,(1+p),(1-p),(n*n),(n*p*n),(n*p*n*p),(n*p*x),(n*p*y),(n*p+n),(n*p+x),(n*p+y),(n*p-n),(n*p-x),(n*p-y),(n*x),(n*y),(n+x),(n+y),(n-n*p),(n-x),(n-y),(x*x),(x*y),(x+y),(x-n),(x-n*p),(x-y),(y*y),(y-n),(y-n*p),(y-x),expected_post,n,n*p,p,post-init,x,y
0,1.41,0.59,1,0.41,0.17,6.15,1.64,1.41,15.41,4.41,-0.59,-14.59,-3.59,15,4,16,5,0.59,-14,-3,225,60,19,14,14.59,11,16,3,3.59,-11,17.8,1,0.41,0.41,2.8000000000000007,15,4
1,1.48,0.52,1,0.48,0.23,8.64,5.76,1.48,18.48,12.48,-0.52,-17.52,-11.52,18,12,19,13,0.52,-17,-11,324,216,30,17,17.52,6,144,11,11.52,-6,24.654,1,0.48,0.48,6.654,18,12
2,1.68,0.32,196,133.28,90.63,190.4,95.2,23.52,29.52,19.52,-4.48,-10.48,-0.48,280,140,34,24,4.48,-6,4,400,200,30,6,10.48,10,100,-4,0.48,-10,136.504,14,9.52,0.68,116.50399999999999,20,10
3,1.25,0.75,289,72.25,18.06,29.75,0.0,21.25,11.25,4.25,-12.75,-2.75,4.25,119,0,24,17,12.75,10,17,49,0,7,-10,2.75,7,0,-17,-4.25,-7,46.972,17,4.25,0.25,39.972,7,0
4,1.39,0.61,100,39.0,15.21,78.0,3.9,13.9,23.9,4.9,-6.1,-16.1,2.9,200,10,30,11,6.1,-10,9,400,20,21,10,16.1,19,1,-9,-2.9,-19,47.05,10,3.9,0.39,27.049999999999997,20,1
5,1.9,0.1,9,8.1,7.29,2.7,16.2,5.7,3.7,8.7,-0.3,1.7,-3.3,3,18,4,9,0.3,2,-3,1,6,7,-2,-1.7,-5,36,3,3.3,5,8.146,3,2.7,0.9,7.146000000000001,1,6
6,1.67,0.33,121,81.07,54.32,44.22,7.37,18.37,13.37,8.37,-3.63,1.37,6.37,66,11,17,12,3.63,5,10,36,6,7,-5,-1.37,5,1,-10,-6.37,-5,53.794,11,7.37,0.67,47.794,6,1
7,1.19,0.81,144,27.36,5.2,18.24,38.76,14.28,10.28,19.28,-9.72,-5.72,-14.72,96,204,20,29,9.72,4,-5,64,136,25,-4,5.72,-9,289,5,14.72,9,188.908,12,2.28,0.19,180.908,8,17
8,1.29,0.71,289,83.81,24.3,0.0,78.88,21.93,4.93,20.93,-12.07,4.93,-11.07,0,272,17,33,12.07,17,1,0,0,16,-17,-4.93,-16,256,-1,11.07,16,237.79,17,4.93,0.29,237.79,0,16
9,1.71,0.29,256,181.76,129.05,159.04,227.2,27.36,25.36,31.36,-4.64,-2.64,-8.64,224,320,30,36,4.64,2,-4,196,280,34,-2,2.64,-6,400,4,8.64,6,202.048,16,11.36,0.71,188.048,14,20
10,1.53,0.47,16,8.48,4.49,23.32,38.16,6.12,13.12,20.12,-1.88,-8.88,-15.88,44,72,15,22,1.88,-7,-14,121,198,29,7,8.88,-7,324,14,15.88,7,49.374,4,2.12,0.53,38.374,11,18
11,1.68,0.32,400,272.0,184.96,81.6,68.0,33.6,19.6,18.6,-6.4,7.6,8.6,120,100,26,25,6.4,14,15,36,30,11,-14,-7.6,1,25,-15,-8.6,-1,180.714,20,13.6,0.68,174.714,6,5
12,1.67,0.33,225,150.75,101.0,20.1,100.5,25.05,12.05,20.05,-4.95,8.05,0.05,30,150,17,25,4.95,13,5,4,20,12,-13,-8.05,-8,100,-5,-0.05,8,131.582,15,10.05,0.67,129.582,2,10
13,1.44,0.56,4,1.76,0.77,8.8,0.88,2.88,10.88,1.88,-1.12,-9.12,-0.12,20,2,12,3,1.12,-8,1,100,10,11,8,9.12,9,1,-1,0.12,-9,12.45,2,0.88,0.44,2.4499999999999993,10,1
14,1.71,0.29,289,205.19,145.68,205.19,120.7,29.07,29.07,22.07,-4.93,-4.93,2.07,289,170,34,27,4.93,0,7,289,170,27,0,4.93,7,100,-7,-2.07,-7,175.454,17,12.07,0.71,158.454,17,10
15,1.58,0.42,121,70.18,40.7,102.08,6.38,17.38,22.38,7.38,-4.62,-9.62,5.38,176,11,27,12,4.62,-5,10,256,16,17,5,9.62,15,1,-10,-5.38,-15,59.674,11,6.38,0.58,43.674,16,1
16,1.29,0.71,64,18.56,5.38,9.28,30.16,10.32,6.32,15.32,-5.68,-1.68,-10.68,32,104,12,21,5.68,4,-5,16,52,17,-4,1.68,-9,169,5,10.68,9,88.504,8,2.32,0.29,84.504,4,13
17,1.09,0.91,121,10.89,0.98,9.9,7.92,11.99,10.99,8.99,-10.01,-9.01,-7.01,110,88,21,19,10.01,1,3,100,80,18,-1,9.01,2,64,-3,7.01,-2,96.15,11,0.99,0.09,86.15,10,8
18,1.59,0.41,9,5.31,3.13,8.85,10.62,4.77,6.77,7.77,-1.23,-3.23,-4.23,15,18,8,9,1.23,-2,-3,25,30,11,2,3.23,-1,36,3,4.23,1,15.86,3,1.77,0.59,10.86,5,6
19,1.92,0.08,64,58.88,54.17,88.32,132.48,15.36,19.36,25.36,-0.64,-4.64,-10.64,96,144,20,26,0.64,-4,-10,144,216,30,4,4.64,-6,324,10,10.64,6,57.038,8,7.36,0.92,45.038,12,18
20,1.31,0.69,256,79.36,24.6,99.2,0.0,20.96,24.96,4.96,-11.04,-15.04,4.96,320,0,36,16,11.04,-4,16,400,0,20,4,15.04,20,0,-16,-4.96,-20,63.026,16,4.96,0.31,43.026,20,0
21,1.94,0.06,4,3.76,3.53,13.16,16.92,3.88,8.88,10.88,-0.12,-5.12,-7.12,14,18,9,11,0.12,-5,-7,49,63,16,5,5.12,-2,81,7,7.12,2,10.786,2,1.88,0.94,3.7859999999999996,7,9
22,1.78,0.22,169,131.82,102.82,172.38,152.1,23.14,27.14,25.14,-2.86,-6.86,-4.86,221,195,30,28,2.86,-4,-2,289,255,32,4,6.86,2,225,2,4.86,-2,130.48,13,10.14,0.78,113.47999999999999,17,15
23,1.53,0.47,169,89.57,47.47,82.68,6.89,19.89,18.89,7.89,-6.11,-5.11,5.89,156,13,25,14,6.11,1,12,144,12,13,-1,5.11,11,1,-12,-5.89,-11,66.458,13,6.89,0.53,54.458,12,1
24,1.38,0.62,256,97.28,36.97,85.12,36.48,22.08,20.08,12.08,-9.92,-7.92,0.08,224,96,30,22,9.92,2,10,196,84,20,-2,7.92,8,36,-10,-0.08,-8,124.792,16,6.08,0.38,110.792,14,6
25,1.09,0.91,49,4.41,0.4,12.6,1.26,7.63,20.63,2.63,-6.37,-19.37,-1.37,140,14,27,9,6.37,-13,5,400,40,22,13,19.37,18,4,-5,1.37,-18,35.266,7,0.63,0.09,15.265999999999998,20,2
26,1.88,0.12,100,88.0,77.44,26.4,8.8,18.8,11.8,9.8,-1.2,5.8,7.8,30,10,13,11,1.2,7,9,9,3,4,-7,-5.8,2,1,-9,-7.8,-2,52.712,10,8.8,0.88,49.712,3,1
27,1.1,0.9,16,1.6,0.16,4.8,3.2,4.4,12.4,8.4,-3.6,-11.6,-7.6,48,32,16,12,3.6,-8,-4,144,96,20,8,11.6,4,64,4,7.6,-4,41.66,4,0.4,0.1,29.659999999999997,12,8
28,1.4,0.6,81,32.4,12.96,72.0,57.6,12.6,23.6,19.6,-5.4,-16.4,-12.4,180,144,29,25,5.4,-11,-7,400,320,36,11,16.4,4,256,7,12.4,-4,125.04,9,3.6,0.4,105.04,20,16
29,1.79,0.21,4,3.16,2.5,12.64,30.02,3.58,9.58,20.58,-0.42,-6.42,-17.42,16,38,10,21,0.42,-6,-17,64,152,27,6,6.42,-11,361,17,17.42,11,18.17,2,1.58,0.79,10.170000000000002,8,19
30,1.5,0.5,400,200.0,100.0,30.0,150.0,30.0,13.0,25.0,-10.0,7.0,-5.0,60,300,23,35,10.0,17,5,9,45,18,-17,-7.0,-12,225,-5,5.0,12,259.322,20,10.0,0.5,256.322,3,15
31,1.06,0.94,25,1.5,0.09,5.4,4.2,5.3,18.3,14.3,-4.7,-17.7,-13.7,90,70,23,19,4.7,-13,-9,324,252,32,13,17.7,4,196,9,13.7,-4,84.664,5,0.3,0.06,66.664,18,14
32,1.25,0.75,256,64.0,16.0,12.0,48.0,20.0,7.0,16.0,-12.0,1.0,-8.0,48,192,19,28,12.0,13,4,9,36,15,-13,-1.0,-9,144,-4,8.0,9,180.61,16,4.0,0.25,177.61,3,12
33,1.59,0.41,9,5.31,3.13,3.54,14.16,4.77,3.77,9.77,-1.23,-0.23,-6.23,6,24,5,11,1.23,1,-5,4,16,10,-1,0.23,-6,64,5,6.23,6,15.17,3,1.77,0.59,13.17,2,8
34,1.11,0.89,49,5.39,0.59,9.24,13.86,7.77,12.77,18.77,-6.23,-11.23,-17.23,84,126,19,25,6.23,-5,-11,144,216,30,5,11.23,-6,324,11,17.23,6,127.768,7,0.77,0.11,115.768,12,18
35,1.65,0.35,121,78.65,51.12,7.15,71.5,18.15,8.15,17.15,-3.85,6.15,-2.85,11,110,12,21,3.85,10,1,1,10,11,-10,-6.15,-9,100,-1,2.85,9,81.866,11,7.15,0.65,80.866,1,10
36,1.48,0.52,400,192.0,92.16,48.0,172.8,29.6,14.6,27.6,-10.4,4.6,-8.4,100,360,25,38,10.4,15,2,25,90,23,-15,-4.6,-13,324,-2,8.4,13,294.036,20,9.6,0.48,289.036,5,18
37,1.54,0.46,289,156.06,84.27,45.9,137.7,26.18,14.18,24.18,-7.82,4.18,-5.82,85,255,22,32,7.82,12,2,25,75,20,-12,-4.18,-10,225,-2,5.82,10,204.458,17,9.18,0.54,199.458,5,15
38,1.87,0.13,400,348.0,302.76,261.0,52.2,37.4,32.4,20.4,-2.6,2.4,14.4,300,60,35,23,2.6,5,17,225,45,18,-5,-2.4,12,9,-17,-14.4,-12,205.522,20,17.4,0.87,190.522,15,3
39,1.45,0.55,225,101.25,45.56,81.0,67.5,21.75,18.75,16.75,-8.25,-5.25,-3.25,180,150,27,25,8.25,3,5,144,120,22,-3,5.25,2,100,-5,3.25,-2,148.642,15,6.75,0.45,136.642,12,10
40,1.63,0.37,225,141.75,89.3,94.5,18.9,24.45,19.45,11.45,-5.55,-0.55,7.45,150,30,25,17,5.55,5,13,100,20,12,-5,0.55,8,4,-13,-7.45,-8,96.12,15,9.45,0.63,86.12,10,2
41,1.6,0.4,225,135.0,81.0,54.0,0.0,24.0,15.0,9.0,-6.0,3.0,9.0,90,0,21,15,6.0,9,15,36,0,6,-9,-3.0,6,0,-15,-9.0,-6,78.446,15,9.0,0.6,72.446,6,0
42,1.9,0.1,9,8.1,7.29,5.4,45.9,5.7,4.7,19.7,-0.3,0.7,-14.3,6,51,5,20,0.3,1,-14,4,34,19,-1,-0.7,-15,289,14,14.3,15,12.556,3,2.7,0.9,10.556,2,17
43,1.6,0.4,289,173.4,104.04,102.0,122.4,27.2,20.2,22.2,-6.8,0.2,-1.8,170,204,27,29,6.8,7,5,100,120,22,-7,-0.2,-2,144,-5,1.8,2,183.014,17,10.2,0.6,173.014,10,12
44,1.77,0.23,9,6.93,5.34,0.0,43.89,5.31,2.31,21.31,-0.69,2.31,-16.69,0,57,3,22,0.69,3,-16,0,0,19,-3,-2.31,-19,361,16,16.69,19,18.096,3,2.31,0.77,18.096,0,19
45,1.39,0.61,1,0.39,0.15,5.85,5.85,1.39,15.39,15.39,-0.61,-14.61,-14.61,15,15,16,16,0.61,-14,-14,225,225,30,14,14.61,0,225,14,14.61,0,24.68,1,0.39,0.39,9.68,15,15
46,1.62,0.38,4,2.48,1.54,6.2,7.44,3.24,6.24,7.24,-0.76,-3.76,-4.76,10,12,7,8,0.76,-3,-4,25,30,11,3,3.76,-1,36,4,4.76,1,11.35,2,1.24,0.62,6.35,5,6
47,1.4,0.6,400,160.0,64.0,88.0,104.0,28.0,19.0,21.0,-12.0,-3.0,-5.0,220,260,31,33,12.0,9,7,121,143,24,-9,3.0,-2,169,-7,5.0,2,252.196,20,8.0,0.4,241.196,11,13
48,1.4,0.6,1,0.4,0.16,3.2,1.6,1.4,8.4,4.4,-0.6,-7.6,-3.6,8,4,9,5,0.6,-7,-3,64,32,12,7,7.6,4,16,3,3.6,-4,10.818,1,0.4,0.4,2.8179999999999996,8,4
49,1.81,0.19,81,65.61,53.14,123.93,87.48,16.29,24.29,19.29,-1.71,-9.71,-4.71,153,108,26,21,1.71,-8,-3,289,204,29,8,9.71,5,144,3,4.71,-5,73.122,9,7.29,0.81,56.122,17,12
50,1.54,0.46,400,216.0,116.64,194.4,194.4,30.8,28.8,28.8,-9.2,-7.2,-7.2,360,360,38,38,9.2,2,2,324,324,36,-2,7.2,0,324,-2,7.2,0,296.308,20,10.8,0.54,278.308,18,18
51,1.77,0.23,81,62.37,48.02,76.23,41.58,15.93,17.93,12.93,-2.07,-4.07,0.93,99,54,20,15,2.07,-2,3,121,66,17,2,4.07,5,36,-3,-0.93,-5,57.956,9,6.93,0.77,46.956,11,6
52,1.18,0.82,400,72.0,12.96,25.2,32.4,23.6,10.6,12.6,-16.4,-3.4,-5.4,140,180,27,29,16.4,13,11,49,63,16,-13,3.4,-2,81,-11,5.4,2,192.526,20,3.6,0.18,185.526,7,9
53,1.83,0.17,256,212.48,176.36,13.28,26.56,29.28,14.28,15.28,-2.72,12.28,11.28,16,32,17,18,2.72,15,14,1,2,3,-15,-12.28,-1,4,-14,-11.28,1,120.274,16,13.28,0.83,119.274,1,2
54,1.71,0.29,361,256.31,181.98,67.45,188.86,32.49,18.49,27.49,-5.51,8.49,-0.51,95,266,24,33,5.51,14,5,25,70,19,-14,-8.49,-9,196,-5,0.51,9,216.818,19,13.49,0.71,211.818,5,14
55,1.39,0.61,289,112.71,43.96,112.71,39.78,23.63,23.63,12.63,-10.37,-10.37,0.63,289,102,34,23,10.37,0,11,289,102,23,0,10.37,11,36,-11,-0.63,-11,138.768,17,6.63,0.39,121.768,17,6
56,1.81,0.19,256,207.36,167.96,220.32,51.84,28.96,29.96,16.96,-3.04,-4.04,8.96,272,64,33,20,3.04,-1,12,289,68,21,1,4.04,13,16,-12,-8.96,-13,138.756,16,12.96,0.81,121.756,17,4
57,1.68,0.32,25,17.0,11.56,40.8,51.0,8.4,15.4,18.4,-1.6,-8.6,-11.6,60,75,17,20,1.6,-7,-10,144,180,27,7,8.6,-3,225,10,11.6,3,46.946,5,3.4,0.68,34.946,12,15
58,1.32,0.68,4,1.28,0.41,4.48,8.32,2.64,7.64,13.64,-1.36,-6.36,-12.36,14,26,9,15,1.36,-5,-11,49,91,20,5,6.36,-6,169,11,12.36,6,25.192,2,0.64,0.32,18.192,7,13
59,1.41,0.59,169,69.29,28.41,58.63,95.94,18.33,16.33,23.33,-7.67,-5.67,-12.67,143,234,24,31,7.67,2,-5,121,198,29,-2,5.67,-7,324,5,12.67,7,186.61,13,5.33,0.41,175.61,11,18
60,1.74,0.26,121,89.54,66.26,73.26,73.26,19.14,17.14,17.14,-2.86,-0.86,-0.86,99,99,20,20,2.86,2,2,81,81,18,-2,0.86,0,81,-2,0.86,0,83.718,11,8.14,0.74,74.718,9,9
61,1.22,0.78,4,0.88,0.19,8.36,8.36,2.44,19.44,19.44,-1.56,-18.56,-18.56,38,38,21,21,1.56,-17,-17,361,361,38,17,18.56,0,361,17,18.56,0,48.47,2,0.44,0.22,29.47,19,19
62,1.19,0.81,169,32.11,6.1,24.7,7.41,15.47,12.47,5.47,-10.53,-7.53,-0.53,130,39,23,16,10.53,3,10,100,30,13,-3,7.53,7,9,-10,0.53,-7,59.058,13,2.47,0.19,49.058,10,3
63,1.65,0.35,144,93.6,60.84,7.8,148.2,19.8,8.8,26.8,-4.2,6.8,-11.2,12,228,13,31,4.2,11,-7,1,19,20,-11,-6.8,-18,361,7,11.2,18,131.486,12,7.8,0.65,130.486,1,19
64,1.19,0.81,361,68.59,13.03,32.49,0.0,22.61,12.61,3.61,-15.39,-5.39,3.61,171,0,28,19,15.39,10,19,81,0,9,-10,5.39,9,0,-19,-3.61,-9,45.166,19,3.61,0.19,36.166,9,0
65,1.71,0.29,169,119.99,85.19,46.15,18.46,22.23,14.23,11.23,-3.77,4.23,7.23,65,26,18,15,3.77,8,11,25,10,7,-8,-4.23,3,4,-11,-7.23,-3,77.55,13,9.23,0.71,72.55,5,2
66,1.39,0.61,1,0.39,0.15,0.78,3.51,1.39,2.39,9.39,-0.61,-1.61,-8.61,2,9,3,10,0.61,-1,-8,4,18,11,1,1.61,-7,81,8,8.61,7,7.912,1,0.39,0.39,5.912,2,9
67,1.2,0.8,100,20.0,4.0,22.0,6.0,12.0,13.0,5.0,-8.0,-9.0,-1.0,110,30,21,13,8.0,-1,7,121,33,14,1,9.0,8,9,-7,1.0,-8,45.78,10,2.0,0.2,34.78,11,3
68,1.57,0.43,16,9.12,5.2,18.24,31.92,6.28,10.28,16.28,-1.72,-5.72,-11.72,32,56,12,18,1.72,-4,-10,64,112,22,4,5.72,-6,196,10,11.72,6,38.296,4,2.28,0.57,30.296,8,14
69,1.93,0.07,196,182.28,169.52,169.26,26.04,27.02,26.02,15.02,-0.98,0.02,11.02,182,28,27,16,0.98,1,12,169,26,15,-1,-0.02,11,4,-12,-11.02,-11,112.552,14,13.02,0.93,99.552,13,2
70,1.75,0.25,400,300.0,225.0,300.0,195.0,35.0,35.0,28.0,-5.0,-5.0,2.0,400,260,40,33,5.0,0,7,400,260,33,0,5.0,7,169,-7,-2.0,-7,243.432,20,15.0,0.75,223.432,20,13
71,1.43,0.57,81,34.83,14.98,15.48,38.7,12.87,7.87,13.87,-5.13,-0.13,-6.13,36,90,13,19,5.13,5,-1,16,40,14,-5,0.13,-6,100,1,6.13,6,74.448,9,3.87,0.43,70.448,4,10
72,1.49,0.51,9,4.41,2.16,16.17,19.11,4.47,12.47,14.47,-1.53,-9.53,-11.53,33,39,14,16,1.53,-8,-10,121,143,24,8,9.53,-2,169,10,11.53,2,34.262,3,1.47,0.49,23.262,11,13
73,1.48,0.52,1,0.48,0.23,9.12,1.44,1.48,19.48,3.48,-0.52,-18.52,-2.52,19,3,20,4,0.52,-18,-2,361,57,22,18,18.52,16,9,2,2.52,-16,21.012,1,0.48,0.48,2.0120000000000005,19,3
74,1.66,0.34,144,95.04,62.73,118.8,55.44,19.92,22.92,14.92,-4.08,-7.08,0.92,180,84,27,19,4.08,-3,5,225,105,22,3,7.08,8,49,-5,-0.92,-8,95.016,12,7.92,0.66,80.016,15,7
75,1.87,0.13,49,42.63,37.09,60.9,18.27,13.09,16.09,9.09,-0.91,-3.91,3.09,70,21,17,10,0.91,-3,4,100,30,13,3,3.91,7,9,-4,-3.09,-7,36.946,7,6.09,0.87,26.945999999999998,10,3
76,1.38,0.62,100,38.0,14.44,30.4,15.2,13.8,11.8,7.8,-6.2,-4.2,-0.2,80,40,18,14,6.2,2,6,64,32,12,-2,4.2,4,16,-6,0.2,-4,53.784,10,3.8,0.38,45.784,8,4
77,1.07,0.93,81,5.67,0.4,1.26,10.08,9.63,2.63,16.63,-8.37,-1.37,-15.37,18,144,11,25,8.37,7,-7,4,32,18,-7,1.37,-14,256,7,15.37,14,139.514,9,0.63,0.07,137.514,2,16
78,1.13,0.87,49,6.37,0.83,15.47,12.74,7.91,17.91,14.91,-6.09,-16.09,-13.09,119,98,24,21,6.09,-10,-7,289,238,31,10,16.09,3,196,7,13.09,-3,106.5,7,0.91,0.13,89.5,17,14
79,1.08,0.92,16,1.28,0.1,3.52,2.24,4.32,11.32,7.32,-3.68,-10.68,-6.68,44,28,15,11,3.68,-7,-3,121,77,18,7,10.68,4,49,3,6.68,-4,37.628,4,0.32,0.08,26.628,11,7
80,1.94,0.06,225,211.5,198.81,14.1,155.1,29.1,15.1,25.1,-0.9,13.1,3.1,15,165,16,26,0.9,14,4,1,11,12,-14,-13.1,-10,121,-4,-3.1,10,123.436,15,14.1,0.94,122.436,1,11
81,1.41,0.59,169,69.29,28.41,69.29,53.3,18.33,18.33,15.33,-7.67,-7.67,-4.67,169,130,26,23,7.67,0,3,169,130,23,0,7.67,3,100,-3,4.67,-3,126.836,13,5.33,0.41,113.836,13,10
82,1.17,0.83,256,43.52,7.4,38.08,40.8,18.72,16.72,17.72,-13.28,-11.28,-12.28,224,240,30,31,13.28,2,1,196,210,29,-2,11.28,-1,225,-1,12.28,1,236.192,16,2.72,0.17,222.192,14,15
83,1.84,0.16,144,120.96,101.61,40.32,120.96,22.08,14.08,22.08,-1.92,6.08,-1.92,48,144,16,24,1.92,8,0,16,48,16,-8,-6.08,-8,144,0,1.92,8,92.456,12,10.08,0.84,88.456,4,12
84,1.52,0.48,256,133.12,69.22,33.28,141.44,24.32,12.32,25.32,-7.68,4.32,-8.68,64,272,20,33,7.68,12,-1,16,68,21,-12,-4.32,-13,289,1,8.68,13,205.42,16,8.32,0.52,201.42,4,17
85,1.8,0.2,64,51.2,40.96,89.6,108.8,14.4,20.4,23.4,-1.6,-7.6,-10.6,112,136,22,25,1.6,-6,-9,196,238,31,6,7.6,-3,289,9,10.6,3,70.468,8,6.4,0.8,56.468,14,17
86,1.35,0.65,144,50.4,17.64,79.8,79.8,16.2,23.2,23.2,-7.8,-14.8,-14.8,228,228,31,31,7.8,-7,-7,361,361,38,7,14.8,0,361,7,14.8,0,195.362,12,4.2,0.35,176.362,19,19
87,1.68,0.32,144,97.92,66.59,24.48,146.88,20.16,11.16,26.16,-3.84,5.16,-9.84,36,216,15,30,3.84,9,-6,9,54,21,-9,-5.16,-15,324,6,9.84,15,125.232,12,8.16,0.68,122.232,3,18
88,1.41,0.59,64,26.24,10.76,3.28,29.52,11.28,4.28,12.28,-4.72,2.28,-5.72,8,72,9,17,4.72,7,-1,1,9,10,-7,-2.28,-8,81,1,5.72,8,58.406,8,3.28,0.41,57.406,1,9
89,1.36,0.64,144,51.84,18.66,73.44,69.12,16.32,21.32,20.32,-7.68,-12.68,-11.68,204,192,29,28,7.68,-5,-4,289,272,33,5,12.68,1,256,4,11.68,-1,169.282,12,4.32,0.36,152.282,17,16
90,1.24,0.76,36,8.64,2.07,7.2,1.44,7.44,6.44,2.44,-4.56,-3.56,0.44,30,6,11,7,4.56,1,5,25,5,6,-1,3.56,4,1,-5,-0.44,-4,14.802,6,1.44,0.24,9.802,5,1
91,1.92,0.08,361,332.12,305.55,297.16,52.44,36.48,34.48,20.48,-1.52,0.48,14.48,323,57,36,22,1.52,2,16,289,51,20,-2,-0.48,14,9,-16,-14.48,-14,196.092,19,17.48,0.92,179.092,17,3
92,1.71,0.29,169,119.99,85.19,101.53,175.37,22.23,20.23,28.23,-3.77,-1.77,-9.77,143,247,24,32,3.77,2,-6,121,209,30,-2,1.77,-8,361,6,9.77,8,145.618,13,9.23,0.71,134.618,11,19
93,1.31,0.69,256,79.36,24.6,4.96,64.48,20.96,5.96,17.96,-11.04,3.96,-8.04,16,208,17,29,11.04,15,3,1,13,14,-15,-3.96,-12,169,-3,8.04,12,186.142,16,4.96,0.31,185.142,1,13
94,1.21,0.79,361,75.81,15.92,43.89,79.8,22.99,14.99,23.99,-15.01,-7.01,-16.01,209,380,30,39,15.01,8,-1,121,220,31,-8,7.01,-9,400,1,16.01,9,353.612,19,3.99,0.21,342.612,11,20
95,1.16,0.84,361,57.76,9.24,39.52,6.08,22.04,16.04,5.04,-15.96,-9.96,1.04,247,38,32,21,15.96,6,17,169,26,15,-6,9.96,11,4,-17,-1.04,-11,75.408,19,3.04,0.16,62.408,13,2
96,1.17,0.83,361,61.37,10.43,51.68,51.68,22.23,19.23,19.23,-15.77,-12.77,-12.77,304,304,35,35,15.77,3,3,256,256,32,-3,12.77,0,256,-3,12.77,0,300.93,19,3.23,0.17,284.93,16,16
97,1.13,0.87,289,37.57,4.88,13.26,39.78,19.21,8.21,20.21,-14.79,-3.79,-15.79,102,306,23,35,14.79,11,-1,36,108,24,-11,3.79,-12,324,1,15.79,12,292.28,17,2.21,0.13,286.28,6,18
98,1.68,0.32,9,6.12,4.16,2.04,14.28,5.04,3.04,9.04,-0.96,1.04,-4.96,3,21,4,10,0.96,2,-4,1,7,8,-2,-1.04,-6,49,4,4.96,6,11.68,3,2.04,0.68,10.68,1,7
99,1.15,0.85,225,33.75,5.06,4.5,36.0,17.25,4.25,18.25,-12.75,0.25,-13.75,30,240,17,31,12.75,13,-1,4,32,18,-13,-0.25,-14,256,1,13.75,14,224.438,15,2.25,0.15,222.438,2,16
100,1.83,0.17,144,119.52,99.2,139.44,149.4,21.96,23.96,24.96,-2.04,-4.04,-5.04,168,180,26,27,2.04,-2,-3,196,210,29,2,4.04,-1,225,3,5.04,1,108.868,12,9.96,0.83,94.868,14,15
101,1.79,0.21,100,79.0,62.41,158.0,79.0,17.9,27.9,17.9,-2.1,-12.1,-2.1,200,100,30,20,2.1,-10,0,400,200,30,10,12.1,10,100,0,2.1,-10,84.13,10,7.9,0.79,64.13,20,10
102,1.24,0.76,169,40.56,9.73,6.24,3.12,16.12,5.12,4.12,-9.88,1.12,2.12,26,13,15,14,9.88,11,12,4,2,3,-11,-1.12,1,1,-12,-2.12,-1,34.3,13,3.12,0.24,32.3,2,1
103,1.92,0.08,324,298.08,274.23,16.56,264.96,34.56,17.56,32.56,-1.44,15.56,0.56,18,288,19,34,1.44,17,2,1,16,17,-17,-15.56,-15,256,-2,-0.56,15,181.694,18,16.56,0.92,180.694,1,16
104,1.32,0.68,36,11.52,3.69,17.28,5.76,7.92,10.92,4.92,-4.08,-7.08,-1.08,54,18,15,9,4.08,-3,3,81,27,12,3,7.08,6,9,-3,1.08,-6,27.956,6,1.92,0.32,18.956,9,3
105,1.38,0.62,361,137.18,52.13,0.0,36.1,26.22,7.22,12.22,-11.78,7.22,2.22,0,95,19,24,11.78,19,14,0,0,5,-19,-7.22,-5,25,-14,-2.22,5,131.228,19,7.22,0.38,131.228,0,5
106,1.51,0.49,169,86.19,43.96,59.67,132.6,19.63,15.63,26.63,-6.37,-2.37,-13.37,117,260,22,33,6.37,4,-7,81,180,29,-4,2.37,-11,400,7,13.37,11,184.348,13,6.63,0.51,175.348,9,20
107,1.27,0.73,36,9.72,2.62,0.0,27.54,7.62,1.62,18.62,-4.38,1.62,-15.38,0,102,6,23,4.38,6,-11,0,0,17,-6,-1.62,-17,289,11,15.38,17,80.38,6,1.62,0.27,80.38,0,17
108,1.4,0.6,4,1.6,0.64,15.2,16.0,2.8,19.8,20.8,-1.2,-18.2,-19.2,38,40,21,22,1.2,-17,-18,361,380,39,17,18.2,-1,400,18,19.2,1,44.462,2,0.8,0.4,25.462000000000003,19,20
109,1.76,0.24,64,48.64,36.97,109.44,66.88,14.08,24.08,17.08,-1.92,-11.92,-4.92,144,88,26,19,1.92,-10,-3,324,198,29,10,11.92,7,121,3,4.92,-7,66.262,8,6.08,0.76,48.262,18,11
110,1.35,0.65,225,78.75,27.56,73.5,47.25,20.25,19.25,14.25,-9.75,-8.75,-3.75,210,135,29,24,9.75,1,6,196,126,23,-1,8.75,5,81,-6,3.75,-5,144.394,15,5.25,0.35,130.394,14,9
111,1.07,0.93,36,2.52,0.18,2.94,5.04,6.42,7.42,12.42,-5.58,-6.58,-11.58,42,72,13,18,5.58,-1,-6,49,84,19,1,6.58,-5,144,6,11.58,5,75.824,6,0.42,0.07,68.824,7,12
112,1.25,0.75,1,0.25,0.06,1.25,1.75,1.25,5.25,7.25,-0.75,-4.75,-6.75,5,7,6,8,0.75,-4,-6,25,35,12,4,4.75,-2,49,6,6.75,2,10.584,1,0.25,0.25,5.584,5,7
113,1.5,0.5,144,72.0,36.0,42.0,0.0,18.0,13.0,6.0,-6.0,-1.0,6.0,84,0,19,12,6.0,5,12,49,0,7,-5,1.0,7,0,-12,-6.0,-7,46.51,12,6.0,0.5,39.51,7,0
114,1.34,0.66,225,76.5,26.01,10.2,96.9,20.1,7.1,24.1,-9.9,3.1,-13.9,30,285,17,34,9.9,13,-4,4,38,21,-13,-3.1,-17,361,4,13.9,17,230.606,15,5.1,0.34,228.606,2,19
115,1.83,0.17,196,162.68,135.02,116.2,174.3,25.62,21.62,26.62,-2.38,1.62,-3.38,140,210,24,29,2.38,4,-1,100,150,25,-4,-1.62,-5,225,1,3.38,5,132.208,14,11.62,0.83,122.208,10,15
116,1.25,0.75,400,100.0,25.0,75.0,65.0,25.0,20.0,18.0,-15.0,-10.0,-8.0,300,260,35,33,15.0,5,7,225,195,28,-5,10.0,2,169,-7,8.0,-2,262.666,20,5.0,0.25,247.666,15,13
117,1.64,0.36,225,144.0,92.16,105.6,96.0,24.6,20.6,19.6,-5.4,-1.4,-0.4,165,150,26,25,5.4,4,5,121,110,21,-4,1.4,1,100,-5,0.4,-1,142.118,15,9.6,0.64,131.118,11,10
118,1.25,0.75,256,64.0,16.0,4.0,20.0,20.0,5.0,9.0,-12.0,3.0,-1.0,16,80,17,21,12.0,15,11,1,5,6,-15,-3.0,-4,25,-11,1.0,4,95.656,16,4.0,0.25,94.656,1,5
119,1.38,0.62,144,54.72,20.79,82.08,13.68,16.56,22.56,7.56,-7.44,-13.44,1.56,216,36,30,15,7.44,-6,9,324,54,21,6,13.44,15,9,-9,-1.56,-15,70.606,12,4.56,0.38,52.605999999999995,18,3
120,1.85,0.15,81,68.85,58.52,153.0,130.05,16.65,27.65,24.65,-1.35,-12.35,-9.35,180,153,29,26,1.35,-11,-8,400,340,37,11,12.35,3,289,8,9.35,-3,80.636,9,7.65,0.85,60.635999999999996,20,17
121,1.58,0.42,324,187.92,108.99,198.36,73.08,28.44,29.44,17.44,-7.56,-8.56,3.44,342,126,37,25,7.56,-1,11,361,133,26,1,8.56,12,49,-11,-3.44,-12,170.498,18,10.44,0.58,151.498,19,7
122,1.67,0.33,289,193.63,129.73,68.34,113.9,28.39,17.39,21.39,-5.61,5.39,1.39,102,170,23,27,5.61,11,7,36,60,16,-11,-5.39,-4,100,-7,-1.39,4,164.16,17,11.39,0.67,158.16,6,10
123,1.44,0.56,81,35.64,15.68,39.6,15.84,12.96,13.96,7.96,-5.04,-6.04,-0.04,90,36,19,13,5.04,-1,5,100,40,14,1,6.04,6,16,-5,0.04,-6,49.946,9,3.96,0.44,39.946,10,4
124,1.23,0.77,225,51.75,11.9,51.75,44.85,18.45,18.45,16.45,-11.55,-11.55,-9.55,225,195,30,28,11.55,0,2,225,195,28,0,11.55,2,169,-2,9.55,-2,193.206,15,3.45,0.23,178.206,15,13
125,1.93,0.07,16,14.88,13.84,0.0,52.08,7.72,3.72,17.72,-0.28,3.72,-10.28,0,56,4,18,0.28,4,-10,0,0,14,-4,-3.72,-14,196,10,10.28,14,12.92,4,3.72,0.93,12.92,0,14
126,1.57,0.43,169,96.33,54.91,96.33,96.33,20.41,20.41,20.41,-5.59,-5.59,-5.59,169,169,26,26,5.59,0,0,169,169,26,0,5.59,0,169,0,5.59,0,138.058,13,7.41,0.57,125.05799999999999,13,13
127,1.2,0.8,225,45.0,9.0,30.0,18.0,18.0,13.0,9.0,-12.0,-7.0,-3.0,150,90,25,21,12.0,5,9,100,60,16,-5,7.0,4,36,-9,3.0,-4,105.7,15,3.0,0.2,95.7,10,6
128,1.9,0.1,121,108.9,98.01,118.8,19.8,20.9,21.9,11.9,-1.1,-2.1,7.9,132,22,23,13,1.1,-1,9,144,24,14,1,2.1,10,4,-9,-7.9,-10,73.868,11,9.9,0.9,61.867999999999995,12,2
129,1.5,0.5,36,18.0,9.0,0.0,51.0,9.0,3.0,20.0,-3.0,3.0,-14.0,0,102,6,23,3.0,6,-11,0,0,17,-6,-3.0,-17,289,11,14.0,17,61.228,6,3.0,0.5,61.228,0,17
130,1.61,0.39,196,119.56,72.93,68.32,68.32,22.54,16.54,16.54,-5.46,0.54,0.54,112,112,22,22,5.46,6,6,64,64,16,-6,-0.54,0,64,-6,-0.54,0,115.432,14,8.54,0.61,107.432,8,8
131,1.32,0.68,1,0.32,0.1,2.24,1.92,1.32,7.32,6.32,-0.68,-6.68,-5.68,7,6,8,7,0.68,-6,-5,49,42,13,6,6.68,1,36,5,5.68,-1,11.39,1,0.32,0.32,4.390000000000001,7,6
132,1.74,0.26,225,166.5,123.21,0.0,66.6,26.1,11.1,17.1,-3.9,11.1,5.1,0,90,15,21,3.9,15,9,0,0,6,-15,-11.1,-6,36,-9,-5.1,6,111.87,15,11.1,0.74,111.87,0,6
133,1.49,0.51,1,0.49,0.24,2.94,5.39,1.49,6.49,11.49,-0.51,-5.51,-10.51,6,11,7,12,0.51,-5,-10,36,66,17,5,5.51,-5,121,10,10.51,5,11.66,1,0.49,0.49,5.66,6,11
134,1.87,0.13,169,147.03,127.92,79.17,135.72,24.31,18.31,23.31,-1.69,4.31,-0.69,91,156,20,25,1.69,6,1,49,84,19,-6,-4.31,-5,144,-1,0.69,5,106.026,13,11.31,0.87,99.026,7,12
135,1.25,0.75,100,25.0,6.25,45.0,10.0,12.5,20.5,6.5,-7.5,-15.5,-1.5,180,40,28,14,7.5,-8,6,324,72,22,8,15.5,14,16,-6,1.5,-14,62.052,10,2.5,0.25,44.052,18,4
136,1.6,0.4,361,216.6,129.96,102.6,159.6,30.4,20.4,25.4,-7.6,2.4,-2.6,171,266,28,33,7.6,10,5,81,126,23,-10,-2.4,-5,196,-5,2.6,5,228.952,19,11.4,0.6,219.952,9,14
137,1.37,0.63,100,37.0,13.69,29.6,3.7,13.7,11.7,4.7,-6.3,-4.3,2.7,80,10,18,11,6.3,2,9,64,8,9,-2,4.3,7,1,-9,-2.7,-7,33.938,10,3.7,0.37,25.938000000000002,8,1
138,1.07,0.93,361,25.27,1.77,3.99,1.33,20.33,4.33,2.33,-17.67,-1.67,0.33,57,19,22,20,17.67,16,18,9,3,4,-16,1.67,2,1,-18,-0.33,-2,33.888,19,1.33,0.07,30.887999999999998,3,1
139,1.87,0.13,225,195.75,170.3,156.6,156.6,28.05,25.05,25.05,-1.95,1.05,1.05,180,180,27,27,1.95,3,3,144,144,24,-3,-1.05,0,144,-3,-1.05,0,140.266,15,13.05,0.87,128.266,12,12
140,1.76,0.24,121,91.96,69.89,167.2,33.44,19.36,28.36,12.36,-2.64,-11.64,4.36,220,44,31,15,2.64,-9,7,400,80,24,9,11.64,16,16,-7,-4.36,-16,80.424,11,8.36,0.76,60.42400000000001,20,4
141,1.63,0.37,4,2.52,1.59,6.3,11.34,3.26,6.26,10.26,-0.74,-3.74,-7.74,10,18,7,11,0.74,-3,-7,25,45,14,3,3.74,-4,81,7,7.74,4,13.346,2,1.26,0.63,8.346,5,9
142,1.57,0.43,196,111.72,63.68,47.88,143.64,21.98,13.98,25.98,-6.02,1.98,-10.02,84,252,20,32,6.02,8,-4,36,108,24,-8,-1.98,-12,324,4,10.02,12,174.304,14,7.98,0.57,168.304,6,18
143,1.78,0.22,225,175.5,136.89,105.3,70.2,26.7,20.7,17.7,-3.3,2.7,5.7,135,90,24,21,3.3,6,9,81,54,15,-6,-2.7,3,36,-9,-5.7,-3,122.644,15,11.7,0.78,113.644,9,6
144,1.43,0.57,25,10.75,4.62,43.0,38.7,7.15,22.15,20.15,-2.85,-17.85,-15.85,100,90,25,23,2.85,-15,-13,400,360,38,15,17.85,2,324,13,15.85,-2,77.504,5,2.15,0.43,57.504000000000005,20,18
145,1.72,0.28,100,72.0,51.84,7.2,36.0,17.2,8.2,12.2,-2.8,6.2,2.2,10,50,11,15,2.8,9,5,1,5,6,-9,-6.2,-4,25,-5,-2.2,4,54.744,10,7.2,0.72,53.744,1,5
146,1.83,0.17,64,53.12,44.09,46.48,6.64,14.64,13.64,7.64,-1.36,-0.36,5.64,56,8,15,9,1.36,1,7,49,7,8,-1,0.36,6,1,-7,-5.64,-6,38.448,8,6.64,0.83,31.448,7,1
147,1.79,0.21,144,113.76,89.87,151.68,9.48,21.48,25.48,10.48,-2.52,-6.52,8.48,192,12,28,13,2.52,-4,11,256,16,17,4,6.52,15,1,-11,-8.48,-15,80.106,12,9.48,0.79,64.106,16,1
148,1.68,0.32,256,174.08,118.37,10.88,76.16,26.88,11.88,17.88,-5.12,9.88,3.88,16,112,17,23,5.12,15,9,1,7,8,-15,-9.88,-6,49,-9,-3.88,6,128.556,16,10.88,0.68,127.55600000000001,1,7
149,1.59,0.41,256,151.04,89.11,132.16,75.52,25.44,23.44,17.44,-6.56,-4.56,1.44,224,128,30,24,6.56,2,8,196,112,22,-2,4.56,6,64,-8,-1.44,-6,146.466,16,9.44,0.59,132.466,14,8
150,1.35,0.65,225,78.75,27.56,68.25,47.25,20.25,18.25,14.25,-9.75,-7.75,-3.75,195,135,28,24,9.75,2,6,169,117,22,-2,7.75,4,81,-6,3.75,-4,142.572,15,5.25,0.35,129.572,13,9
151,1.75,0.25,121,90.75,68.06,132.0,165.0,19.25,24.25,28.25,-2.75,-7.75,-11.75,176,220,27,31,2.75,-5,-9,256,320,36,5,7.75,-4,400,9,11.75,4,120.482,11,8.25,0.75,104.482,16,20
152,1.36,0.64,169,60.84,21.9,79.56,51.48,17.68,21.68,15.68,-8.32,-12.32,-6.32,221,143,30,24,8.32,-4,2,289,187,28,4,12.32,6,121,-2,6.32,-6,141.006,13,4.68,0.36,124.006,17,11
153,1.56,0.44,361,202.16,113.21,180.88,212.8,29.64,27.64,30.64,-8.36,-6.36,-9.36,323,380,36,39,8.36,2,-1,289,340,37,-2,6.36,-3,400,1,9.36,3,289.362,19,10.64,0.56,272.362,17,20
154,1.47,0.53,324,152.28,71.57,109.98,101.52,26.46,21.46,20.46,-9.54,-4.54,-3.54,234,216,31,30,9.54,5,6,169,156,25,-5,4.54,1,144,-6,3.54,-1,207.638,18,8.46,0.47,194.638,13,12
155,1.31,0.69,36,11.16,3.46,11.16,37.2,7.86,7.86,21.86,-4.14,-4.14,-18.14,36,120,12,26,4.14,0,-14,36,120,26,0,4.14,-14,400,14,18.14,14,94.238,6,1.86,0.31,88.238,6,20
156,1.15,0.85,196,29.4,4.41,33.6,35.7,16.1,18.1,19.1,-11.9,-13.9,-14.9,224,238,30,31,11.9,-2,-3,256,272,33,2,13.9,-1,289,3,14.9,1,233.516,14,2.1,0.15,217.516,16,17
157,1.48,0.52,9,4.32,2.07,23.04,15.84,4.44,17.44,12.44,-1.56,-14.56,-9.56,48,33,19,14,1.56,-13,-8,256,176,27,13,14.56,5,121,8,9.56,-5,36.244,3,1.44,0.48,20.244,16,11
158,1.35,0.65,256,89.6,31.36,0.0,39.2,21.6,5.6,12.6,-10.4,5.6,-1.4,0,112,16,23,10.4,16,9,0,0,7,-16,-5.6,-7,49,-9,1.4,7,120.112,16,5.6,0.35,120.112,0,7
159,1.62,0.38,361,223.82,138.77,35.34,212.04,30.78,14.78,29.78,-7.22,8.78,-6.22,57,342,22,37,7.22,16,1,9,54,21,-16,-8.78,-15,324,-1,6.22,15,251.246,19,11.78,0.62,248.246,3,18
160,1.92,0.08,400,368.0,338.56,55.2,294.4,38.4,21.4,34.4,-1.6,15.4,2.4,60,320,23,36,1.6,17,4,9,48,19,-17,-15.4,-13,256,-4,-2.4,13,222.014,20,18.4,0.92,219.014,3,16
161,1.86,0.14,25,21.5,18.49,21.5,0.0,9.3,9.3,4.3,-0.7,-0.7,4.3,25,0,10,5,0.7,0,5,25,0,5,0,0.7,5,0,-5,-4.3,-5,17.936,5,4.3,0.86,12.936,5,0
162,1.53,0.47,4,2.12,1.12,5.3,4.24,3.06,6.06,5.06,-0.94,-3.94,-2.94,10,8,7,6,0.94,-3,-2,25,20,9,3,3.94,1,16,2,2.94,-1,10.25,2,1.06,0.53,5.25,5,4
163,1.62,0.38,1,0.62,0.38,8.06,10.54,1.62,13.62,17.62,-0.38,-12.38,-16.38,13,17,14,18,0.38,-12,-16,169,221,30,12,12.38,-4,289,16,16.38,4,19.76,1,0.62,0.62,6.760000000000002,13,17
164,1.5,0.5,16,8.0,4.0,20.0,40.0,6.0,12.0,22.0,-2.0,-8.0,-18.0,40,80,14,24,2.0,-6,-16,100,200,30,6,8.0,-10,400,16,18.0,10,56.868,4,2.0,0.5,46.868,10,20
165,1.48,0.52,9,4.32,2.07,1.44,27.36,4.44,2.44,20.44,-1.56,0.44,-17.56,3,57,4,22,1.56,2,-16,1,19,20,-2,-0.44,-18,361,16,17.56,18,33.774,3,1.44,0.48,32.774,1,19
166,1.64,0.36,16,10.24,6.55,10.24,33.28,6.56,6.56,15.56,-1.44,-1.44,-10.44,16,52,8,17,1.44,0,-9,16,52,17,0,1.44,-9,169,9,10.44,9,29.7,4,2.56,0.64,25.7,4,13
167,1.61,0.39,49,29.89,18.23,8.54,25.62,11.27,6.27,10.27,-2.73,2.27,-1.73,14,42,9,13,2.73,5,1,4,12,8,-5,-2.27,-4,36,-1,1.73,4,35.404,7,4.27,0.61,33.404,2,6
168,1.63,0.37,1,0.63,0.4,4.41,8.19,1.63,7.63,13.63,-0.37,-6.37,-12.37,7,13,8,14,0.37,-6,-12,49,91,20,6,6.37,-6,169,12,12.37,6,12.248,1,0.63,0.63,5.247999999999999,7,13
169,1.79,0.21,36,28.44,22.47,66.36,4.74,10.74,18.74,5.74,-1.26,-9.26,3.74,84,6,20,7,1.26,-8,5,196,14,15,8,9.26,13,1,-5,-3.74,-13,31.662,6,4.74,0.79,17.662,14,1
170,1.22,0.78,169,37.18,8.18,8.58,28.6,15.86,5.86,12.86,-10.14,-0.14,-7.14,39,130,16,23,10.14,10,3,9,30,13,-10,0.14,-7,100,-3,7.14,7,124.658,13,2.86,0.22,121.658,3,10
171,1.58,0.42,144,83.52,48.44,97.44,48.72,18.96,20.96,13.96,-5.04,-7.04,-0.04,168,84,26,19,5.04,-2,5,196,98,21,2,7.04,7,49,-5,0.04,-7,94.706,12,6.96,0.58,80.706,14,7
172,1.64,0.36,256,163.84,104.86,163.84,51.2,26.24,26.24,15.24,-5.76,-5.76,5.24,256,80,32,21,5.76,0,11,256,80,21,0,5.76,11,25,-11,-5.24,-11,132.378,16,10.24,0.64,116.37799999999999,16,5
173,1.26,0.74,1,0.26,0.07,3.64,3.38,1.26,14.26,13.26,-0.74,-13.74,-12.74,14,13,15,14,0.74,-13,-12,196,182,27,13,13.74,1,169,12,12.74,-1,23.616,1,0.26,0.26,9.616,14,13
174,1.13,0.87,49,6.37,0.83,10.01,10.01,7.91,11.91,11.91,-6.09,-10.09,-10.09,77,77,18,18,6.09,-4,-4,121,121,22,4,10.09,0,121,4,10.09,0,81.108,7,0.91,0.13,70.108,11,11
175,1.21,0.79,49,10.29,2.16,22.05,26.46,8.47,16.47,19.47,-5.53,-13.53,-16.53,105,126,22,25,5.53,-8,-11,225,270,33,8,13.53,-3,324,11,16.53,3,119.436,7,1.47,0.21,104.436,15,18
176,1.12,0.88,25,3.0,0.36,7.2,4.2,5.6,12.6,7.6,-4.4,-11.4,-6.4,60,35,17,12,4.4,-7,-2,144,84,19,7,11.4,5,49,2,6.4,-5,44.622,5,0.6,0.12,32.622,12,7
177,1.89,0.11,4,3.56,3.17,1.78,10.68,3.78,2.78,7.78,-0.22,0.78,-4.22,2,12,3,8,0.22,1,-4,1,6,7,-1,-0.78,-5,36,4,4.22,5,4.95,2,1.78,0.89,3.95,1,6
178,1.87,0.13,121,105.27,91.58,28.71,114.84,20.57,12.57,21.57,-1.43,6.57,-2.43,33,132,14,23,1.43,8,-1,9,36,15,-8,-6.57,-9,144,1,2.43,9,77.69,11,9.57,0.87,74.69,3,12
179,1.9,0.1,225,202.5,182.25,40.5,162.0,28.5,16.5,25.5,-1.5,10.5,1.5,45,180,18,27,1.5,12,3,9,36,15,-12,-10.5,-9,144,-3,-1.5,9,129.31,15,13.5,0.9,126.31,3,12
180,1.09,0.91,16,1.44,0.13,6.84,7.2,4.36,19.36,20.36,-3.64,-18.64,-19.64,76,80,23,24,3.64,-15,-16,361,380,39,15,18.64,-1,400,16,19.64,1,92.706,4,0.36,0.09,73.706,19,20
181,1.88,0.12,64,56.32,49.56,0.0,133.76,15.04,7.04,26.04,-0.96,7.04,-11.96,0,152,8,27,0.96,8,-11,0,0,19,-8,-7.04,-19,361,11,11.96,19,49.058,8,7.04,0.88,49.058,0,19
182,1.31,0.69,64,19.84,6.15,19.84,32.24,10.48,10.48,15.48,-5.52,-5.52,-10.52,64,104,16,21,5.52,0,-5,64,104,21,0,5.52,-5,169,5,10.52,5,91.636,8,2.48,0.31,83.636,8,13
183,1.08,0.92,36,2.88,0.23,1.92,8.16,6.48,4.48,17.48,-5.52,-3.52,-16.52,24,102,10,23,5.52,2,-11,16,68,21,-2,3.52,-13,289,11,16.52,13,99.092,6,0.48,0.08,95.092,4,17
184,1.79,0.21,1,0.79,0.62,14.22,3.95,1.79,18.79,5.79,-0.21,-17.21,-4.21,18,5,19,6,0.21,-17,-4,324,90,23,17,17.21,13,25,4,4.21,-13,19.904,1,0.79,0.79,1.904,18,5
185,1.62,0.38,9,5.58,3.46,0.0,16.74,4.86,1.86,10.86,-1.14,1.86,-7.14,0,27,3,12,1.14,3,-6,0,0,9,-3,-1.86,-9,81,6,7.14,9,13.778,3,1.86,0.62,13.778,0,9
186,1.91,0.09,256,232.96,211.99,276.64,72.8,30.56,33.56,19.56,-1.44,-4.44,9.56,304,80,35,21,1.44,-3,11,361,95,24,3,4.44,14,25,-11,-9.56,-14,150.46,16,14.56,0.91,131.46,19,5
187,1.86,0.14,225,193.5,166.41,219.3,0.0,27.9,29.9,12.9,-2.1,-4.1,12.9,255,0,32,15,2.1,-2,15,289,0,17,2,4.1,17,0,-15,-12.9,-17,119.716,15,12.9,0.86,102.716,17,0
188,1.33,0.67,121,39.93,13.18,61.71,7.26,14.63,20.63,5.63,-7.37,-13.37,1.63,187,22,28,13,7.37,-6,9,289,34,19,6,13.37,15,4,-9,-1.63,-15,53.108,11,3.63,0.33,36.108,17,2
189,1.73,0.27,81,59.13,43.16,0.0,52.56,15.57,6.57,14.57,-2.43,6.57,-1.43,0,72,9,17,2.43,9,1,0,0,8,-9,-6.57,-8,64,-1,1.43,8,52.392,9,6.57,0.73,52.392,0,8
190,1.81,0.19,196,158.76,128.6,136.08,79.38,25.34,23.34,18.34,-2.66,-0.66,4.34,168,98,26,21,2.66,2,7,144,84,19,-2,0.66,5,49,-7,-4.34,-5,115.43,14,11.34,0.81,103.43,12,7
191,1.93,0.07,256,238.08,221.41,104.16,104.16,30.88,21.88,21.88,-1.12,7.88,7.88,112,112,23,23,1.12,9,9,49,49,14,-9,-7.88,0,49,-9,-7.88,0,141.46,16,14.88,0.93,134.46,7,7
192,1.8,0.2,36,28.8,23.04,9.6,38.4,10.8,6.8,12.8,-1.2,2.8,-3.2,12,48,8,14,1.2,4,-2,4,16,10,-4,-2.8,-6,64,2,3.2,6,28.454,6,4.8,0.8,26.454,2,8
193,1.88,0.12,169,148.72,130.87,34.32,228.8,24.44,14.44,31.44,-1.56,8.44,-8.56,39,260,16,33,1.56,10,-7,9,60,23,-10,-8.44,-17,400,7,8.56,17,113.874,13,11.44,0.88,110.874,3,20
194,1.24,0.76,81,19.44,4.67,8.64,19.44,11.16,6.16,11.16,-6.84,-1.84,-6.84,36,81,13,18,6.84,5,0,16,36,13,-5,1.84,-5,81,0,6.84,5,76.276,9,2.16,0.24,72.276,4,9
195,1.89,0.11,36,32.04,28.52,85.44,42.72,11.34,21.34,13.34,-0.66,-10.66,-2.66,96,48,22,14,0.66,-10,-2,256,128,24,10,10.66,8,64,2,2.66,-8,40.142,6,5.34,0.89,24.142000000000003,16,8
196,1.41,0.59,324,132.84,54.46,88.56,88.56,25.38,19.38,19.38,-10.62,-4.62,-4.62,216,216,30,30,10.62,6,6,144,144,24,-6,4.62,0,144,-6,4.62,0,209.724,18,7.38,0.41,197.724,12,12
197,1.15,0.85,100,15.0,2.25,10.5,18.0,11.5,8.5,13.5,-8.5,-5.5,-10.5,70,120,17,22,8.5,3,-2,49,84,19,-3,5.5,-5,144,2,10.5,5,117.4,10,1.5,0.15,110.4,7,12
198,1.58,0.42,1,0.58,0.34,8.12,2.32,1.58,14.58,4.58,-0.42,-13.42,-3.42,14,4,15,5,0.42,-13,-3,196,56,18,13,13.42,10,16,3,3.42,-10,16.302,1,0.58,0.58,2.3019999999999996,14,4
199,1.84,0.16,169,141.96,119.25,32.76,32.76,23.92,13.92,13.92,-2.08,7.92,7.92,39,39,16,16,2.08,10,10,9,9,6,-10,-7.92,0,9,-10,-7.92,0,85.974,13,10.92,0.84,82.974,3,3
200,1.92,0.08,4,3.68,3.39,3.68,29.44,3.84,3.84,17.84,-0.16,-0.16,-14.16,4,32,4,18,0.16,0,-14,4,32,18,0,0.16,-14,256,14,14.16,14,7.028,2,1.84,0.92,5.028,2,16
201,1.12,0.88,4,0.48,0.06,1.68,1.44,2.24,7.24,6.24,-1.76,-6.76,-5.76,14,12,9,8,1.76,-5,-4,49,42,13,5,6.76,1,36,4,5.76,-1,18.038,2,0.24,0.12,11.038,7,6
202,1.69,0.31,1,0.69,0.48,2.07,2.07,1.69,3.69,3.69,-0.31,-2.31,-2.31,3,3,4,4,0.31,-2,-2,9,9,6,2,2.31,0,9,2,2.31,0,4.636,1,0.69,0.69,1.6360000000000001,3,3
203,1.41,0.59,64,26.24,10.76,62.32,9.84,11.28,22.28,6.28,-4.72,-15.72,0.28,152,24,27,11,4.72,-11,5,361,57,22,11,15.72,16,9,-5,-0.28,-16,47.706,8,3.28,0.41,28.706000000000003,19,3
204,1.72,0.28,1,0.72,0.52,5.04,2.16,1.72,7.72,3.72,-0.28,-6.28,-2.28,7,3,8,4,0.28,-6,-2,49,21,10,6,6.28,4,9,2,2.28,-4,8.612,1,0.72,0.72,1.612,7,3
205,1.5,0.5,16,8.0,4.0,14.0,22.0,6.0,9.0,13.0,-2.0,-5.0,-9.0,28,44,11,15,2.0,-3,-7,49,77,18,3,5.0,-4,121,7,9.0,4,34.144,4,2.0,0.5,27.144,7,11
206,1.46,0.54,324,149.04,68.56,8.28,33.12,26.28,9.28,12.28,-9.72,7.28,4.28,18,72,19,22,9.72,17,14,1,4,5,-17,-7.28,-3,16,-14,-4.28,3,118.308,18,8.28,0.46,117.308,1,4
207,1.88,0.12,25,22.0,19.36,0.0,13.2,9.4,4.4,7.4,-0.6,4.4,1.4,0,15,5,8,0.6,5,2,0,0,3,-5,-4.4,-3,9,-2,-1.4,3,15.044,5,4.4,0.88,15.044,0,3
208,1.38,0.62,25,9.5,3.61,36.1,0.0,6.9,20.9,1.9,-3.1,-17.1,1.9,95,0,24,5,3.1,-14,5,361,0,19,14,17.1,19,0,-5,-1.9,-19,24.432,5,1.9,0.38,5.431999999999999,19,0
209,1.45,0.55,9,4.05,1.82,4.05,9.45,4.35,4.35,8.35,-1.65,-1.65,-5.65,9,21,6,10,1.65,0,-4,9,21,10,0,1.65,-4,49,4,5.65,4,17.204,3,1.35,0.45,14.204,3,7
210,1.9,0.1,1,0.9,0.81,9.9,1.8,1.9,11.9,2.9,-0.1,-10.1,-1.1,11,2,12,3,0.1,-10,-1,121,22,13,10,10.1,9,4,1,1.1,-9,12.118,1,0.9,0.9,1.1180000000000003,11,2
211,1.24,0.76,400,96.0,23.04,81.6,57.6,24.8,21.8,16.8,-15.2,-12.2,-7.2,340,240,37,32,15.2,3,8,289,204,29,-3,12.2,5,144,-8,7.2,-5,249.55,20,4.8,0.24,232.55,17,12
212,1.78,0.22,400,312.0,243.36,218.4,249.6,35.6,29.6,31.6,-4.4,1.6,-0.4,280,320,34,36,4.4,6,4,196,224,30,-6,-1.6,-2,256,-4,0.4,2,248.558,20,15.6,0.78,234.558,14,16
213,1.36,0.64,9,3.24,1.17,10.8,19.44,4.08,11.08,19.08,-1.92,-8.92,-16.92,30,54,13,21,1.92,-7,-15,100,180,28,7,8.92,-8,324,15,16.92,8,47.154,3,1.08,0.36,37.154,10,18
214,1.5,0.5,225,112.5,56.25,52.5,135.0,22.5,14.5,25.5,-7.5,0.5,-10.5,105,270,22,33,7.5,8,-3,49,126,25,-8,-0.5,-11,324,3,10.5,11,201.558,15,7.5,0.5,194.558,7,18
215,1.26,0.74,196,50.96,13.25,21.84,25.48,17.64,9.64,10.64,-10.36,-2.36,-3.36,84,98,20,21,10.36,8,7,36,42,13,-8,2.36,-1,49,-7,3.36,1,105.484,14,3.64,0.26,99.484,6,7
216,1.14,0.86,9,1.26,0.18,5.46,3.36,3.42,13.42,8.42,-2.58,-12.58,-7.58,39,24,16,11,2.58,-10,-5,169,104,21,10,12.58,5,64,5,7.58,-5,34.606,3,0.42,0.14,21.606,13,8
217,1.77,0.23,16,12.32,9.49,21.56,33.88,7.08,10.08,14.08,-0.92,-3.92,-7.92,28,44,11,15,0.92,-3,-7,49,77,18,3,3.92,-4,121,7,7.92,4,24.438,4,3.08,0.77,17.438,7,11
218,1.25,0.75,25,6.25,1.56,22.5,2.5,6.25,19.25,3.25,-3.75,-16.75,-0.75,90,10,23,7,3.75,-13,3,324,36,20,13,16.75,16,4,-3,0.75,-16,29.414,5,1.25,0.25,11.414000000000001,18,2
219,1.81,0.19,361,292.41,236.85,123.12,184.68,34.39,23.39,27.39,-3.61,7.39,3.39,152,228,27,31,3.61,11,7,64,96,20,-11,-7.39,-4,144,-7,-3.39,4,205.576,19,15.39,0.81,197.576,8,12
220,1.34,0.66,289,98.26,33.41,11.56,109.82,22.78,7.78,24.78,-11.22,3.78,-13.22,34,323,19,36,11.22,15,-2,4,38,21,-15,-3.78,-17,361,2,13.22,17,265.726,17,5.78,0.34,263.726,2,19
221,1.06,0.94,256,15.36,0.92,16.32,12.48,16.96,17.96,13.96,-15.04,-16.04,-12.04,272,208,33,29,15.04,-1,3,289,221,30,1,16.04,4,169,-3,12.04,-4,220.648,16,0.96,0.06,203.648,17,13
222,1.37,0.63,361,133.57,49.42,98.42,70.3,26.03,21.03,17.03,-11.97,-6.97,-2.97,266,190,33,29,11.97,5,9,196,140,24,-5,6.97,4,100,-9,2.97,-4,203.776,19,7.03,0.37,189.776,14,10
223,1.86,0.14,121,104.06,89.49,56.76,151.36,20.46,15.46,25.46,-1.54,3.46,-6.54,66,176,17,27,1.54,5,-5,36,96,22,-5,-3.46,-10,256,5,6.54,10,87.408,11,9.46,0.86,81.408,6,16
224,1.6,0.4,324,194.4,116.64,43.2,183.6,28.8,14.8,27.8,-7.2,6.8,-6.2,72,306,22,35,7.2,14,1,16,68,21,-14,-6.8,-13,289,-1,6.2,13,229.204,18,10.8,0.6,225.204,4,17
225,1.86,0.14,81,69.66,59.91,38.7,131.58,16.74,12.74,24.74,-1.26,2.74,-9.26,45,153,14,26,1.26,4,-8,25,85,22,-4,-2.74,-12,289,8,9.26,12,65.454,9,7.74,0.86,60.45399999999999,5,17
226,1.88,0.12,16,14.08,12.39,21.12,17.6,7.52,9.52,8.52,-0.48,-2.48,-1.48,24,20,10,9,0.48,-2,-1,36,30,11,2,2.48,1,25,1,1.48,-1,17.254,4,3.52,0.88,11.254000000000001,6,5
227,1.76,0.24,64,48.64,36.97,79.04,42.56,14.08,19.08,13.08,-1.92,-6.92,-0.92,104,56,21,15,1.92,-5,1,169,91,20,5,6.92,6,49,-1,0.92,-6,53.316,8,6.08,0.76,40.316,13,7
228,1.36,0.64,36,12.96,4.67,23.76,36.72,8.16,13.16,19.16,-3.84,-8.84,-14.84,66,102,17,23,3.84,-5,-11,121,187,28,5,8.84,-6,289,11,14.84,6,84.02,6,2.16,0.36,73.02,11,17
229,1.2,0.8,36,7.2,1.44,0.0,3.6,7.2,1.2,4.2,-4.8,1.2,-1.8,0,18,6,9,4.8,6,3,0,0,3,-6,-1.2,-3,9,-3,1.8,3,18.732,6,1.2,0.2,18.732,0,3
230,1.41,0.59,25,10.25,4.2,14.35,26.65,7.05,9.05,15.05,-2.95,-4.95,-10.95,35,65,12,18,2.95,-2,-8,49,91,20,2,4.95,-6,169,8,10.95,6,51.162,5,2.05,0.41,44.162,7,13
231,1.24,0.76,196,47.04,11.29,0.0,50.4,17.36,3.36,18.36,-10.64,3.36,-11.64,0,210,14,29,10.64,14,-1,0,0,15,-14,-3.36,-15,225,1,11.64,15,184.468,14,3.36,0.24,184.468,0,15
232,1.34,0.66,196,66.64,22.66,61.88,95.2,18.76,17.76,24.76,-9.24,-8.24,-15.24,182,280,27,34,9.24,1,-6,169,260,33,-1,8.24,-7,400,6,15.24,7,233.368,14,4.76,0.34,220.368,13,20
233,1.29,0.71,144,41.76,12.11,52.2,59.16,15.48,18.48,20.48,-8.52,-11.52,-13.52,180,204,27,29,8.52,-3,-5,225,255,32,3,11.52,-2,289,5,13.52,2,183.22,12,3.48,0.29,168.22,15,17
234,1.54,0.46,225,121.5,65.61,72.9,56.7,23.1,17.1,15.1,-6.9,-0.9,1.1,135,105,24,22,6.9,6,8,81,63,16,-6,0.9,2,49,-8,-1.1,-2,122.294,15,8.1,0.54,113.294,9,7
235,1.68,0.32,169,114.92,78.15,132.6,159.12,21.84,23.84,26.84,-4.16,-6.16,-9.16,195,234,28,31,4.16,-2,-5,225,270,33,2,6.16,-3,324,5,9.16,3,151.166,13,8.84,0.68,136.166,15,18
236,1.9,0.1,1,0.9,0.81,8.1,13.5,1.9,9.9,15.9,-0.1,-8.1,-14.1,9,15,10,16,0.1,-8,-14,81,135,24,8,8.1,-6,225,14,14.1,6,11.596,1,0.9,0.9,2.596,9,15
237,1.34,0.66,64,21.76,7.4,43.52,38.08,10.72,18.72,16.72,-5.28,-13.28,-11.28,128,112,24,22,5.28,-8,-6,256,224,30,8,13.28,2,196,6,11.28,-2,102.108,8,2.72,0.34,86.108,16,14
238,1.08,0.92,324,25.92,2.07,15.84,18.72,19.44,12.44,14.44,-16.56,-9.56,-11.56,198,234,29,31,16.56,7,5,121,143,24,-7,9.56,-2,169,-5,11.56,2,239.988,18,1.44,0.08,228.988,11,13
239,1.14,0.86,25,3.5,0.49,14.0,3.5,5.7,20.7,5.7,-4.3,-19.3,-4.3,100,25,25,10,4.3,-15,0,400,100,25,15,19.3,15,25,0,4.3,-15,43.432,5,0.7,0.14,23.432000000000002,20,5
240,1.38,0.62,121,45.98,17.47,75.24,4.18,15.18,22.18,5.18,-6.82,-13.82,3.18,198,11,29,12,6.82,-7,10,324,18,19,7,13.82,17,1,-10,-3.18,-17,50.73,11,4.18,0.38,32.73,18,1
241,1.8,0.2,25,20.0,16.0,56.0,72.0,9.0,18.0,22.0,-1.0,-10.0,-14.0,70,90,19,23,1.0,-9,-13,196,252,32,9,10.0,-4,324,13,14.0,4,44.006,5,4.0,0.8,30.006,14,18
242,1.43,0.57,324,139.32,59.91,23.22,23.22,25.74,10.74,10.74,-10.26,4.74,4.74,54,54,21,21,10.26,15,15,9,9,6,-15,-4.74,0,9,-15,-4.74,0,107.676,18,7.74,0.43,104.676,3,3
243,1.89,0.11,16,14.24,12.67,21.36,39.16,7.56,9.56,14.56,-0.44,-2.44,-7.44,24,44,10,15,0.44,-2,-7,36,66,17,2,2.44,-5,121,7,7.44,5,19.974,4,3.56,0.89,13.974,6,11
244,1.79,0.21,4,3.16,2.5,3.16,15.8,3.58,3.58,11.58,-0.42,-0.42,-8.42,4,20,4,12,0.42,0,-8,4,20,12,0,0.42,-8,100,8,8.42,8,8.762,2,1.58,0.79,6.7620000000000005,2,10
245,1.7,0.3,169,118.3,82.81,63.7,45.5,22.1,16.1,14.1,-3.9,2.1,4.1,91,65,20,18,3.9,6,8,49,35,12,-6,-2.1,2,25,-8,-4.1,-2,90.19,13,9.1,0.7,83.19,7,5
246,1.38,0.62,16,6.08,2.31,21.28,25.84,5.52,15.52,18.52,-2.48,-12.48,-15.48,56,68,18,21,2.48,-10,-13,196,238,31,10,12.48,-3,289,13,15.48,3,59.62,4,1.52,0.38,45.62,14,17
247,1.3,0.7,16,4.8,1.44,24.0,8.4,5.2,21.2,8.2,-2.8,-18.8,-5.8,80,28,24,11,2.8,-16,-3,400,140,27,16,18.8,13,49,3,5.8,-13,42.546,4,1.2,0.3,22.546,20,7
248,1.84,0.16,9,7.56,6.35,10.08,50.4,5.52,6.52,22.52,-0.48,-1.48,-17.48,12,60,7,23,0.48,-1,-17,16,80,24,1,1.48,-16,400,17,17.48,16,18.626,3,2.52,0.84,14.626000000000001,4,20
249,1.49,0.51,64,31.36,15.37,58.8,39.2,11.92,18.92,13.92,-4.08,-11.08,-6.08,120,80,23,18,4.08,-7,-2,225,150,25,7,11.08,5,100,2,6.08,-5,73.502,8,3.92,0.49,58.501999999999995,15,10
250,1.82,0.18,400,328.0,268.96,32.8,0.0,36.4,18.4,16.4,-3.6,14.4,16.4,40,0,22,20,3.6,18,20,4,0,2,-18,-14.4,2,0,-20,-16.4,-2,175.858,20,16.4,0.82,173.858,2,0
251,1.56,0.44,225,126.0,70.56,50.4,50.4,23.4,14.4,14.4,-6.6,2.4,2.4,90,90,21,21,6.6,9,9,36,36,12,-9,-2.4,0,36,-9,-2.4,0,112.774,15,8.4,0.56,106.774,6,6
252,1.38,0.62,1,0.38,0.14,3.42,5.7,1.38,9.38,15.38,-0.62,-8.62,-14.62,9,15,10,16,0.62,-8,-14,81,135,24,8,8.62,-6,225,14,14.62,6,18.484,1,0.38,0.38,9.484000000000002,9,15
253,1.19,0.81,16,3.04,0.58,7.6,8.36,4.76,10.76,11.76,-3.24,-9.24,-10.24,40,44,14,15,3.24,-6,-7,100,110,21,6,9.24,-1,121,7,10.24,1,46.984,4,0.76,0.19,36.984,10,11
254,1.64,0.36,4,2.56,1.64,20.48,3.84,3.28,17.28,4.28,-0.72,-14.72,-1.72,32,6,18,5,0.72,-14,-1,256,48,19,14,14.72,13,9,1,1.72,-13,20.024,2,1.28,0.64,4.024000000000001,16,3
255,1.88,0.12,256,225.28,198.25,112.64,112.64,30.08,22.08,22.08,-1.92,6.08,6.08,128,128,24,24,1.92,8,8,64,64,16,-8,-6.08,0,64,-8,-6.08,0,143.27,16,14.08,0.88,135.27,8,8
256,1.81,0.19,25,20.25,16.4,64.8,60.75,9.05,20.05,19.05,-0.95,-11.95,-10.95,80,75,21,20,0.95,-11,-10,256,240,31,11,11.95,1,225,10,10.95,-1,42.592,5,4.05,0.81,26.592,16,15
257,1.6,0.4,81,48.6,29.16,43.2,86.4,14.4,13.4,21.4,-3.6,-2.6,-10.6,72,144,17,25,3.6,1,-7,64,128,24,-1,2.6,-8,256,7,10.6,8,93.24,9,5.4,0.6,85.24,8,16
258,1.55,0.45,49,26.95,14.82,7.7,23.1,10.85,5.85,9.85,-3.15,1.85,-2.15,14,42,9,13,3.15,5,1,4,12,8,-5,-1.85,-4,36,-1,2.15,4,36.174,7,3.85,0.55,34.174,2,6
259,1.14,0.86,324,45.36,6.35,22.68,7.56,20.52,11.52,5.52,-15.48,-6.48,-0.48,162,54,27,21,15.48,9,15,81,27,12,-9,6.48,6,9,-15,0.48,-6,79.508,18,2.52,0.14,70.508,9,3
260,1.52,0.48,169,87.88,45.7,94.64,94.64,19.76,20.76,20.76,-6.24,-7.24,-7.24,182,182,27,27,6.24,-1,-1,196,196,28,1,7.24,0,196,1,7.24,0,149.722,13,6.76,0.52,135.722,14,14
261,1.91,0.09,400,364.0,331.24,327.6,91.0,38.2,36.2,23.2,-1.8,0.2,13.2,360,100,38,25,1.8,2,15,324,90,23,-2,-0.2,13,25,-15,-13.2,-13,218.266,20,18.2,0.91,200.266,18,5
262,1.62,0.38,144,89.28,55.35,22.32,0.0,19.44,10.44,7.44,-4.56,4.44,7.44,36,0,15,12,4.56,9,12,9,0,3,-9,-4.44,3,0,-12,-7.44,-3,51.37,12,7.44,0.62,48.37,3,0
263,1.25,0.75,289,72.25,18.06,25.5,17.0,21.25,10.25,8.25,-12.75,-1.75,0.25,102,68,23,21,12.75,11,13,36,24,10,-11,1.75,2,16,-13,-0.25,-2,95.494,17,4.25,0.25,89.494,6,4
264,1.94,0.06,196,184.24,173.19,184.24,26.32,27.16,27.16,15.16,-0.84,-0.84,11.16,196,28,28,16,0.84,0,12,196,28,16,0,0.84,12,4,-12,-11.16,-12,114.464,14,13.16,0.94,100.464,14,2
265,1.86,0.14,81,69.66,59.91,0.0,154.8,16.74,7.74,27.74,-1.26,7.74,-12.26,0,180,9,29,1.26,9,-11,0,0,20,-9,-7.74,-20,400,11,12.26,20,64.446,9,7.74,0.86,64.446,0,20
266,1.6,0.4,256,153.6,92.16,28.8,48.0,25.6,12.6,14.6,-6.4,6.6,4.6,48,80,19,21,6.4,13,11,9,15,8,-13,-6.6,-2,25,-11,-4.6,2,116.474,16,9.6,0.6,113.474,3,5
267,1.13,0.87,81,10.53,1.37,23.4,17.55,10.17,21.17,16.17,-7.83,-18.83,-13.83,180,135,29,24,7.83,-11,-6,400,300,35,11,18.83,5,225,6,13.83,-5,143.732,9,1.17,0.13,123.732,20,15
268,1.7,0.3,400,280.0,196.0,14.0,70.0,34.0,15.0,19.0,-6.0,13.0,9.0,20,100,21,25,6.0,19,15,1,5,6,-19,-13.0,-4,25,-15,-9.0,4,176.576,20,14.0,0.7,175.576,1,5
269,1.05,0.95,9,0.45,0.02,2.55,0.3,3.15,17.15,2.15,-2.85,-16.85,-1.85,51,6,20,5,2.85,-14,1,289,34,19,14,16.85,15,4,-1,1.85,-15,23.002,3,0.15,0.05,6.001999999999999,17,2
270,1.43,0.57,225,96.75,41.6,129.0,116.1,21.45,26.45,24.45,-8.55,-13.55,-11.55,300,270,35,33,8.55,-5,-3,400,360,38,5,13.55,2,324,3,11.55,-2,224.454,15,6.45,0.43,204.454,20,18
271,1.69,0.31,324,223.56,154.26,186.3,0.0,30.42,27.42,12.42,-5.58,-2.58,12.42,270,0,33,18,5.58,3,18,225,0,15,-3,2.58,15,0,-18,-12.42,-15,131.328,18,12.42,0.69,116.328,15,0
272,1.38,0.62,64,24.32,9.24,45.6,51.68,11.04,18.04,20.04,-4.96,-11.96,-13.96,120,136,23,25,4.96,-7,-9,225,255,32,7,11.96,-2,289,9,13.96,2,115.552,8,3.04,0.38,100.552,15,17
273,1.41,0.59,400,164.0,67.24,57.4,65.6,28.2,15.2,16.2,-11.8,1.2,0.2,140,160,27,28,11.8,13,12,49,56,15,-13,-1.2,-1,64,-12,-0.2,1,187.384,20,8.2,0.41,180.384,7,8
274,1.65,0.35,144,93.6,60.84,124.8,85.8,19.8,23.8,18.8,-4.2,-8.2,-3.2,192,132,28,23,4.2,-4,1,256,176,27,4,8.2,5,121,-1,3.2,-5,112.714,12,7.8,0.65,96.714,16,11
275,1.36,0.64,9,3.24,1.17,14.04,17.28,4.08,14.08,17.08,-1.92,-11.92,-14.92,39,48,16,19,1.92,-10,-13,169,208,29,10,11.92,-3,256,13,14.92,3,44.342,3,1.08,0.36,31.342,13,16
276,1.61,0.39,196,119.56,72.93,170.8,42.7,22.54,28.54,13.54,-5.46,-11.46,3.54,280,70,34,19,5.46,-6,9,400,100,25,6,11.46,15,25,-9,-3.54,-15,110.916,14,8.54,0.61,90.916,20,5
277,1.68,0.32,9,6.12,4.16,16.32,24.48,5.04,10.04,14.04,-0.96,-5.96,-9.96,24,36,11,15,0.96,-5,-9,64,96,20,5,5.96,-4,144,9,9.96,4,23.94,3,2.04,0.68,15.940000000000001,8,12
278,1.9,0.1,36,32.4,29.16,81.0,43.2,11.4,20.4,13.4,-0.6,-9.6,-2.6,90,48,21,14,0.6,-9,-2,225,120,23,9,9.6,7,64,2,2.6,-7,38.402,6,5.4,0.9,23.402,15,8
279,1.42,0.58,400,168.0,70.56,75.6,33.6,28.4,17.4,12.4,-11.6,-0.6,4.4,180,80,29,24,11.6,11,16,81,36,13,-11,0.6,5,16,-16,-4.4,-5,142.82,20,8.4,0.42,133.82,9,4
280,1.15,0.85,169,25.35,3.8,11.7,39.0,14.95,7.95,21.95,-11.05,-4.05,-18.05,78,260,19,33,11.05,7,-7,36,120,26,-7,4.05,-14,400,7,18.05,14,240.54,13,1.95,0.15,234.54,6,20
281,1.42,0.58,289,121.38,50.98,7.14,78.54,24.14,8.14,18.14,-9.86,6.14,-3.86,17,187,18,28,9.86,16,6,1,11,12,-16,-6.14,-10,121,-6,3.86,10,174.022,17,7.14,0.42,173.022,1,11
282,1.43,0.57,144,61.92,26.63,10.32,103.2,17.16,7.16,25.16,-6.84,3.16,-14.84,24,240,14,32,6.84,10,-8,4,40,22,-10,-3.16,-18,400,8,14.84,18,171.534,12,5.16,0.43,169.534,2,20
283,1.18,0.82,196,35.28,6.35,32.76,42.84,16.52,15.52,19.52,-11.48,-10.48,-14.48,182,238,27,31,11.48,1,-3,169,221,30,-1,10.48,-4,289,3,14.48,4,226.644,14,2.52,0.18,213.644,13,17
284,1.24,0.76,121,29.04,6.97,42.24,36.96,13.64,18.64,16.64,-8.36,-13.36,-11.36,176,154,27,25,8.36,-5,-3,256,224,30,5,13.36,2,196,3,11.36,-2,148.868,11,2.64,0.24,132.868,16,14
285,1.59,0.41,49,28.91,17.06,33.04,57.82,11.13,12.13,18.13,-2.87,-3.87,-9.87,56,98,15,21,2.87,-1,-7,64,112,22,1,3.87,-6,196,7,9.87,6,64.712,7,4.13,0.59,56.712,8,14
286,1.76,0.24,361,274.36,208.51,274.36,144.4,33.44,33.44,24.44,-4.56,-4.56,4.44,361,190,38,29,4.56,0,9,361,190,29,0,4.56,9,100,-9,-4.44,-9,209.304,19,14.44,0.76,190.304,19,10
287,1.37,0.63,169,62.53,23.14,24.05,57.72,17.81,9.81,16.81,-8.19,-0.19,-7.19,65,156,18,25,8.19,8,1,25,60,17,-8,0.19,-7,144,-1,7.19,7,136.972,13,4.81,0.37,131.972,5,12
288,1.84,0.16,169,141.96,119.25,141.96,174.72,23.92,23.92,26.92,-2.08,-2.08,-5.08,169,208,26,29,2.08,0,-3,169,208,29,0,2.08,-3,256,3,5.08,3,123.27,13,10.92,0.84,110.27,13,16
289,1.92,0.08,16,14.72,13.54,44.16,47.84,7.68,15.68,16.68,-0.32,-8.32,-9.32,48,52,16,17,0.32,-8,-9,144,156,25,8,8.32,-1,169,9,9.32,1,24.918,4,3.68,0.92,12.918,12,13
290,1.94,0.06,289,271.66,255.36,255.68,31.96,32.98,31.98,17.98,-1.02,-0.02,13.98,272,34,33,19,1.02,1,15,256,32,18,-1,0.02,14,4,-15,-13.98,-14,161.912,17,15.98,0.94,145.912,16,2
291,1.08,0.92,81,6.48,0.52,10.8,12.24,9.72,15.72,17.72,-8.28,-14.28,-16.28,135,153,24,26,8.28,-6,-8,225,255,32,6,14.28,-2,289,8,16.28,2,159.018,9,0.72,0.08,144.018,15,17
292,1.14,0.86,225,31.5,4.41,27.3,10.5,17.1,15.1,7.1,-12.9,-10.9,-2.9,195,75,28,20,12.9,2,10,169,65,18,-2,10.9,8,25,-10,2.9,-8,93.74,15,2.1,0.14,80.74,13,5
293,1.35,0.65,100,35.0,12.25,63.0,45.5,13.5,21.5,16.5,-6.5,-14.5,-9.5,180,130,28,23,6.5,-8,-3,324,234,31,8,14.5,5,169,3,9.5,-5,121.554,10,3.5,0.35,103.554,18,13
294,1.36,0.64,256,92.16,33.18,17.28,109.44,21.76,8.76,24.76,-10.24,2.76,-13.24,48,304,19,35,10.24,13,-3,9,57,22,-13,-2.76,-16,361,3,13.24,16,247.06,16,5.76,0.36,244.06,3,19
295,1.53,0.47,324,171.72,91.01,0.0,152.64,27.54,9.54,25.54,-8.46,9.54,-6.46,0,288,18,34,8.46,18,2,0,0,16,-18,-9.54,-16,256,-2,6.46,16,226.43,18,9.54,0.53,226.43,0,16
296,1.15,0.85,169,25.35,3.8,3.9,23.4,14.95,3.95,13.95,-11.05,-0.05,-10.05,26,156,15,25,11.05,11,1,4,24,14,-11,0.05,-10,144,-1,10.05,10,148.604,13,1.95,0.15,146.604,2,12
297,1.88,0.12,225,198.0,174.24,237.6,211.2,28.2,31.2,29.2,-1.8,-4.8,-2.8,270,240,33,31,1.8,-3,-1,324,288,34,3,4.8,2,256,1,2.8,-2,152.308,15,13.2,0.88,134.308,18,16
298,1.66,0.34,4,2.64,1.74,18.48,7.92,3.32,15.32,7.32,-0.68,-12.68,-4.68,28,12,16,8,0.68,-12,-4,196,84,20,12,12.68,8,36,4,4.68,-8,20.002,2,1.32,0.66,6.001999999999999,14,6
299,1.57,0.43,64,36.48,20.79,27.36,41.04,12.56,10.56,13.56,-3.44,-1.44,-4.44,48,72,14,17,3.44,2,-1,36,54,15,-2,1.44,-3,81,1,4.44,3,57.996,8,4.56,0.57,51.996,6,9
300,1.19,0.81,1,0.19,0.04,2.28,3.42,1.19,12.19,18.19,-0.81,-11.81,-17.81,12,18,13,19,0.81,-11,-17,144,216,30,11,11.81,-6,324,17,17.81,6,26.668,1,0.19,0.19,14.668,12,18
301,1.57,0.43,49,27.93,15.92,47.88,31.92,10.99,15.99,11.99,-3.01,-8.01,-4.01,84,56,19,15,3.01,-5,-1,144,96,20,5,8.01,4,64,1,4.01,-4,51.842,7,3.99,0.57,39.842,12,8
302,1.45,0.55,16,7.2,3.24,5.4,30.6,5.8,4.8,18.8,-2.2,-1.2,-15.2,12,68,7,21,2.2,1,-13,9,51,20,-1,1.2,-14,289,13,15.2,14,45.412,4,1.8,0.45,42.412,3,17
303,1.5,0.5,121,60.5,30.25,82.5,82.5,16.5,20.5,20.5,-5.5,-9.5,-9.5,165,165,26,26,5.5,-4,-4,225,225,30,4,9.5,0,225,4,9.5,0,130.184,11,5.5,0.5,115.184,15,15
304,1.61,0.39,324,197.64,120.56,153.72,186.66,28.98,24.98,27.98,-7.02,-3.02,-6.02,252,306,32,35,7.02,4,1,196,238,31,-4,3.02,-3,289,-1,6.02,3,238.108,18,10.98,0.61,224.108,14,17
305,1.5,0.5,81,40.5,20.25,18.0,40.5,13.5,8.5,13.5,-4.5,0.5,-4.5,36,81,13,18,4.5,5,0,16,36,13,-5,-0.5,-5,81,0,4.5,5,67.38,9,4.5,0.5,63.379999999999995,4,9
306,1.56,0.44,4,2.24,1.25,5.6,8.96,3.12,6.12,9.12,-0.88,-3.88,-6.88,10,16,7,10,0.88,-3,-6,25,40,13,3,3.88,-3,64,6,6.88,3,13.646,2,1.12,0.56,8.646,5,8
307,1.31,0.69,169,52.39,16.24,12.09,40.3,17.03,7.03,14.03,-8.97,1.03,-5.97,39,130,16,23,8.97,10,3,9,30,13,-10,-1.03,-7,100,-3,5.97,7,120.24,13,4.03,0.31,117.24,3,10
308,1.58,0.42,121,70.18,40.7,38.28,25.52,17.38,12.38,10.38,-4.62,0.38,2.38,66,44,17,15,4.62,5,7,36,24,10,-5,-0.38,2,16,-7,-2.38,-2,62.55,11,6.38,0.58,56.55,6,4
309,1.09,0.91,49,4.41,0.4,1.26,6.93,7.63,2.63,11.63,-6.37,-1.37,-10.37,14,77,9,18,6.37,5,-4,4,22,13,-5,1.37,-9,121,4,10.37,9,74.59,7,0.63,0.09,72.59,2,11
310,1.19,0.81,100,19.0,3.61,34.2,30.4,11.9,19.9,17.9,-8.1,-16.1,-14.1,180,160,28,26,8.1,-8,-6,324,288,34,8,16.1,2,256,6,14.1,-2,157.674,10,1.9,0.19,139.674,18,16
311,1.72,0.28,400,288.0,207.36,28.8,43.2,34.4,16.4,17.4,-5.6,12.4,11.4,40,60,22,23,5.6,18,17,4,6,5,-18,-12.4,-1,9,-17,-11.4,1,169.72,20,14.4,0.72,167.72,2,3
312,1.87,0.13,81,70.47,61.31,54.81,140.94,16.83,14.83,25.83,-1.17,0.83,-10.17,63,162,16,27,1.17,2,-9,49,126,25,-2,-0.83,-11,324,9,10.17,11,66.398,9,7.83,0.87,59.397999999999996,7,18
313,1.36,0.64,196,70.56,25.4,20.16,65.52,19.04,9.04,18.04,-8.96,1.04,-7.96,56,182,18,27,8.96,10,1,16,52,17,-10,-1.04,-9,169,-1,7.96,9,159.19,14,5.04,0.36,155.19,4,13
314,1.88,0.12,81,71.28,62.73,142.56,142.56,16.92,25.92,25.92,-1.08,-10.08,-10.08,162,162,27,27,1.08,-9,-9,324,324,36,9,10.08,0,324,9,10.08,0,77.326,9,7.92,0.88,59.32599999999999,18,18
315,1.52,0.48,25,13.0,6.76,2.6,18.2,7.6,3.6,9.6,-2.4,1.6,-4.4,5,35,6,12,2.4,4,-2,1,7,8,-4,-1.6,-6,49,2,4.4,6,25.434,5,2.6,0.52,24.434,1,7
316,1.91,0.09,81,73.71,67.08,106.47,155.61,17.19,21.19,27.19,-0.81,-4.81,-10.81,117,171,22,28,0.81,-4,-10,169,247,32,4,4.81,-6,361,10,10.81,6,69.642,9,8.19,0.91,56.641999999999996,13,19
317,1.53,0.47,121,64.13,33.99,17.49,99.11,16.83,8.83,22.83,-5.17,2.83,-11.17,33,187,14,28,5.17,8,-6,9,51,20,-8,-2.83,-14,289,6,11.17,14,125.278,11,5.83,0.53,122.278,3,17
318,1.34,0.66,4,1.36,0.46,4.76,10.2,2.68,7.68,15.68,-1.32,-6.32,-14.32,14,30,9,17,1.32,-5,-13,49,105,22,5,6.32,-8,225,13,14.32,8,27.736,2,0.68,0.34,20.736,7,15
319,1.3,0.7,121,36.3,10.89,46.2,52.8,14.3,17.3,19.3,-7.7,-10.7,-12.7,154,176,25,27,7.7,-3,-5,196,224,30,3,10.7,-2,256,5,12.7,2,157.346,11,3.3,0.3,143.346,14,16
320,1.44,0.56,1,0.44,0.19,7.04,8.8,1.44,16.44,20.44,-0.56,-15.56,-19.56,16,20,17,21,0.56,-15,-19,256,320,36,15,15.56,-4,400,19,19.56,4,26.994,1,0.44,0.44,10.994,16,20
321,1.32,0.68,100,32.0,10.24,28.8,16.0,13.2,12.2,8.2,-6.8,-5.8,-1.8,90,50,19,15,6.8,1,5,81,45,14,-1,5.8,4,25,-5,1.8,-4,60.708,10,3.2,0.32,51.708,9,5
322,1.86,0.14,25,21.5,18.49,47.3,64.5,9.3,15.3,19.3,-0.7,-6.7,-10.7,55,75,16,20,0.7,-6,-10,121,165,26,6,6.7,-4,225,10,10.7,4,34.446,5,4.3,0.86,23.445999999999998,11,15
323,1.2,0.8,64,12.8,2.56,32.0,4.8,9.6,21.6,4.6,-6.4,-18.4,-1.4,160,24,28,11,6.4,-12,5,400,60,23,12,18.4,17,9,-5,1.4,-17,46.338,8,1.6,0.2,26.338,20,3
324,1.75,0.25,64,48.0,36.0,48.0,108.0,14.0,14.0,24.0,-2.0,-2.0,-12.0,64,144,16,26,2.0,0,-10,64,144,26,0,2.0,-10,324,10,12.0,10,70.144,8,6.0,0.75,62.144000000000005,8,18
325,1.23,0.77,1,0.23,0.05,3.91,3.91,1.23,17.23,17.23,-0.77,-16.77,-16.77,17,17,18,18,0.77,-16,-16,289,289,34,16,16.77,0,289,16,16.77,0,30.16,1,0.23,0.23,13.16,17,17
326,1.41,0.59,64,26.24,10.76,45.92,45.92,11.28,17.28,17.28,-4.72,-10.72,-10.72,112,112,22,22,4.72,-6,-6,196,196,28,6,10.72,0,196,6,10.72,0,94.13,8,3.28,0.41,80.13,14,14
327,1.31,0.69,100,31.0,9.61,9.3,27.9,13.1,6.1,12.1,-6.9,0.1,-5.9,30,90,13,19,6.9,7,1,9,27,12,-7,-0.1,-6,81,-1,5.9,6,82.02,10,3.1,0.31,79.02,3,9
328,1.09,0.91,196,17.64,1.59,21.42,18.9,15.26,18.26,16.26,-12.74,-15.74,-13.74,238,210,31,29,12.74,-3,-1,289,255,32,3,15.74,2,225,1,13.74,-2,218.246,14,1.26,0.09,201.246,17,15
329,1.87,0.13,9,7.83,6.81,5.22,15.66,5.61,4.61,8.61,-0.39,0.61,-3.39,6,18,5,9,0.39,1,-3,4,12,8,-1,-0.61,-4,36,3,3.39,4,9.612,3,2.61,0.87,7.612,2,6
330,1.74,0.26,225,166.5,123.21,133.2,144.3,26.1,23.1,24.1,-3.9,-0.9,-1.9,180,195,27,28,3.9,3,2,144,156,25,-3,0.9,-1,169,-2,1.9,1,151.228,15,11.1,0.74,139.228,12,13
331,1.7,0.3,361,252.7,176.89,93.1,133.0,32.3,20.3,23.3,-5.7,6.3,3.3,133,190,26,29,5.7,12,9,49,70,17,-12,-6.3,-3,100,-9,-3.3,3,196.534,19,13.3,0.7,189.534,7,10
332,1.24,0.76,49,11.76,2.82,30.24,26.88,8.68,19.68,17.68,-5.32,-16.32,-14.32,126,112,25,23,5.32,-11,-9,324,288,34,11,16.32,2,256,9,14.32,-2,109.164,7,1.68,0.24,91.164,18,16
333,1.71,0.29,324,230.04,163.33,12.78,115.02,30.78,13.78,21.78,-5.22,11.78,3.78,18,162,19,27,5.22,17,9,1,9,10,-17,-11.78,-8,81,-9,-3.78,8,169.702,18,12.78,0.71,168.702,1,9
334,1.15,0.85,256,38.4,5.76,7.2,31.2,18.4,5.4,15.4,-13.6,-0.6,-10.6,48,208,19,29,13.6,13,3,9,39,16,-13,0.6,-10,169,-3,10.6,10,200.29,16,2.4,0.15,197.29,3,13
335,1.8,0.2,16,12.8,10.24,32.0,51.2,7.2,13.2,19.2,-0.8,-6.8,-12.8,40,64,14,20,0.8,-6,-12,100,160,26,6,6.8,-6,256,12,12.8,6,31.34,4,3.2,0.8,21.34,10,16
336,1.19,0.81,196,37.24,7.08,47.88,0.0,16.66,20.66,2.66,-11.34,-15.34,2.66,252,0,32,14,11.34,-4,14,324,0,18,4,15.34,18,0,-14,-2.66,-18,38.056,14,2.66,0.19,20.055999999999997,18,0
337,1.87,0.13,1,0.87,0.76,14.79,14.79,1.87,17.87,17.87,-0.13,-16.13,-16.13,17,17,18,18,0.13,-16,-16,289,289,34,16,16.13,0,289,16,16.13,0,19.92,1,0.87,0.87,2.9200000000000017,17,17
338,1.08,0.92,16,1.28,0.1,5.44,5.44,4.32,17.32,17.32,-3.68,-16.68,-16.68,68,68,21,21,3.68,-13,-13,289,289,34,13,16.68,0,289,13,16.68,0,79.796,4,0.32,0.08,62.79600000000001,17,17
339,1.56,0.44,225,126.0,70.56,33.6,92.4,23.4,12.4,19.4,-6.6,4.4,-2.6,60,165,19,26,6.6,11,4,16,44,15,-11,-4.4,-7,121,-4,2.6,7,143.494,15,8.4,0.56,139.494,4,11
340,1.42,0.58,324,136.08,57.15,30.24,105.84,25.56,11.56,21.56,-10.44,3.56,-6.44,72,252,22,32,10.44,14,4,16,56,18,-14,-3.56,-10,196,-4,6.44,10,221.202,18,7.56,0.42,217.202,4,14
341,1.45,0.55,1,0.45,0.2,9.0,8.1,1.45,20.45,18.45,-0.55,-19.55,-17.55,20,18,21,19,0.55,-19,-17,400,360,38,19,19.55,2,324,17,17.55,-2,29.5,1,0.45,0.45,9.5,20,18
342,1.3,0.7,64,19.2,5.76,4.8,7.2,10.4,4.4,5.4,-5.6,0.4,-0.6,16,24,10,11,5.6,6,5,4,6,5,-6,-0.4,-1,9,-5,0.6,1,29.704,8,2.4,0.3,27.704,2,3
343,1.91,0.09,81,73.71,67.08,139.23,24.57,17.19,25.19,11.19,-0.81,-8.81,5.19,153,27,26,12,0.81,-8,6,289,51,20,8,8.81,14,9,-6,-5.19,-14,60.078,9,8.19,0.91,43.078,17,3
344,1.59,0.41,81,47.79,28.2,0.0,79.65,14.31,5.31,20.31,-3.69,5.31,-9.69,0,135,9,24,3.69,9,-6,0,0,15,-9,-5.31,-15,225,6,9.69,15,81.678,9,5.31,0.59,81.678,0,15
345,1.45,0.55,64,28.8,12.96,61.2,61.2,11.6,20.6,20.6,-4.4,-13.4,-13.4,136,136,25,25,4.4,-9,-9,289,289,34,9,13.4,0,289,9,13.4,0,106.276,8,3.6,0.45,89.276,17,17
346,1.57,0.43,100,57.0,32.49,62.7,57.0,15.7,16.7,15.7,-4.3,-5.3,-4.3,110,100,21,20,4.3,-1,0,121,110,21,1,5.3,1,100,0,4.3,-1,85.586,10,5.7,0.57,74.586,11,10
347,1.23,0.77,196,45.08,10.37,25.76,45.08,17.22,11.22,17.22,-10.78,-4.78,-10.78,112,196,22,28,10.78,6,0,64,112,22,-6,4.78,-6,196,0,10.78,6,182.522,14,3.22,0.23,174.522,8,14
348,1.08,0.92,225,18.0,1.44,24.0,16.8,16.2,21.2,15.2,-13.8,-18.8,-12.8,300,210,35,29,13.8,-5,1,400,280,34,5,18.8,6,196,-1,12.8,-6,223.096,15,1.2,0.08,203.096,20,14
349,1.08,0.92,256,20.48,1.64,11.52,17.92,17.28,10.28,15.28,-14.72,-7.72,-12.72,144,224,25,30,14.72,7,2,81,126,23,-7,7.72,-5,196,-2,12.72,5,225.822,16,1.28,0.08,216.822,9,14
350,1.37,0.63,361,133.57,49.42,63.27,42.18,26.03,16.03,13.03,-11.97,-1.97,1.03,171,114,28,25,11.97,10,13,81,54,15,-10,1.97,3,36,-13,-1.03,-3,151.536,19,7.03,0.37,142.536,9,6
351,1.14,0.86,4,0.56,0.08,5.6,5.32,2.28,20.28,19.28,-1.72,-19.72,-18.72,40,38,22,21,1.72,-18,-17,400,380,39,18,19.72,1,361,17,18.72,-1,53.052,2,0.28,0.14,33.052,20,19
352,1.52,0.48,1,0.52,0.27,5.2,9.88,1.52,10.52,19.52,-0.48,-9.48,-18.48,10,19,11,20,0.48,-9,-18,100,190,29,9,9.48,-9,361,18,18.48,9,20.144,1,0.52,0.52,10.143999999999998,10,19
353,1.63,0.37,144,90.72,57.15,90.72,7.56,19.56,19.56,8.56,-4.44,-4.44,6.56,144,12,24,13,4.44,0,11,144,12,13,0,4.44,11,1,-11,-6.56,-11,65.876,12,7.56,0.63,53.876000000000005,12,1
354,1.62,0.38,9,5.58,3.46,31.62,9.3,4.86,18.86,6.86,-1.14,-15.14,-3.14,51,15,20,8,1.14,-14,-2,289,85,22,14,15.14,12,25,2,3.14,-12,26.284,3,1.86,0.62,9.283999999999999,17,5
355,1.85,0.15,400,340.0,289.0,255.0,153.0,37.0,32.0,26.0,-3.0,2.0,8.0,300,180,35,29,3.0,5,11,225,135,24,-5,-2.0,6,81,-11,-8.0,-6,220.828,20,17.0,0.85,205.828,15,9
356,1.16,0.84,25,4.0,0.64,1.6,11.2,5.8,2.8,14.8,-4.2,-1.2,-13.2,10,70,7,19,4.2,3,-9,4,28,16,-3,1.2,-12,196,9,13.2,12,63.55,5,0.8,0.16,61.55,2,14
357,1.73,0.27,100,73.0,53.29,51.1,29.2,17.3,14.3,11.3,-2.7,0.3,3.3,70,40,17,14,2.7,3,6,49,28,11,-3,-0.3,3,16,-6,-3.3,-3,57.712,10,7.3,0.73,50.712,7,4
358,1.84,0.16,400,336.0,282.24,134.4,100.8,36.8,24.8,22.8,-3.2,8.8,10.8,160,120,28,26,3.2,12,14,64,48,14,-12,-8.8,2,36,-14,-10.8,-2,203.786,20,16.8,0.84,195.786,8,6
359,1.18,0.82,81,14.58,2.62,21.06,4.86,10.62,14.62,4.62,-7.38,-11.38,-1.38,117,27,22,12,7.38,-4,6,169,39,16,4,11.38,10,9,-6,1.38,-10,43.396,9,1.62,0.18,30.396,13,3
360,1.28,0.72,16,4.48,1.25,10.08,4.48,5.12,10.12,5.12,-2.88,-7.88,-2.88,36,16,13,8,2.88,-5,0,81,36,13,5,7.88,5,16,0,2.88,-5,23.446,4,1.12,0.28,14.446000000000002,9,4
361,1.12,0.88,256,30.72,3.69,38.4,1.92,17.92,21.92,2.92,-14.08,-18.08,0.92,320,16,36,17,14.08,-4,15,400,20,21,4,18.08,19,1,-15,-0.92,-19,50.092,16,1.92,0.12,30.092,20,1
362,1.48,0.52,169,81.12,38.94,24.96,87.36,19.24,10.24,20.24,-6.76,2.24,-7.76,52,182,17,27,6.76,9,-1,16,56,18,-9,-2.24,-10,196,1,7.76,10,141.646,13,6.24,0.48,137.646,4,14
363,1.15,0.85,100,15.0,2.25,7.5,18.0,11.5,6.5,13.5,-8.5,-3.5,-10.5,50,120,15,22,8.5,5,-2,25,60,17,-5,3.5,-7,144,2,10.5,7,115.156,10,1.5,0.15,110.156,5,12
364,1.37,0.63,25,9.25,3.42,16.65,24.05,6.85,10.85,14.85,-3.15,-7.15,-11.15,45,65,14,18,3.15,-4,-8,81,117,22,4,7.15,-4,169,8,11.15,4,55.396,5,1.85,0.37,46.396,9,13
365,1.73,0.27,9,6.57,4.8,2.19,32.85,5.19,3.19,17.19,-0.81,1.19,-12.81,3,45,4,18,0.81,2,-12,1,15,16,-2,-1.19,-14,225,12,12.81,14,17.734,3,2.19,0.73,16.734,1,15
366,1.57,0.43,289,164.73,93.9,193.8,87.21,26.69,29.69,18.69,-7.31,-10.31,0.69,340,153,37,26,7.31,-3,8,400,180,29,3,10.31,11,81,-8,-0.69,-11,172.922,17,9.69,0.57,152.922,20,9
367,1.94,0.06,225,211.5,198.81,70.5,253.8,29.1,19.1,32.1,-0.9,9.1,-3.9,75,270,20,33,0.9,10,-3,25,90,23,-10,-9.1,-13,324,3,3.9,13,133.264,15,14.1,0.94,128.264,5,18
368,1.62,0.38,324,200.88,124.55,89.28,55.8,29.16,19.16,16.16,-6.84,3.16,6.16,144,90,26,23,6.84,10,13,64,40,13,-10,-3.16,3,25,-13,-6.16,-3,148.386,18,11.16,0.62,140.386,8,5
369,1.64,0.36,49,31.36,20.07,80.64,26.88,11.48,22.48,10.48,-2.52,-13.52,-1.52,126,42,25,13,2.52,-11,1,324,108,24,11,13.52,12,36,-1,1.52,-12,51.196,7,4.48,0.64,33.196,18,6
370,1.61,0.39,169,103.09,62.88,0.0,55.51,20.93,7.93,14.93,-5.07,7.93,0.93,0,91,13,20,5.07,13,6,0,0,7,-13,-7.93,-7,49,-6,-0.93,7,90.816,13,7.93,0.61,90.816,0,7
371,1.92,0.08,64,58.88,54.17,103.04,110.4,15.36,21.36,22.36,-0.64,-6.64,-7.64,112,120,22,23,0.64,-6,-7,196,210,29,6,6.64,-1,225,7,7.64,1,56.996,8,7.36,0.92,42.996,14,15
372,1.5,0.5,64,32.0,16.0,52.0,4.0,12.0,17.0,5.0,-4.0,-9.0,3.0,104,8,21,9,4.0,-5,7,169,13,14,5,9.0,12,1,-7,-3.0,-12,34.724,8,4.0,0.5,21.723999999999997,13,1
373,1.88,0.12,324,285.12,250.91,190.08,237.6,33.84,27.84,30.84,-2.16,3.84,0.84,216,270,30,33,2.16,6,3,144,180,27,-6,-3.84,-3,225,-3,-0.84,3,194.498,18,15.84,0.88,182.498,12,15
374,1.2,0.8,144,28.8,5.76,26.4,28.8,14.4,13.4,14.4,-9.6,-8.6,-9.6,132,144,23,24,9.6,1,0,121,132,23,-1,8.6,-1,144,0,9.6,1,141.888,12,2.4,0.2,130.888,11,12
375,1.8,0.2,1,0.8,0.64,9.6,15.2,1.8,12.8,19.8,-0.2,-11.2,-18.2,12,19,13,20,0.2,-11,-18,144,228,31,11,11.2,-7,361,18,18.2,7,16.672,1,0.8,0.8,4.672000000000001,12,19
376,1.47,0.53,64,30.08,14.14,18.8,33.84,11.76,8.76,12.76,-4.24,-1.24,-5.24,40,72,13,17,4.24,3,-1,25,45,14,-3,1.24,-4,81,1,5.24,4,60.146,8,3.76,0.47,55.146,5,9
377,1.06,0.94,121,7.26,0.44,3.96,5.94,11.66,6.66,9.66,-10.34,-5.34,-8.34,66,99,17,20,10.34,5,2,36,54,15,-5,5.34,-3,81,-2,8.34,3,103.052,11,0.66,0.06,97.052,6,9
378,1.37,0.63,289,106.93,39.56,44.03,44.03,23.29,13.29,13.29,-10.71,-0.71,-0.71,119,119,24,24,10.71,10,10,49,49,14,-10,0.71,0,49,-10,0.71,0,138.568,17,6.29,0.37,131.568,7,7
379,1.79,0.21,256,202.24,159.77,227.52,63.2,28.64,30.64,17.64,-3.36,-5.36,7.64,288,80,34,21,3.36,-2,11,324,90,23,2,5.36,13,25,-11,-7.64,-13,142.898,16,12.64,0.79,124.898,18,5
380,1.37,0.63,256,94.72,35.05,17.76,5.92,21.92,8.92,6.92,-10.08,2.92,4.92,48,16,19,17,10.08,13,15,9,3,4,-13,-2.92,2,1,-15,-4.92,-2,63.624,16,5.92,0.37,60.624,3,1
381,1.3,0.7,16,4.8,1.44,13.2,3.6,5.2,12.2,4.2,-2.8,-9.8,-1.8,44,12,15,7,2.8,-7,1,121,33,14,7,9.8,8,9,-1,1.8,-8,22.44,4,1.2,0.3,11.440000000000001,11,3
382,1.69,0.31,121,83.49,57.61,15.18,68.31,18.59,9.59,16.59,-3.41,5.59,-1.41,22,99,13,20,3.41,9,2,4,18,11,-9,-5.59,-7,81,-2,1.41,7,78.32,11,7.59,0.69,76.32,2,9
383,1.53,0.47,400,212.0,112.36,63.6,169.6,30.6,16.6,26.6,-9.4,4.6,-5.4,120,320,26,36,9.4,14,4,36,96,22,-14,-4.6,-10,256,-4,5.4,10,266.82,20,10.6,0.53,260.82,6,16
384,1.55,0.45,361,198.55,109.2,94.05,104.5,29.45,19.45,20.45,-8.55,1.45,0.45,171,190,28,29,8.55,10,9,81,90,19,-10,-1.45,-1,100,-9,-0.45,1,199.028,19,10.45,0.55,190.028,9,10
385,1.7,0.3,25,17.5,12.25,70.0,21.0,8.5,23.5,9.5,-1.5,-16.5,-2.5,100,30,25,11,1.5,-15,-1,400,120,26,15,16.5,14,36,1,2.5,-14,39.604,5,3.5,0.7,19.604,20,6
386,1.39,0.61,9,3.51,1.37,3.51,18.72,4.17,4.17,17.17,-1.83,-1.83,-14.83,9,48,6,19,1.83,0,-13,9,48,19,0,1.83,-13,256,13,14.83,13,34.764,3,1.17,0.39,31.764000000000003,3,16
387,1.89,0.11,49,43.61,38.81,80.99,68.53,13.23,19.23,17.23,-0.77,-6.77,-4.77,91,77,20,18,0.77,-6,-4,169,143,24,6,6.77,2,121,4,4.77,-2,46.382,7,6.23,0.89,33.382,13,11
388,1.47,0.53,100,47.0,22.09,18.8,79.9,14.7,8.7,21.7,-5.3,0.7,-12.3,40,170,14,27,5.3,6,-7,16,68,21,-6,-0.7,-13,289,7,12.3,13,120.754,10,4.7,0.47,116.754,4,17
389,1.06,0.94,289,17.34,1.04,2.04,15.3,18.02,3.02,16.02,-15.98,-0.98,-13.98,34,255,19,32,15.98,15,2,4,30,17,-15,0.98,-13,225,-2,13.98,13,251.278,17,1.02,0.06,249.278,2,15
390,1.41,0.59,49,20.09,8.24,37.31,11.48,9.87,15.87,6.87,-4.13,-10.13,-1.13,91,28,20,11,4.13,-6,3,169,52,17,6,10.13,9,16,-3,1.13,-9,41.048,7,2.87,0.41,28.048000000000002,13,4
391,1.31,0.69,100,31.0,9.61,55.8,21.7,13.1,21.1,10.1,-6.9,-14.9,-3.9,180,70,28,17,6.9,-8,3,324,126,25,8,14.9,11,49,-3,3.9,-11,83.684,10,3.1,0.31,65.684,18,7
392,1.14,0.86,49,6.86,0.96,10.78,19.6,7.98,11.98,20.98,-6.02,-10.02,-19.02,77,140,18,27,6.02,-4,-13,121,220,31,4,10.02,-9,400,13,19.02,9,134.362,7,0.98,0.14,123.362,11,20
393,1.72,0.28,289,208.08,149.82,36.72,122.4,29.24,15.24,22.24,-4.76,9.24,2.24,51,170,20,27,4.76,14,7,9,30,13,-14,-9.24,-7,100,-7,-2.24,7,161.144,17,12.24,0.72,158.144,3,10
394,1.82,0.18,49,40.18,32.95,5.74,45.92,12.74,6.74,13.74,-1.26,4.74,-2.26,7,56,8,15,1.26,6,-1,1,8,9,-6,-4.74,-7,64,1,2.26,7,33.742,7,5.74,0.82,32.742,1,8
395,1.9,0.1,1,0.9,0.81,2.7,7.2,1.9,3.9,8.9,-0.1,-2.1,-7.1,3,8,4,9,0.1,-2,-7,9,24,11,2,2.1,-5,64,7,7.1,5,4.756,1,0.9,0.9,1.7560000000000002,3,8
396,1.52,0.48,25,13.0,6.76,13.0,28.6,7.6,7.6,13.6,-2.4,-2.4,-8.4,25,55,10,16,2.4,0,-6,25,55,16,0,2.4,-6,121,6,8.4,6,38.724,5,2.6,0.52,33.724,5,11
397,1.83,0.17,100,83.0,68.89,58.1,91.3,18.3,15.3,19.3,-1.7,1.3,-2.7,70,110,17,21,1.7,3,-1,49,77,18,-3,-1.3,-4,121,1,2.7,4,71.774,10,8.3,0.83,64.774,7,11
398,1.3,0.7,25,7.5,2.25,15.0,28.5,6.5,11.5,20.5,-3.5,-8.5,-17.5,50,95,15,24,3.5,-5,-14,100,190,29,5,8.5,-9,361,14,17.5,9,80.334,5,1.5,0.3,70.334,10,19
399,1.93,0.07,144,133.92,124.55,122.76,145.08,23.16,22.16,24.16,-0.84,0.16,-1.84,132,156,23,25,0.84,1,-1,121,143,24,-1,-0.16,-2,169,1,1.84,2,94.54,12,11.16,0.93,83.54,11,13
400,1.75,0.25,196,147.0,110.25,84.0,52.5,24.5,18.5,15.5,-3.5,2.5,5.5,112,70,22,19,3.5,6,9,64,40,13,-6,-2.5,3,25,-9,-5.5,-3,104.604,14,10.5,0.75,96.604,8,5
401,1.78,0.22,400,312.0,243.36,249.6,109.2,35.6,31.6,22.6,-4.4,-0.4,8.6,320,140,36,27,4.4,4,13,256,112,23,-4,0.4,9,49,-13,-8.6,-9,210.784,20,15.6,0.78,194.784,16,7
402,1.76,0.24,169,128.44,97.61,88.92,19.76,22.88,18.88,11.88,-3.12,0.88,7.88,117,26,22,15,3.12,4,11,81,18,11,-4,-0.88,7,4,-11,-7.88,-7,83.618,13,9.88,0.76,74.618,9,2
403,1.85,0.15,144,122.4,104.04,20.4,30.6,22.2,12.2,13.2,-1.8,8.2,7.2,24,36,14,15,1.8,10,9,4,6,5,-10,-8.2,-1,9,-9,-7.2,1,73.386,12,10.2,0.85,71.386,2,3
404,1.32,0.68,361,115.52,36.97,97.28,97.28,25.08,22.08,22.08,-12.92,-9.92,-9.92,304,304,35,35,12.92,3,3,256,256,32,-3,9.92,0,256,-3,9.92,0,284.592,19,6.08,0.32,268.592,16,16
405,1.09,0.91,121,10.89,0.98,2.97,9.9,11.99,3.99,10.99,-10.01,-2.01,-9.01,33,110,14,21,10.01,8,1,9,30,13,-8,2.01,-7,100,-1,9.01,7,108.878,11,0.99,0.09,105.878,3,10
406,1.39,0.61,361,140.79,54.91,111.15,96.33,26.41,22.41,20.41,-11.59,-7.59,-5.59,285,247,34,32,11.59,4,6,225,195,28,-4,7.59,2,169,-6,5.59,-2,239.924,19,7.41,0.39,224.924,15,13
407,1.32,0.68,100,32.0,10.24,6.4,35.2,13.2,5.2,14.2,-6.8,1.2,-7.8,20,110,12,21,6.8,8,-1,4,22,13,-8,-1.2,-9,121,1,7.8,9,93.966,10,3.2,0.32,91.966,2,11
408,1.21,0.79,324,68.04,14.29,30.24,45.36,21.78,11.78,15.78,-14.22,-4.22,-8.22,144,216,26,30,14.22,10,6,64,96,20,-10,4.22,-4,144,-6,8.22,4,214.882,18,3.78,0.21,206.882,8,12
409,1.63,0.37,36,22.68,14.29,18.9,75.6,9.78,8.78,23.78,-2.22,-1.22,-16.22,30,120,11,26,2.22,1,-14,25,100,25,-1,1.22,-15,400,14,16.22,15,61.516,6,3.78,0.63,56.516,5,20
410,1.53,0.47,225,119.25,63.2,103.35,127.2,22.95,20.95,23.95,-7.05,-5.05,-8.05,195,240,28,31,7.05,2,-1,169,208,29,-2,5.05,-3,256,1,8.05,3,189.954,15,7.95,0.53,176.954,13,16
411,1.77,0.23,81,62.37,48.02,97.02,6.93,15.93,20.93,7.93,-2.07,-7.07,5.93,126,9,23,10,2.07,-5,8,196,14,15,5,7.07,13,1,-8,-5.93,-13,50.346,9,6.93,0.77,36.346,14,1
412,1.49,0.51,81,39.69,19.45,83.79,30.87,13.41,23.41,11.41,-4.59,-14.59,-2.59,171,63,28,16,4.59,-10,2,361,133,26,10,14.59,12,49,-2,2.59,-12,73.33,9,4.41,0.49,54.33,19,7
413,1.26,0.74,100,26.0,6.76,5.2,10.4,12.6,4.6,6.6,-7.4,0.6,-1.4,20,40,12,14,7.4,8,6,4,8,6,-8,-0.6,-2,16,-6,1.4,2,46.09,10,2.6,0.26,44.09,2,4
414,1.4,0.6,289,115.6,46.24,88.4,6.8,23.8,19.8,7.8,-10.2,-6.2,5.8,221,17,30,18,10.2,4,16,169,13,14,-4,6.2,12,1,-16,-5.8,-12,84.724,17,6.8,0.4,71.724,13,1
415,1.17,0.83,400,68.0,11.56,34.0,57.8,23.4,13.4,20.4,-16.6,-6.6,-13.6,200,340,30,37,16.6,10,3,100,170,27,-10,6.6,-7,289,-3,13.6,7,327.726,20,3.4,0.17,317.726,10,17
416,1.82,0.18,324,265.68,217.86,0.0,177.12,32.76,14.76,26.76,-3.24,14.76,2.76,0,216,18,30,3.24,18,6,0,0,12,-18,-14.76,-12,144,-6,-2.76,12,179.334,18,14.76,0.82,179.334,0,12
417,1.74,0.26,9,6.66,4.93,31.08,39.96,5.22,16.22,20.22,-0.78,-11.78,-15.78,42,54,17,21,0.78,-11,-15,196,252,32,11,11.78,-4,324,15,15.78,4,32.582,3,2.22,0.74,18.582,14,18
418,1.79,0.21,49,38.71,30.58,66.36,22.12,12.53,17.53,9.53,-1.47,-6.47,1.53,84,28,19,11,1.47,-5,3,144,48,16,5,6.47,8,16,-3,-1.53,-8,39.918,7,5.53,0.79,27.918,12,4
419,1.67,0.33,25,16.75,11.22,30.15,50.25,8.35,12.35,18.35,-1.65,-5.65,-11.65,45,75,14,20,1.65,-4,-10,81,135,24,4,5.65,-6,225,10,11.65,6,43.106,5,3.35,0.67,34.106,9,15
420,1.43,0.57,25,10.75,4.62,36.55,32.25,7.15,19.15,17.15,-2.85,-14.85,-12.85,85,75,22,20,2.85,-12,-10,289,255,32,12,14.85,2,225,10,12.85,-2,66.39,5,2.15,0.43,49.39,17,15
421,1.85,0.15,36,30.6,26.01,0.0,96.9,11.1,5.1,24.1,-0.9,5.1,-13.9,0,114,6,25,0.9,6,-13,0,0,19,-6,-5.1,-19,361,13,13.9,19,34.766,6,5.1,0.85,34.766,0,19
422,1.16,0.84,289,46.24,7.4,24.48,21.76,19.72,11.72,10.72,-14.28,-6.28,-5.28,153,136,26,25,14.28,8,9,81,72,17,-8,6.28,1,64,-9,5.28,-1,147.566,17,2.72,0.16,138.566,9,8
423,1.9,0.1,49,44.1,39.69,31.5,100.8,13.3,11.3,22.3,-0.7,1.3,-9.7,35,112,12,23,0.7,2,-9,25,80,21,-2,-1.3,-11,256,9,9.7,11,41.386,7,6.3,0.9,36.386,5,16
424,1.24,0.76,49,11.76,2.82,0.0,25.2,8.68,1.68,16.68,-5.32,1.68,-13.32,0,105,7,22,5.32,7,-8,0,0,15,-7,-1.68,-15,225,8,13.32,15,87.28,7,1.68,0.24,87.28,0,15
425,1.68,0.32,324,220.32,149.82,244.8,48.96,30.24,32.24,16.24,-5.76,-7.76,8.24,360,72,38,22,5.76,-2,14,400,80,24,2,7.76,16,16,-14,-8.24,-16,159.692,18,12.24,0.68,139.692,20,4
426,1.17,0.83,400,68.0,11.56,20.4,57.8,23.4,9.4,20.4,-16.6,-2.6,-13.6,120,340,26,37,16.6,14,3,36,102,23,-14,2.6,-11,289,-3,13.6,11,323.55,20,3.4,0.17,317.55,6,17
427,1.68,0.32,144,97.92,66.59,73.44,122.4,20.16,17.16,23.16,-3.84,-0.84,-6.84,108,180,21,27,3.84,3,-3,81,135,24,-3,0.84,-6,225,3,6.84,6,119.424,12,8.16,0.68,110.424,9,15
428,1.53,0.47,4,2.12,1.12,0.0,0.0,3.06,1.06,1.06,-0.94,1.06,1.06,0,0,2,2,0.94,2,2,0,0,0,-2,-1.06,0,0,-2,-1.06,0,1.65,2,1.06,0.53,1.65,0,0
429,1.89,0.11,289,257.21,228.92,242.08,136.17,32.13,31.13,24.13,-1.87,-0.87,6.13,272,153,33,26,1.87,1,8,256,144,25,-1,0.87,7,81,-8,-6.13,-7,169.246,17,15.13,0.89,153.246,16,9
430,1.25,0.75,36,9.0,2.25,3.0,21.0,7.5,3.5,15.5,-4.5,-0.5,-12.5,12,84,8,20,4.5,4,-8,4,28,16,-4,0.5,-12,196,8,12.5,12,70.044,6,1.5,0.25,68.044,2,14
431,1.81,0.19,169,136.89,110.88,200.07,115.83,23.53,29.53,21.53,-2.47,-8.47,-0.47,247,143,32,24,2.47,-6,2,361,209,30,6,8.47,8,121,-2,0.47,-8,119.248,13,10.53,0.81,100.248,19,11
432,1.9,0.1,324,291.6,262.44,64.8,178.2,34.2,20.2,27.2,-1.8,12.2,5.2,72,198,22,29,1.8,14,7,16,44,15,-14,-12.2,-7,121,-7,-5.2,7,177.238,18,16.2,0.9,173.238,4,11
433,1.74,0.26,36,26.64,19.71,31.08,22.2,10.44,11.44,9.44,-1.56,-2.56,-0.56,42,30,13,11,1.56,-1,1,49,35,12,1,2.56,2,25,-1,0.56,-2,30.44,6,4.44,0.74,23.44,7,5
434,1.57,0.43,361,205.77,117.29,184.11,75.81,29.83,27.83,17.83,-8.17,-6.17,3.83,323,133,36,26,8.17,2,12,289,119,24,-2,6.17,10,49,-12,-3.83,-10,181.974,19,10.83,0.57,164.974,17,7
435,1.85,0.15,121,102.85,87.42,130.9,130.9,20.35,23.35,23.35,-1.65,-4.65,-4.65,154,154,25,25,1.65,-3,-3,196,196,28,3,4.65,0,196,3,4.65,0,93.09,11,9.35,0.85,79.09,14,14
436,1.1,0.9,81,8.1,0.81,3.6,4.5,9.9,4.9,5.9,-8.1,-3.1,-4.1,36,45,13,14,8.1,5,4,16,20,9,-5,3.1,-1,25,-4,4.1,1,48.952,9,0.9,0.1,44.952,4,5
437,1.78,0.22,81,63.18,49.28,0.0,112.32,16.02,7.02,23.02,-1.98,7.02,-8.98,0,144,9,25,1.98,9,-7,0,0,16,-9,-7.02,-16,256,7,8.98,16,66.866,9,7.02,0.78,66.866,0,16
438,1.79,0.21,64,50.56,39.94,82.16,37.92,14.32,19.32,12.32,-1.68,-6.68,0.32,104,48,21,14,1.68,-5,2,169,78,19,5,6.68,7,36,-2,-0.32,-7,51.784,8,6.32,0.79,38.784,13,6
439,1.06,0.94,121,7.26,0.44,4.62,7.26,11.66,7.66,11.66,-10.34,-6.34,-10.34,77,121,18,22,10.34,4,0,49,77,18,-4,6.34,-4,121,0,10.34,4,124.74,11,0.66,0.06,117.74,7,11
440,1.3,0.7,289,86.7,26.01,10.2,0.0,22.1,7.1,5.1,-11.9,3.1,5.1,34,0,19,17,11.9,15,17,4,0,2,-15,-3.1,2,0,-17,-5.1,-2,47.706,17,5.1,0.3,45.706,2,0
441,1.7,0.3,121,84.7,59.29,38.5,77.0,18.7,12.7,17.7,-3.3,2.7,-2.3,55,110,16,21,3.3,6,1,25,50,15,-6,-2.7,-5,100,-1,2.3,5,84.532,11,7.7,0.7,79.532,5,10
442,1.38,0.62,100,38.0,14.44,45.6,64.6,13.8,15.8,20.8,-6.2,-8.2,-13.2,120,170,22,27,6.2,-2,-7,144,204,29,2,8.2,-5,289,7,13.2,5,137.76,10,3.8,0.38,125.75999999999999,12,17
443,1.39,0.61,36,14.04,5.48,42.12,7.02,8.34,20.34,5.34,-3.66,-15.66,-0.66,108,18,24,9,3.66,-12,3,324,54,21,12,15.66,15,9,-3,0.66,-15,37.15,6,2.34,0.39,19.15,18,3
444,1.08,0.92,36,2.88,0.23,7.2,0.96,6.48,15.48,2.48,-5.52,-14.52,-1.52,90,12,21,8,5.52,-9,4,225,30,17,9,14.52,13,4,-4,1.52,-13,27.718,6,0.48,0.08,12.718,15,2
445,1.61,0.39,49,29.89,18.23,0.0,25.62,11.27,4.27,10.27,-2.73,4.27,-1.73,0,42,7,13,2.73,7,1,0,0,6,-7,-4.27,-6,36,-1,1.73,6,33.294,7,4.27,0.61,33.294,0,6
446,1.91,0.09,64,58.24,53.0,138.32,7.28,15.28,26.28,8.28,-0.72,-11.72,6.28,152,8,27,9,0.72,-11,7,361,19,20,11,11.72,18,1,-7,-6.28,-18,52.3,8,7.28,0.91,33.3,19,1
447,1.46,0.54,36,16.56,7.62,2.76,8.28,8.76,3.76,5.76,-3.24,1.76,-0.24,6,18,7,9,3.24,5,3,1,3,4,-5,-1.76,-2,9,-3,0.24,2,20.336,6,2.76,0.46,19.336,1,3
448,1.5,0.5,196,98.0,49.0,35.0,28.0,21.0,12.0,11.0,-7.0,2.0,3.0,70,56,19,18,7.0,9,10,25,20,9,-9,-2.0,1,16,-10,-3.0,-1,86.608,14,7.0,0.5,81.608,5,4
449,1.46,0.54,361,166.06,76.39,78.66,52.44,27.74,17.74,14.74,-10.26,-0.26,2.74,171,114,28,25,10.26,10,13,81,54,15,-10,0.26,3,36,-13,-2.74,-3,158.062,19,8.74,0.46,149.062,9,6
450,1.91,0.09,25,22.75,20.7,45.5,4.55,9.55,14.55,5.55,-0.45,-5.45,3.55,50,5,15,6,0.45,-5,4,100,10,11,5,5.45,9,1,-4,-3.55,-9,24.052,5,4.55,0.91,14.052,10,1
451,1.47,0.53,1,0.47,0.22,5.17,1.88,1.47,11.47,4.47,-0.53,-10.53,-3.53,11,4,12,5,0.53,-10,-3,121,44,15,10,10.53,7,16,3,3.53,-7,13.686,1,0.47,0.47,2.686,11,4
452,1.88,0.12,1,0.88,0.77,7.04,13.2,1.88,8.88,15.88,-0.12,-7.12,-14.12,8,15,9,16,0.12,-7,-14,64,120,23,7,7.12,-7,225,14,14.12,7,10.596,1,0.88,0.88,2.596,8,15
453,1.95,0.05,121,114.95,109.2,125.4,167.2,21.45,22.45,26.45,-0.55,-1.55,-5.55,132,176,23,27,0.55,-1,-5,144,192,28,1,1.55,-4,256,5,5.55,4,83.18,11,10.45,0.95,71.18,12,16
454,1.18,0.82,225,40.5,7.29,21.6,51.3,17.7,10.7,21.7,-12.3,-5.3,-16.3,120,285,23,34,12.3,7,-4,64,152,27,-7,5.3,-11,361,4,16.3,11,262.15,15,2.7,0.18,254.14999999999998,8,19
455,1.18,0.82,49,8.82,1.59,0.0,17.64,8.26,1.26,15.26,-5.74,1.26,-12.74,0,98,7,21,5.74,7,-7,0,0,14,-7,-1.26,-14,196,7,12.74,14,85.572,7,1.26,0.18,85.572,0,14
456,1.85,0.15,289,245.65,208.8,101.15,0.0,31.45,21.45,14.45,-2.55,7.45,14.45,119,0,24,17,2.55,10,17,49,0,7,-10,-7.45,7,0,-17,-14.45,-7,136.732,17,14.45,0.85,129.732,7,0
457,1.79,0.21,49,38.71,30.58,44.24,22.12,12.53,13.53,9.53,-1.47,-2.47,1.53,56,28,15,11,1.47,-1,3,64,32,12,1,2.47,4,16,-3,-1.53,-4,36.058,7,5.53,0.79,28.058,8,4
458,1.32,0.68,1,0.32,0.1,0.96,2.88,1.32,3.32,9.32,-0.68,-2.68,-8.68,3,9,4,10,0.68,-2,-8,9,27,12,2,2.68,-6,81,8,8.68,6,9.264,1,0.32,0.32,6.263999999999999,3,9
459,1.86,0.14,64,55.04,47.33,137.6,123.84,14.88,26.88,24.88,-1.12,-13.12,-11.12,160,144,28,26,1.12,-12,-10,400,360,38,12,13.12,2,324,10,11.12,-2,70.73,8,6.88,0.86,50.730000000000004,20,18
460,1.54,0.46,400,216.0,116.64,0.0,64.8,30.8,10.8,16.8,-9.2,10.8,4.8,0,120,20,26,9.2,20,14,0,0,6,-20,-10.8,-6,36,-14,-4.8,6,169.05,20,10.8,0.54,169.05,0,6
461,1.22,0.78,36,7.92,1.74,17.16,18.48,7.32,14.32,15.32,-4.68,-11.68,-12.68,78,84,19,20,4.68,-7,-8,169,182,27,7,11.68,-1,196,8,12.68,1,83.586,6,1.32,0.22,70.586,13,14
462,1.86,0.14,289,248.54,213.74,160.82,292.4,31.62,25.62,34.62,-2.38,3.62,-5.38,187,340,28,37,2.38,6,-3,121,220,31,-6,-3.62,-9,400,3,5.38,9,189.434,17,14.62,0.86,178.434,11,20
463,1.38,0.62,196,74.48,28.3,95.76,10.64,19.32,23.32,7.32,-8.68,-12.68,3.32,252,28,32,16,8.68,-4,12,324,36,20,4,12.68,16,4,-12,-3.32,-16,74.224,14,5.32,0.38,56.224000000000004,18,2
464,1.78,0.22,256,199.68,155.75,187.2,149.76,28.48,27.48,24.48,-3.52,-2.52,0.48,240,192,31,28,3.52,1,4,225,180,27,-1,2.52,3,144,-4,-0.48,-3,163.38,16,12.48,0.78,148.38,15,12
465,1.23,0.77,1,0.23,0.05,2.53,4.6,1.23,11.23,20.23,-0.77,-10.77,-19.77,11,20,12,21,0.77,-10,-19,121,220,31,10,10.77,-9,400,19,19.77,9,26.896,1,0.23,0.23,15.896,11,20
466,1.39,0.61,196,76.44,29.81,27.3,21.84,19.46,10.46,9.46,-8.54,0.46,1.46,70,56,19,18,8.54,9,10,25,20,9,-9,-0.46,1,16,-10,-1.46,-1,80.37,14,5.46,0.39,75.37,5,4
467,1.56,0.44,289,161.84,90.63,85.68,19.04,26.52,18.52,11.52,-7.48,0.52,7.52,153,34,26,19,7.48,8,15,81,18,11,-8,-0.52,7,4,-15,-7.52,-7,109.956,17,9.52,0.56,100.956,9,2
468,1.78,0.22,4,3.12,2.43,4.68,0.0,3.56,4.56,1.56,-0.44,-1.44,1.56,6,0,5,2,0.44,-1,2,9,0,3,1,1.44,3,0,-2,-1.56,-3,5.332,2,1.56,0.78,2.332,3,0
469,1.64,0.36,16,10.24,6.55,51.2,40.96,6.56,22.56,18.56,-1.44,-17.44,-13.44,80,64,24,20,1.44,-16,-12,400,320,36,16,17.44,4,256,12,13.44,-4,48.782,4,2.56,0.64,28.781999999999996,20,16
470,1.92,0.08,1,0.92,0.85,17.48,2.76,1.92,19.92,3.92,-0.08,-18.08,-2.08,19,3,20,4,0.08,-18,-2,361,57,22,18,18.08,16,9,2,2.08,-16,20.14,1,0.92,0.92,1.1400000000000006,19,3
471,1.15,0.85,169,25.35,3.8,11.7,15.6,14.95,7.95,9.95,-11.05,-4.05,-6.05,78,104,19,21,11.05,7,5,36,48,14,-7,4.05,-2,64,-5,6.05,2,108.36,13,1.95,0.15,102.36,6,8
472,1.9,0.1,289,260.1,234.09,260.1,168.3,32.3,32.3,26.3,-1.7,-1.7,4.3,289,187,34,28,1.7,0,6,289,187,28,0,1.7,6,121,-6,-4.3,-6,172.948,17,15.3,0.9,155.948,17,11
473,1.34,0.66,9,3.06,1.04,5.1,13.26,4.02,6.02,14.02,-1.98,-3.98,-11.98,15,39,8,16,1.98,-2,-10,25,65,18,2,3.98,-8,169,10,11.98,8,32.38,3,1.02,0.34,27.380000000000003,5,13
474,1.37,0.63,4,1.48,0.55,8.14,9.62,2.74,11.74,13.74,-1.26,-10.26,-12.26,22,26,13,15,1.26,-9,-11,121,143,24,9,10.26,-2,169,11,12.26,2,28.642,2,0.74,0.37,17.642,11,13
475,1.6,0.4,25,15.0,9.0,30.0,57.0,8.0,13.0,22.0,-2.0,-7.0,-16.0,50,95,15,24,2.0,-5,-14,100,190,29,5,7.0,-9,361,14,16.0,9,56.834,5,3.0,0.6,46.834,10,19
476,1.48,0.52,1,0.48,0.23,8.16,0.48,1.48,17.48,1.48,-0.52,-16.52,-0.52,17,1,18,2,0.52,-16,0,289,17,18,16,16.52,16,1,0,0.52,-16,18.0,1,0.48,0.48,1.0,17,1
477,1.17,0.83,64,10.88,1.85,24.48,5.44,9.36,19.36,5.36,-6.64,-16.64,-2.64,144,32,26,12,6.64,-10,4,324,72,22,10,16.64,14,16,-4,2.64,-14,50.684,8,1.36,0.17,32.684,18,4
478,1.8,0.2,169,135.2,108.16,114.4,41.6,23.4,21.4,14.4,-2.6,-0.6,6.4,143,52,24,17,2.6,2,9,121,44,15,-2,0.6,7,16,-9,-6.4,-7,94.298,13,10.4,0.8,83.298,11,4
479,1.89,0.11,256,227.84,202.78,213.6,0.0,30.24,29.24,14.24,-1.76,-0.76,14.24,240,0,31,16,1.76,1,16,225,0,15,-1,0.76,15,0,-16,-14.24,-15,134.89,16,14.24,0.89,119.88999999999999,15,0
0,1.99,0.01,625,618.75,612.56,618.75,0.0,49.75,49.75,24.75,-0.25,-0.25,24.75,625,0,50,25,0.25,0,25,625,0,25,0,0.25,25,0,-25,-24.75,-25,346.538,25,24.75,0.99,321.538,25,0
1,1.99,0.01,625,618.75,612.56,0.0,0.0,49.75,24.75,24.75,-0.25,24.75,24.75,0,0,25,25,0.25,25,25,0,0,0,-25,-24.75,0,0,-25,-24.75,0,322.034,25,24.75,0.99,322.034,0,0
2,1.01,0.99,169,1.69,0.02,3.25,3.25,13.13,25.13,25.13,-12.87,-24.87,-24.87,325,325,38,38,12.87,-12,-12,625,625,50,12,24.87,0,625,12,24.87,0,347.4153333333333,13,0.13,0.01,322.4153333333333,25,25
3,1.99,0.01,625,618.75,612.56,618.75,0.0,49.75,49.75,24.75,-0.25,-0.25,24.75,625,0,50,25,0.25,0,25,625,0,25,0,0.25,25,0,-25,-24.75,-25,346.692,25,24.75,0.99,321.692,25,0
4,1.01,0.99,625,6.25,0.06,0.0,6.25,25.25,0.25,25.25,-24.75,0.25,-24.75,0,625,25,50,24.75,25,0,0,0,25,-25,-0.25,-25,625,0,24.75,25,621.5613333333333,25,0.25,0.01,621.5613333333333,0,25
5,1.99,0.01,625,618.75,612.56,0.0,0.0,49.75,24.75,24.75,-0.25,24.75,24.75,0,0,25,25,0.25,25,25,0,0,0,-25,-24.75,0,0,-25,-24.75,0,321.77933333333334,25,24.75,0.99,321.77933333333334,0,0
6,1.99,0.01,625,618.75,612.56,618.75,618.75,49.75,49.75,49.75,-0.25,-0.25,-0.25,625,625,50,50,0.25,0,0,625,625,50,0,0.25,0,625,0,0.25,0,352.82,25,24.75,0.99,327.82,25,25
7,1.99,0.01,625,618.75,612.56,618.75,297.0,49.75,49.75,36.75,-0.25,-0.25,12.75,625,300,50,37,0.25,0,13,625,300,37,0,0.25,13,144,-13,-12.75,-13,349.552,25,24.75,0.99,324.552,25,12
8,1.99,0.01,625,618.75,612.56,0.0,618.75,49.75,24.75,49.75,-0.25,24.75,-0.25,0,625,25,50,0.25,25,0,0,0,25,-25,-24.75,-25,625,0,0.25,25,327.94466666666665,25,24.75,0.99,327.94466666666665,0,25
9,1.99,0.01,169,167.31,165.64,0.0,321.75,25.87,12.87,37.87,-0.13,12.87,-12.13,0,325,13,38,0.13,13,-12,0,0,25,-13,-12.87,-25,625,12,12.13,25,93.68733333333333,13,12.87,0.99,93.68733333333333,0,25
10,1.99,0.01,1,0.99,0.98,0.0,0.99,1.99,0.99,1.99,-0.01,0.99,-0.01,0,1,1,2,0.01,1,0,0,0,1,-1,-0.99,-1,1,0,0.01,1,1.0,1,0.99,0.99,1.0,0,1
11,1.99,0.01,1,0.99,0.98,0.0,0.0,1.99,0.99,0.99,-0.01,0.99,0.99,0,0,1,1,0.01,1,1,0,0,0,-1,-0.99,0,0,-1,-0.99,0,0.994,1,0.99,0.99,0.994,0,0
12,1.01,0.99,1,0.01,0.0,0.24,0.25,1.01,24.01,25.01,-0.99,-23.99,-24.99,24,25,25,26,0.99,-23,-24,576,600,49,23,23.99,-1,625,24,24.99,1,48.792,1,0.01,0.01,24.792,24,25
13,1.99,0.01,4,3.96,3.92,0.0,0.0,3.98,1.98,1.98,-0.02,1.98,1.98,0,0,2,2,0.02,2,2,0,0,0,-2,-1.98,0,0,-2,-1.98,0,2.974,2,1.98,0.99,2.974,0,0
14,1.01,0.99,1,0.01,0.0,0.0,0.0,1.01,0.01,0.01,-0.99,0.01,0.01,0,0,1,1,0.99,1,1,0,0,0,-1,-0.01,0,0,-1,-0.01,0,0.014,1,0.01,0.01,0.014,0,0
15,1.01,0.99,169,1.69,0.02,0.0,0.0,13.13,0.13,0.13,-12.87,0.13,0.13,0,0,13,13,12.87,13,13,0,0,0,-13,-0.13,0,0,-13,-0.13,0,0.8026666666666666,13,0.13,0.01,0.8026666666666666,0,0
16,1.99,0.01,1,0.99,0.98,0.0,0.99,1.99,0.99,1.99,-0.01,0.99,-0.01,0,1,1,2,0.01,1,0,0,0,1,-1,-0.99,-1,1,0,0.01,1,1.0,1,0.99,0.99,1.0,0,1
17,1.01,0.99,4,0.04,0.0,0.0,0.0,2.02,0.02,0.02,-1.98,0.02,0.02,0,0,2,2,1.98,2,2,0,0,0,-2,-0.02,0,0,-2,-0.02,0,0.03133333333333333,2,0.02,0.01,0.03133333333333333,0,0
18,1.99,0.01,1,0.99,0.98,0.0,0.0,1.99,0.99,0.99,-0.01,0.99,0.99,0,0,1,1,0.01,1,1,0,0,0,-1,-0.99,0,0,-1,-0.99,0,0.9873333333333333,1,0.99,0.99,0.9873333333333333,0,0
19,1.01,0.99,169,1.69,0.02,0.0,0.0,13.13,0.13,0.13,-12.87,0.13,0.13,0,0,13,13,12.87,13,13,0,0,0,-13,-0.13,0,0,-13,-0.13,0,0.8473333333333334,13,0.13,0.01,0.8473333333333334,0,0
20,1.01,0.99,1,0.01,0.0,0.25,0.25,1.01,25.01,25.01,-0.99,-24.99,-24.99,25,25,26,26,0.99,-24,-24,625,625,50,24,24.99,0,625,24,24.99,0,49.696,1,0.01,0.01,24.695999999999998,25,25
21,1.99,0.01,4,3.96,3.92,0.0,0.0,3.98,1.98,1.98,-0.02,1.98,1.98,0,0,2,2,0.02,2,2,0,0,0,-2,-1.98,0,0,-2,-1.98,0,2.973333333333333,2,1.98,0.99,2.973333333333333,0,0
22,1.01,0.99,1,0.01,0.0,0.0,0.0,1.01,0.01,0.01,-0.99,0.01,0.01,0,0,1,1,0.99,1,1,0,0,0,-1,-0.01,0,0,-1,-0.01,0,0.009333333333333334,1,0.01,0.01,0.009333333333333334,0,0
23,1.74,0.26,169,125.9,93.8,0.0,0.0,22.68,9.68,9.68,-3.32,9.68,9.68,0,0,13,13,3.32,13,13,0,0,0,-13,-9.68,0,0,-13,-9.68,0,67.78666666666666,13,9.68,0.7449999844779577,67.78666666666666,0,0
24,1.99,0.01,625,618.75,612.56,618.75,321.75,49.75,49.75,37.75,-0.25,-0.25,11.75,625,325,50,38,0.25,0,12,625,325,38,0,0.25,12,169,-12,-11.75,-12,350.1653333333333,25,24.75,0.99,325.1653333333333,25,13
25,1.99,0.01,1,0.99,0.98,0.0,0.99,1.99,0.99,1.99,-0.01,0.99,-0.01,0,1,1,2,0.01,1,0,0,0,1,-1,-0.99,-1,1,0,0.01,1,1.0,1,0.99,0.99,1.0,0,1
26,1.99,0.01,625,618.75,612.56,0.0,618.75,49.75,24.75,49.75,-0.25,24.75,-0.25,0,625,25,50,0.25,25,0,0,0,25,-25,-24.75,-25,625,0,0.25,25,328.106,25,24.75,0.99,328.106,0,25
27,1.99,0.01,1,0.99,0.98,0.0,0.0,1.99,0.99,0.99,-0.01,0.99,0.99,0,0,1,1,0.01,1,1,0,0,0,-1,-0.99,0,0,-1,-0.99,0,0.9913333333333333,1,0.99,0.99,0.9913333333333333,0,0
28,1.99,0.01,144,142.56,141.13,297.0,297.0,23.88,36.88,36.88,-0.12,-13.12,-13.12,300,300,37,37,0.12,-13,-13,625,625,50,13,13.12,0,625,13,13.12,0,105.14733333333334,12,11.88,0.9899999993972133,80.14733333333334,25,25
29,1.99,0.01,4,3.96,3.92,0.0,0.0,3.98,1.98,1.98,-0.02,1.98,1.98,0,0,2,2,0.02,2,2,0,0,0,-2,-1.98,0,0,-2,-1.98,0,2.970666666666667,2,1.98,0.99,2.970666666666667,0,0
30,1.99,0.01,169,167.31,165.64,0.0,321.75,25.87,12.87,37.87,-0.13,12.87,-12.13,0,325,13,38,0.13,13,-12,0,0,25,-13,-12.87,-25,625,12,12.13,25,93.42933333333333,13,12.87,0.99,93.42933333333333,0,25
31,1.01,0.99,1,0.01,0.0,0.0,0.25,1.01,0.01,25.01,-0.99,0.01,-24.99,0,25,1,26,0.99,1,-24,0,0,25,-1,-0.01,-25,625,24,24.99,25,24.76,1,0.01,0.01,24.76,0,25
32,1.01,0.99,625,6.25,0.06,0.0,0.0,25.25,0.25,0.25,-24.75,0.25,0.25,0,0,25,25,24.75,25,25,0,0,0,-25,-0.25,0,0,-25,-0.25,0,3.514,25,0.25,0.01,3.514,0,0
33,1.99,0.01,625,618.75,612.56,618.75,0.0,49.75,49.75,24.75,-0.25,-0.25,24.75,625,0,50,25,0.25,0,25,625,0,25,0,0.25,25,0,-25,-24.75,-25,346.538,25,24.75,0.99,321.538,25,0
34,1.99,0.01,625,618.75,612.56,0.0,0.0,49.75,24.75,24.75,-0.25,24.75,24.75,0,0,25,25,0.25,25,25,0,0,0,-25,-24.75,0,0,-25,-24.75,0,322.034,25,24.75,0.99,322.034,0,0
35,1.01,0.99,169,1.69,0.02,3.25,3.25,13.13,25.13,25.13,-12.87,-24.87,-24.87,325,325,38,38,12.87,-12,-12,625,625,50,12,24.87,0,625,12,24.87,0,347.4153333333333,13,0.13,0.01,322.4153333333333,25,25
36,1.99,0.01,625,618.75,612.56,618.75,0.0,49.75,49.75,24.75,-0.25,-0.25,24.75,625,0,50,25,0.25,0,25,625,0,25,0,0.25,25,0,-25,-24.75,-25,346.692,25,24.75,0.99,321.692,25,0
37,1.01,0.99,625,6.25,0.06,0.0,6.25,25.25,0.25,25.25,-24.75,0.25,-24.75,0,625,25,50,24.75,25,0,0,0,25,-25,-0.25,-25,625,0,24.75,25,621.5613333333333,25,0.25,0.01,621.5613333333333,0,25
38,1.99,0.01,625,618.75,612.56,0.0,0.0,49.75,24.75,24.75,-0.25,24.75,24.75,0,0,25,25,0.25,25,25,0,0,0,-25,-24.75,0,0,-25,-24.75,0,321.77933333333334,25,24.75,0.99,321.77933333333334,0,0
39,1.99,0.01,625,618.75,612.56,618.75,618.75,49.75,49.75,49.75,-0.25,-0.25,-0.25,625,625,50,50,0.25,0,0,625,625,50,0,0.25,0,625,0,0.25,0,352.82,25,24.75,0.99,327.82,25,25
40,1.99,0.01,625,618.75,612.56,618.75,297.0,49.75,49.75,36.75,-0.25,-0.25,12.75,625,300,50,37,0.25,0,13,625,300,37,0,0.25,13,144,-13,-12.75,-13,349.552,25,24.75,0.99,324.552,25,12
41,1.99,0.01,625,618.75,612.56,0.0,618.75,49.75,24.75,49.75,-0.25,24.75,-0.25,0,625,25,50,0.25,25,0,0,0,25,-25,-24.75,-25,625,0,0.25,25,327.94466666666665,25,24.75,0.99,327.94466666666665,0,25
42,1.99,0.01,169,167.31,165.64,0.0,321.75,25.87,12.87,37.87,-0.13,12.87,-12.13,0,325,13,38,0.13,13,-12,0,0,25,-13,-12.87,-25,625,12,12.13,25,93.68733333333333,13,12.87,0.99,93.68733333333333,0,25
43,1.99,0.01,1,0.99,0.98,0.0,0.99,1.99,0.99,1.99,-0.01,0.99,-0.01,0,1,1,2,0.01,1,0,0,0,1,-1,-0.99,-1,1,0,0.01,1,1.0,1,0.99,0.99,1.0,0,1
44,1.99,0.01,1,0.99,0.98,0.0,0.0,1.99,0.99,0.99,-0.01,0.99,0.99,0,0,1,1,0.01,1,1,0,0,0,-1,-0.99,0,0,-1,-0.99,0,0.994,1,0.99,0.99,0.994,0,0
45,1.01,0.99,1,0.01,0.0,0.24,0.25,1.01,24.01,25.01,-0.99,-23.99,-24.99,24,25,25,26,0.99,-23,-24,576,600,49,23,23.99,-1,625,24,24.99,1,48.792,1,0.01,0.01,24.792,24,25
46,1.99,0.01,4,3.96,3.92,0.0,0.0,3.98,1.98,1.98,-0.02,1.98,1.98,0,0,2,2,0.02,2,2,0,0,0,-2,-1.98,0,0,-2,-1.98,0,2.974,2,1.98,0.99,2.974,0,0
47,1.01,0.99,1,0.01,0.0,0.0,0.0,1.01,0.01,0.01,-0.99,0.01,0.01,0,0,1,1,0.99,1,1,0,0,0,-1,-0.01,0,0,-1,-0.01,0,0.014,1,0.01,0.01,0.014,0,0
48,1.01,0.99,169,1.69,0.02,0.0,0.0,13.13,0.13,0.13,-12.87,0.13,0.13,0,0,13,13,12.87,13,13,0,0,0,-13,-0.13,0,0,-13,-0.13,0,0.8026666666666666,13,0.13,0.01,0.8026666666666666,0,0
49,1.99,0.01,1,0.99,0.98,0.0,0.99,1.99,0.99,1.99,-0.01,0.99,-0.01,0,1,1,2,0.01,1,0,0,0,1,-1,-0.99,-1,1,0,0.01,1,1.0,1,0.99,0.99,1.0,0,1
50,1.01,0.99,4,0.04,0.0,0.0,0.0,2.02,0.02,0.02,-1.98,0.02,0.02,0,0,2,2,1.98,2,2,0,0,0,-2,-0.02,0,0,-2,-0.02,0,0.03133333333333333,2,0.02,0.01,0.03133333333333333,0,0
51,1.99,0.01,1,0.99,0.98,0.0,0.0,1.99,0.99,0.99,-0.01,0.99,0.99,0,0,1,1,0.01,1,1,0,0,0,-1,-0.99,0,0,-1,-0.99,0,0.9873333333333333,1,0.99,0.99,0.9873333333333333,0,0
52,1.01,0.99,169,1.69,0.02,0.0,0.0,13.13,0.13,0.13,-12.87,0.13,0.13,0,0,13,13,12.87,13,13,0,0,0,-13,-0.13,0,0,-13,-0.13,0,0.8473333333333334,13,0.13,0.01,0.8473333333333334,0,0
53,1.01,0.99,1,0.01,0.0,0.25,0.25,1.01,25.01,25.01,-0.99,-24.99,-24.99,25,25,26,26,0.99,-24,-24,625,625,50,24,24.99,0,625,24,24.99,0,49.696,1,0.01,0.01,24.695999999999998,25,25
54,1.99,0.01,4,3.96,3.92,0.0,0.0,3.98,1.98,1.98,-0.02,1.98,1.98,0,0,2,2,0.02,2,2,0,0,0,-2,-1.98,0,0,-2,-1.98,0,2.973333333333333,2,1.98,0.99,2.973333333333333,0,0
55,1.01,0.99,1,0.01,0.0,0.0,0.0,1.01,0.01,0.01,-0.99,0.01,0.01,0,0,1,1,0.99,1,1,0,0,0,-1,-0.01,0,0,-1,-0.01,0,0.009333333333333334,1,0.01,0.01,0.009333333333333334,0,0
56,1.74,0.26,169,125.9,93.8,0.0,0.0,22.68,9.68,9.68,-3.32,9.68,9.68,0,0,13,13,3.32,13,13,0,0,0,-13,-9.68,0,0,-13,-9.68,0,67.78666666666666,13,9.68,0.7449999844779577,67.78666666666666,0,0
57,1.99,0.01,625,618.75,612.56,618.75,321.75,49.75,49.75,37.75,-0.25,-0.25,11.75,625,325,50,38,0.25,0,12,625,325,38,0,0.25,12,169,-12,-11.75,-12,350.1653333333333,25,24.75,0.99,325.1653333333333,25,13
58,1.99,0.01,1,0.99,0.98,0.0,0.99,1.99,0.99,1.99,-0.01,0.99,-0.01,0,1,1,2,0.01,1,0,0,0,1,-1,-0.99,-1,1,0,0.01,1,1.0,1,0.99,0.99,1.0,0,1
59,1.99,0.01,625,618.75,612.56,0.0,618.75,49.75,24.75,49.75,-0.25,24.75,-0.25,0,625,25,50,0.25,25,0,0,0,25,-25,-24.75,-25,625,0,0.25,25,328.106,25,24.75,0.99,328.106,0,25
60,1.99,0.01,1,0.99,0.98,0.0,0.0,1.99,0.99,0.99,-0.01,0.99,0.99,0,0,1,1,0.01,1,1,0,0,0,-1,-0.99,0,0,-1,-0.99,0,0.9913333333333333,1,0.99,0.99,0.9913333333333333,0,0
61,1.99,0.01,144,142.56,141.13,297.0,297.0,23.88,36.88,36.88,-0.12,-13.12,-13.12,300,300,37,37,0.12,-13,-13,625,625,50,13,13.12,0,625,13,13.12,0,105.14733333333334,12,11.88,0.9899999993972133,80.14733333333334,25,25
62,1.99,0.01,4,3.96,3.92,0.0,0.0,3.98,1.98,1.98,-0.02,1.98,1.98,0,0,2,2,0.02,2,2,0,0,0,-2,-1.98,0,0,-2,-1.98,0,2.970666666666667,2,1.98,0.99,2.970666666666667,0,0
63,1.99,0.01,169,167.31,165.64,0.0,321.75,25.87,12.87,37.87,-0.13,12.87,-12.13,0,325,13,38,0.13,13,-12,0,0,25,-13,-12.87,-25,625,12,12.13,25,93.42933333333333,13,12.87,0.99,93.42933333333333,0,25
64,1.01,0.99,1,0.01,0.0,0.0,0.25,1.01,0.01,25.01,-0.99,0.01,-24.99,0,25,1,26,0.99,1,-24,0,0,25,-1,-0.01,-25,625,24,24.99,25,24.76,1,0.01,0.01,24.76,0,25
65,1.01,0.99,625,6.25,0.06,0.0,0.0,25.25,0.25,0.25,-24.75,0.25,0.25,0,0,25,25,24.75,25,25,0,0,0,-25,-0.25,0,0,-25,-0.25,0,3.514,25,0.25,0.01,3.514,0,0
66,1.99,0.01,625,618.75,612.56,618.75,0.0,49.75,49.75,24.75,-0.25,-0.25,24.75,625,0,50,25,0.25,0,25,625,0,25,0,0.25,25,0,-25,-24.75,-25,346.538,25,24.75,0.99,321.538,25,0
67,1.99,0.01,625,618.75,612.56,0.0,0.0,49.75,24.75,24.75,-0.25,24.75,24.75,0,0,25,25,0.25,25,25,0,0,0,-25,-24.75,0,0,-25,-24.75,0,322.034,25,24.75,0.99,322.034,0,0
68,1.01,0.99,169,1.69,0.02,3.25,3.25,13.13,25.13,25.13,-12.87,-24.87,-24.87,325,325,38,38,12.87,-12,-12,625,625,50,12,24.87,0,625,12,24.87,0,347.4153333333333,13,0.13,0.01,322.4153333333333,25,25
69,1.99,0.01,625,618.75,612.56,618.75,0.0,49.75,49.75,24.75,-0.25,-0.25,24.75,625,0,50,25,0.25,0,25,625,0,25,0,0.25,25,0,-25,-24.75,-25,346.692,25,24.75,0.99,321.692,25,0
70,1.01,0.99,625,6.25,0.06,0.0,6.25,25.25,0.25,25.25,-24.75,0.25,-24.75,0,625,25,50,24.75,25,0,0,0,25,-25,-0.25,-25,625,0,24.75,25,621.5613333333333,25,0.25,0.01,621.5613333333333,0,25
71,1.99,0.01,625,618.75,612.56,0.0,0.0,49.75,24.75,24.75,-0.25,24.75,24.75,0,0,25,25,0.25,25,25,0,0,0,-25,-24.75,0,0,-25,-24.75,0,321.77933333333334,25,24.75,0.99,321.77933333333334,0,0
72,1.99,0.01,625,618.75,612.56,618.75,618.75,49.75,49.75,49.75,-0.25,-0.25,-0.25,625,625,50,50,0.25,0,0,625,625,50,0,0.25,0,625,0,0.25,0,352.82,25,24.75,0.99,327.82,25,25
73,1.99,0.01,625,618.75,612.56,618.75,297.0,49.75,49.75,36.75,-0.25,-0.25,12.75,625,300,50,37,0.25,0,13,625,300,37,0,0.25,13,144,-13,-12.75,-13,349.552,25,24.75,0.99,324.552,25,12
74,1.99,0.01,625,618.75,612.56,0.0,618.75,49.75,24.75,49.75,-0.25,24.75,-0.25,0,625,25,50,0.25,25,0,0,0,25,-25,-24.75,-25,625,0,0.25,25,327.94466666666665,25,24.75,0.99,327.94466666666665,0,25
75,1.99,0.01,169,167.31,165.64,0.0,321.75,25.87,12.87,37.87,-0.13,12.87,-12.13,0,325,13,38,0.13,13,-12,0,0,25,-13,-12.87,-25,625,12,12.13,25,93.68733333333333,13,12.87,0.99,93.68733333333333,0,25
76,1.99,0.01,1,0.99,0.98,0.0,0.99,1.99,0.99,1.99,-0.01,0.99,-0.01,0,1,1,2,0.01,1,0,0,0,1,-1,-0.99,-1,1,0,0.01,1,1.0,1,0.99,0.99,1.0,0,1
77,1.99,0.01,1,0.99,0.98,0.0,0.0,1.99,0.99,0.99,-0.01,0.99,0.99,0,0,1,1,0.01,1,1,0,0,0,-1,-0.99,0,0,-1,-0.99,0,0.994,1,0.99,0.99,0.994,0,0
78,1.01,0.99,1,0.01,0.0,0.24,0.25,1.01,24.01,25.01,-0.99,-23.99,-24.99,24,25,25,26,0.99,-23,-24,576,600,49,23,23.99,-1,625,24,24.99,1,48.792,1,0.01,0.01,24.792,24,25
79,1.99,0.01,4,3.96,3.92,0.0,0.0,3.98,1.98,1.98,-0.02,1.98,1.98,0,0,2,2,0.02,2,2,0,0,0,-2,-1.98,0,0,-2,-1.98,0,2.974,2,1.98,0.99,2.974,0,0
80,1.01,0.99,1,0.01,0.0,0.0,0.0,1.01,0.01,0.01,-0.99,0.01,0.01,0,0,1,1,0.99,1,1,0,0,0,-1,-0.01,0,0,-1,-0.01,0,0.014,1,0.01,0.01,0.014,0,0
81,1.01,0.99,169,1.69,0.02,0.0,0.0,13.13,0.13,0.13,-12.87,0.13,0.13,0,0,13,13,12.87,13,13,0,0,0,-13,-0.13,0,0,-13,-0.13,0,0.8026666666666666,13,0.13,0.01,0.8026666666666666,0,0
82,1.99,0.01,1,0.99,0.98,0.0,0.99,1.99,0.99,1.99,-0.01,0.99,-0.01,0,1,1,2,0.01,1,0,0,0,1,-1,-0.99,-1,1,0,0.01,1,1.0,1,0.99,0.99,1.0,0,1
83,1.01,0.99,4,0.04,0.0,0.0,0.0,2.02,0.02,0.02,-1.98,0.02,0.02,0,0,2,2,1.98,2,2,0,0,0,-2,-0.02,0,0,-2,-0.02,0,0.03133333333333333,2,0.02,0.01,0.03133333333333333,0,0
84,1.99,0.01,1,0.99,0.98,0.0,0.0,1.99,0.99,0.99,-0.01,0.99,0.99,0,0,1,1,0.01,1,1,0,0,0,-1,-0.99,0,0,-1,-0.99,0,0.9873333333333333,1,0.99,0.99,0.9873333333333333,0,0
85,1.01,0.99,169,1.69,0.02,0.0,0.0,13.13,0.13,0.13,-12.87,0.13,0.13,0,0,13,13,12.87,13,13,0,0,0,-13,-0.13,0,0,-13,-0.13,0,0.8473333333333334,13,0.13,0.01,0.8473333333333334,0,0
86,1.01,0.99,1,0.01,0.0,0.25,0.25,1.01,25.01,25.01,-0.99,-24.99,-24.99,25,25,26,26,0.99,-24,-24,625,625,50,24,24.99,0,625,24,24.99,0,49.696,1,0.01,0.01,24.695999999999998,25,25
87,1.99,0.01,4,3.96,3.92,0.0,0.0,3.98,1.98,1.98,-0.02,1.98,1.98,0,0,2,2,0.02,2,2,0,0,0,-2,-1.98,0,0,-2,-1.98,0,2.973333333333333,2,1.98,0.99,2.973333333333333,0,0
88,1.01,0.99,1,0.01,0.0,0.0,0.0,1.01,0.01,0.01,-0.99,0.01,0.01,0,0,1,1,0.99,1,1,0,0,0,-1,-0.01,0,0,-1,-0.01,0,0.009333333333333334,1,0.01,0.01,0.009333333333333334,0,0
89,1.74,0.26,169,125.9,93.8,0.0,0.0,22.68,9.68,9.68,-3.32,9.68,9.68,0,0,13,13,3.32,13,13,0,0,0,-13,-9.68,0,0,-13,-9.68,0,67.78666666666666,13,9.68,0.7449999844779577,67.78666666666666,0,0
90,1.99,0.01,625,618.75,612.56,618.75,321.75,49.75,49.75,37.75,-0.25,-0.25,11.75,625,325,50,38,0.25,0,12,625,325,38,0,0.25,12,169,-12,-11.75,-12,350.1653333333333,25,24.75,0.99,325.1653333333333,25,13
91,1.99,0.01,1,0.99,0.98,0.0,0.99,1.99,0.99,1.99,-0.01,0.99,-0.01,0,1,1,2,0.01,1,0,0,0,1,-1,-0.99,-1,1,0,0.01,1,1.0,1,0.99,0.99,1.0,0,1
92,1.99,0.01,625,618.75,612.56,0.0,618.75,49.75,24.75,49.75,-0.25,24.75,-0.25,0,625,25,50,0.25,25,0,0,0,25,-25,-24.75,-25,625,0,0.25,25,328.106,25,24.75,0.99,328.106,0,25
93,1.99,0.01,1,0.99,0.98,0.0,0.0,1.99,0.99,0.99,-0.01,0.99,0.99,0,0,1,1,0.01,1,1,0,0,0,-1,-0.99,0,0,-1,-0.99,0,0.9913333333333333,1,0.99,0.99,0.9913333333333333,0,0
94,1.99,0.01,144,142.56,141.13,297.0,297.0,23.88,36.88,36.88,-0.12,-13.12,-13.12,300,300,37,37,0.12,-13,-13,625,625,50,13,13.12,0,625,13,13.12,0,105.14733333333334,12,11.88,0.9899999993972133,80.14733333333334,25,25
95,1.99,0.01,4,3.96,3.92,0.0,0.0,3.98,1.98,1.98,-0.02,1.98,1.98,0,0,2,2,0.02,2,2,0,0,0,-2,-1.98,0,0,-2,-1.98,0,2.970666666666667,2,1.98,0.99,2.970666666666667,0,0
96,1.99,0.01,169,167.31,165.64,0.0,321.75,25.87,12.87,37.87,-0.13,12.87,-12.13,0,325,13,38,0.13,13,-12,0,0,25,-13,-12.87,-25,625,12,12.13,25,93.42933333333333,13,12.87,0.99,93.42933333333333,0,25
97,1.01,0.99,1,0.01,0.0,0.0,0.25,1.01,0.01,25.01,-0.99,0.01,-24.99,0,25,1,26,0.99,1,-24,0,0,25,-1,-0.01,-25,625,24,24.99,25,24.76,1,0.01,0.01,24.76,0,25
98,1.01,0.99,625,6.25,0.06,0.0,0.0,25.25,0.25,0.25,-24.75,0.25,0.25,0,0,25,25,24.75,25,25,0,0,0,-25,-0.25,0,0,-25,-0.25,0,3.514,25,0.25,0.01,3.514,0,0
99,1.99,0.01,625,618.75,612.56,618.75,0.0,49.75,49.75,24.75,-0.25,-0.25,24.75,625,0,50,25,0.25,0,25,625,0,25,0,0.25,25,0,-25,-24.75,-25,346.538,25,24.75,0.99,321.538,25,0
100,1.99,0.01,625,618.75,612.56,0.0,0.0,49.75,24.75,24.75,-0.25,24.75,24.75,0,0,25,25,0.25,25,25,0,0,0,-25,-24.75,0,0,-25,-24.75,0,322.034,25,24.75,0.99,322.034,0,0
101,1.01,0.99,169,1.69,0.02,3.25,3.25,13.13,25.13,25.13,-12.87,-24.87,-24.87,325,325,38,38,12.87,-12,-12,625,625,50,12,24.87,0,625,12,24.87,0,347.4153333333333,13,0.13,0.01,322.4153333333333,25,25
102,1.99,0.01,625,618.75,612.56,618.75,0.0,49.75,49.75,24.75,-0.25,-0.25,24.75,625,0,50,25,0.25,0,25,625,0,25,0,0.25,25,0,-25,-24.75,-25,346.692,25,24.75,0.99,321.692,25,0
103,1.01,0.99,625,6.25,0.06,0.0,6.25,25.25,0.25,25.25,-24.75,0.25,-24.75,0,625,25,50,24.75,25,0,0,0,25,-25,-0.25,-25,625,0,24.75,25,621.5613333333333,25,0.25,0.01,621.5613333333333,0,25
104,1.99,0.01,625,618.75,612.56,0.0,0.0,49.75,24.75,24.75,-0.25,24.75,24.75,0,0,25,25,0.25,25,25,0,0,0,-25,-24.75,0,0,-25,-24.75,0,321.77933333333334,25,24.75,0.99,321.77933333333334,0,0
105,1.99,0.01,625,618.75,612.56,618.75,618.75,49.75,49.75,49.75,-0.25,-0.25,-0.25,625,625,50,50,0.25,0,0,625,625,50,0,0.25,0,625,0,0.25,0,352.82,25,24.75,0.99,327.82,25,25
106,1.99,0.01,625,618.75,612.56,618.75,297.0,49.75,49.75,36.75,-0.25,-0.25,12.75,625,300,50,37,0.25,0,13,625,300,37,0,0.25,13,144,-13,-12.75,-13,349.552,25,24.75,0.99,324.552,25,12
107,1.99,0.01,625,618.75,612.56,0.0,618.75,49.75,24.75,49.75,-0.25,24.75,-0.25,0,625,25,50,0.25,25,0,0,0,25,-25,-24.75,-25,625,0,0.25,25,327.94466666666665,25,24.75,0.99,327.94466666666665,0,25
108,1.99,0.01,169,167.31,165.64,0.0,321.75,25.87,12.87,37.87,-0.13,12.87,-12.13,0,325,13,38,0.13,13,-12,0,0,25,-13,-12.87,-25,625,12,12.13,25,93.68733333333333,13,12.87,0.99,93.68733333333333,0,25
109,1.99,0.01,1,0.99,0.98,0.0,0.99,1.99,0.99,1.99,-0.01,0.99,-0.01,0,1,1,2,0.01,1,0,0,0,1,-1,-0.99,-1,1,0,0.01,1,1.0,1,0.99,0.99,1.0,0,1
110,1.99,0.01,1,0.99,0.98,0.0,0.0,1.99,0.99,0.99,-0.01,0.99,0.99,0,0,1,1,0.01,1,1,0,0,0,-1,-0.99,0,0,-1,-0.99,0,0.994,1,0.99,0.99,0.994,0,0
111,1.01,0.99,1,0.01,0.0,0.24,0.25,1.01,24.01,25.01,-0.99,-23.99,-24.99,24,25,25,26,0.99,-23,-24,576,600,49,23,23.99,-1,625,24,24.99,1,48.792,1,0.01,0.01,24.792,24,25
112,1.99,0.01,4,3.96,3.92,0.0,0.0,3.98,1.98,1.98,-0.02,1.98,1.98,0,0,2,2,0.02,2,2,0,0,0,-2,-1.98,0,0,-2,-1.98,0,2.974,2,1.98,0.99,2.974,0,0
113,1.01,0.99,1,0.01,0.0,0.0,0.0,1.01,0.01,0.01,-0.99,0.01,0.01,0,0,1,1,0.99,1,1,0,0,0,-1,-0.01,0,0,-1,-0.01,0,0.014,1,0.01,0.01,0.014,0,0
114,1.01,0.99,169,1.69,0.02,0.0,0.0,13.13,0.13,0.13,-12.87,0.13,0.13,0,0,13,13,12.87,13,13,0,0,0,-13,-0.13,0,0,-13,-0.13,0,0.8026666666666666,13,0.13,0.01,0.8026666666666666,0,0
115,1.99,0.01,1,0.99,0.98,0.0,0.99,1.99,0.99,1.99,-0.01,0.99,-0.01,0,1,1,2,0.01,1,0,0,0,1,-1,-0.99,-1,1,0,0.01,1,1.0,1,0.99,0.99,1.0,0,1
116,1.01,0.99,4,0.04,0.0,0.0,0.0,2.02,0.02,0.02,-1.98,0.02,0.02,0,0,2,2,1.98,2,2,0,0,0,-2,-0.02,0,0,-2,-0.02,0,0.03133333333333333,2,0.02,0.01,0.03133333333333333,0,0
117,1.99,0.01,1,0.99,0.98,0.0,0.0,1.99,0.99,0.99,-0.01,0.99,0.99,0,0,1,1,0.01,1,1,0,0,0,-1,-0.99,0,0,-1,-0.99,0,0.9873333333333333,1,0.99,0.99,0.9873333333333333,0,0
118,1.01,0.99,169,1.69,0.02,0.0,0.0,13.13,0.13,0.13,-12.87,0.13,0.13,0,0,13,13,12.87,13,13,0,0,0,-13,-0.13,0,0,-13,-0.13,0,0.8473333333333334,13,0.13,0.01,0.8473333333333334,0,0
119,1.01,0.99,1,0.01,0.0,0.25,0.25,1.01,25.01,25.01,-0.99,-24.99,-24.99,25,25,26,26,0.99,-24,-24,625,625,50,24,24.99,0,625,24,24.99,0,49.696,1,0.01,0.01,24.695999999999998,25,25
120,1.99,0.01,4,3.96,3.92,0.0,0.0,3.98,1.98,1.98,-0.02,1.98,1.98,0,0,2,2,0.02,2,2,0,0,0,-2,-1.98,0,0,-2,-1.98,0,2.973333333333333,2,1.98,0.99,2.973333333333333,0,0
121,1.01,0.99,1,0.01,0.0,0.0,0.0,1.01,0.01,0.01,-0.99,0.01,0.01,0,0,1,1,0.99,1,1,0,0,0,-1,-0.01,0,0,-1,-0.01,0,0.009333333333333334,1,0.01,0.01,0.009333333333333334,0,0
122,1.74,0.26,169,125.9,93.8,0.0,0.0,22.68,9.68,9.68,-3.32,9.68,9.68,0,0,13,13,3.32,13,13,0,0,0,-13,-9.68,0,0,-13,-9.68,0,67.78666666666666,13,9.68,0.7449999844779577,67.78666666666666,0,0
123,1.99,0.01,625,618.75,612.56,618.75,321.75,49.75,49.75,37.75,-0.25,-0.25,11.75,625,325,50,38,0.25,0,12,625,325,38,0,0.25,12,169,-12,-11.75,-12,350.1653333333333,25,24.75,0.99,325.1653333333333,25,13
124,1.99,0.01,1,0.99,0.98,0.0,0.99,1.99,0.99,1.99,-0.01,0.99,-0.01,0,1,1,2,0.01,1,0,0,0,1,-1,-0.99,-1,1,0,0.01,1,1.0,1,0.99,0.99,1.0,0,1
125,1.99,0.01,625,618.75,612.56,0.0,618.75,49.75,24.75,49.75,-0.25,24.75,-0.25,0,625,25,50,0.25,25,0,0,0,25,-25,-24.75,-25,625,0,0.25,25,328.106,25,24.75,0.99,328.106,0,25
126,1.99,0.01,1,0.99,0.98,0.0,0.0,1.99,0.99,0.99,-0.01,0.99,0.99,0,0,1,1,0.01,1,1,0,0,0,-1,-0.99,0,0,-1,-0.99,0,0.9913333333333333,1,0.99,0.99,0.9913333333333333,0,0
127,1.99,0.01,144,142.56,141.13,297.0,297.0,23.88,36.88,36.88,-0.12,-13.12,-13.12,300,300,37,37,0.12,-13,-13,625,625,50,13,13.12,0,625,13,13.12,0,105.14733333333334,12,11.88,0.9899999993972133,80.14733333333334,25,25
128,1.99,0.01,4,3.96,3.92,0.0,0.0,3.98,1.98,1.98,-0.02,1.98,1.98,0,0,2,2,0.02,2,2,0,0,0,-2,-1.98,0,0,-2,-1.98,0,2.970666666666667,2,1.98,0.99,2.970666666666667,0,0
129,1.99,0.01,169,167.31,165.64,0.0,321.75,25.87,12.87,37.87,-0.13,12.87,-12.13,0,325,13,38,0.13,13,-12,0,0,25,-13,-12.87,-25,625,12,12.13,25,93.42933333333333,13,12.87,0.99,93.42933333333333,0,25
130,1.01,0.99,1,0.01,0.0,0.0,0.25,1.01,0.01,25.01,-0.99,0.01,-24.99,0,25,1,26,0.99,1,-24,0,0,25,-1,-0.01,-25,625,24,24.99,25,24.76,1,0.01,0.01,24.76,0,25
131,1.01,0.99,625,6.25,0.06,0.0,0.0,25.25,0.25,0.25,-24.75,0.25,0.25,0,0,25,25,24.75,25,25,0,0,0,-25,-0.25,0,0,-25,-0.25,0,3.514,25,0.25,0.01,3.514,0,0
132,1.99,0.01,625,618.75,612.56,618.75,0.0,49.75,49.75,24.75,-0.25,-0.25,24.75,625,0,50,25,0.25,0,25,625,0,25,0,0.25,25,0,-25,-24.75,-25,346.538,25,24.75,0.99,321.538,25,0
133,1.99,0.01,625,618.75,612.56,0.0,0.0,49.75,24.75,24.75,-0.25,24.75,24.75,0,0,25,25,0.25,25,25,0,0,0,-25,-24.75,0,0,-25,-24.75,0,322.034,25,24.75,0.99,322.034,0,0
134,1.01,0.99,169,1.69,0.02,3.25,3.25,13.13,25.13,25.13,-12.87,-24.87,-24.87,325,325,38,38,12.87,-12,-12,625,625,50,12,24.87,0,625,12,24.87,0,347.4153333333333,13,0.13,0.01,322.4153333333333,25,25
135,1.99,0.01,625,618.75,612.56,618.75,0.0,49.75,49.75,24.75,-0.25,-0.25,24.75,625,0,50,25,0.25,0,25,625,0,25,0,0.25,25,0,-25,-24.75,-25,346.692,25,24.75,0.99,321.692,25,0
136,1.01,0.99,625,6.25,0.06,0.0,6.25,25.25,0.25,25.25,-24.75,0.25,-24.75,0,625,25,50,24.75,25,0,0,0,25,-25,-0.25,-25,625,0,24.75,25,621.5613333333333,25,0.25,0.01,621.5613333333333,0,25
137,1.99,0.01,625,618.75,612.56,0.0,0.0,49.75,24.75,24.75,-0.25,24.75,24.75,0,0,25,25,0.25,25,25,0,0,0,-25,-24.75,0,0,-25,-24.75,0,321.77933333333334,25,24.75,0.99,321.77933333333334,0,0
138,1.99,0.01,625,618.75,612.56,618.75,618.75,49.75,49.75,49.75,-0.25,-0.25,-0.25,625,625,50,50,0.25,0,0,625,625,50,0,0.25,0,625,0,0.25,0,352.82,25,24.75,0.99,327.82,25,25
139,1.99,0.01,625,618.75,612.56,618.75,297.0,49.75,49.75,36.75,-0.25,-0.25,12.75,625,300,50,37,0.25,0,13,625,300,37,0,0.25,13,144,-13,-12.75,-13,349.552,25,24.75,0.99,324.552,25,12
140,1.99,0.01,625,618.75,612.56,0.0,618.75,49.75,24.75,49.75,-0.25,24.75,-0.25,0,625,25,50,0.25,25,0,0,0,25,-25,-24.75,-25,625,0,0.25,25,327.94466666666665,25,24.75,0.99,327.94466666666665,0,25
141,1.99,0.01,169,167.31,165.64,0.0,321.75,25.87,12.87,37.87,-0.13,12.87,-12.13,0,325,13,38,0.13,13,-12,0,0,25,-13,-12.87,-25,625,12,12.13,25,93.68733333333333,13,12.87,0.99,93.68733333333333,0,25
142,1.99,0.01,1,0.99,0.98,0.0,0.99,1.99,0.99,1.99,-0.01,0.99,-0.01,0,1,1,2,0.01,1,0,0,0,1,-1,-0.99,-1,1,0,0.01,1,1.0,1,0.99,0.99,1.0,0,1
143,1.99,0.01,1,0.99,0.98,0.0,0.0,1.99,0.99,0.99,-0.01,0.99,0.99,0,0,1,1,0.01,1,1,0,0,0,-1,-0.99,0,0,-1,-0.99,0,0.994,1,0.99,0.99,0.994,0,0
144,1.01,0.99,1,0.01,0.0,0.24,0.25,1.01,24.01,25.01,-0.99,-23.99,-24.99,24,25,25,26,0.99,-23,-24,576,600,49,23,23.99,-1,625,24,24.99,1,48.792,1,0.01,0.01,24.792,24,25
145,1.99,0.01,4,3.96,3.92,0.0,0.0,3.98,1.98,1.98,-0.02,1.98,1.98,0,0,2,2,0.02,2,2,0,0,0,-2,-1.98,0,0,-2,-1.98,0,2.974,2,1.98,0.99,2.974,0,0
146,1.01,0.99,1,0.01,0.0,0.0,0.0,1.01,0.01,0.01,-0.99,0.01,0.01,0,0,1,1,0.99,1,1,0,0,0,-1,-0.01,0,0,-1,-0.01,0,0.014,1,0.01,0.01,0.014,0,0
147,1.01,0.99,169,1.69,0.02,0.0,0.0,13.13,0.13,0.13,-12.87,0.13,0.13,0,0,13,13,12.87,13,13,0,0,0,-13,-0.13,0,0,-13,-0.13,0,0.8026666666666666,13,0.13,0.01,0.8026666666666666,0,0
148,1.99,0.01,1,0.99,0.98,0.0,0.99,1.99,0.99,1.99,-0.01,0.99,-0.01,0,1,1,2,0.01,1,0,0,0,1,-1,-0.99,-1,1,0,0.01,1,1.0,1,0.99,0.99,1.0,0,1
149,1.01,0.99,4,0.04,0.0,0.0,0.0,2.02,0.02,0.02,-1.98,0.02,0.02,0,0,2,2,1.98,2,2,0,0,0,-2,-0.02,0,0,-2,-0.02,0,0.03133333333333333,2,0.02,0.01,0.03133333333333333,0,0
150,1.99,0.01,1,0.99,0.98,0.0,0.0,1.99,0.99,0.99,-0.01,0.99,0.99,0,0,1,1,0.01,1,1,0,0,0,-1,-0.99,0,0,-1,-0.99,0,0.9873333333333333,1,0.99,0.99,0.9873333333333333,0,0
151,1.01,0.99,169,1.69,0.02,0.0,0.0,13.13,0.13,0.13,-12.87,0.13,0.13,0,0,13,13,12.87,13,13,0,0,0,-13,-0.13,0,0,-13,-0.13,0,0.8473333333333334,13,0.13,0.01,0.8473333333333334,0,0
152,1.01,0.99,1,0.01,0.0,0.25,0.25,1.01,25.01,25.01,-0.99,-24.99,-24.99,25,25,26,26,0.99,-24,-24,625,625,50,24,24.99,0,625,24,24.99,0,49.696,1,0.01,0.01,24.695999999999998,25,25
153,1.99,0.01,4,3.96,3.92,0.0,0.0,3.98,1.98,1.98,-0.02,1.98,1.98,0,0,2,2,0.02,2,2,0,0,0,-2,-1.98,0,0,-2,-1.98,0,2.973333333333333,2,1.98,0.99,2.973333333333333,0,0
154,1.01,0.99,1,0.01,0.0,0.0,0.0,1.01,0.01,0.01,-0.99,0.01,0.01,0,0,1,1,0.99,1,1,0,0,0,-1,-0.01,0,0,-1,-0.01,0,0.009333333333333334,1,0.01,0.01,0.009333333333333334,0,0
155,1.74,0.26,169,125.9,93.8,0.0,0.0,22.68,9.68,9.68,-3.32,9.68,9.68,0,0,13,13,3.32,13,13,0,0,0,-13,-9.68,0,0,-13,-9.68,0,67.78666666666666,13,9.68,0.7449999844779577,67.78666666666666,0,0
156,1.99,0.01,625,618.75,612.56,618.75,321.75,49.75,49.75,37.75,-0.25,-0.25,11.75,625,325,50,38,0.25,0,12,625,325,38,0,0.25,12,169,-12,-11.75,-12,350.1653333333333,25,24.75,0.99,325.1653333333333,25,13
157,1.99,0.01,1,0.99,0.98,0.0,0.99,1.99,0.99,1.99,-0.01,0.99,-0.01,0,1,1,2,0.01,1,0,0,0,1,-1,-0.99,-1,1,0,0.01,1,1.0,1,0.99,0.99,1.0,0,1
158,1.99,0.01,625,618.75,612.56,0.0,618.75,49.75,24.75,49.75,-0.25,24.75,-0.25,0,625,25,50,0.25,25,0,0,0,25,-25,-24.75,-25,625,0,0.25,25,328.106,25,24.75,0.99,328.106,0,25
159,1.99,0.01,1,0.99,0.98,0.0,0.0,1.99,0.99,0.99,-0.01,0.99,0.99,0,0,1,1,0.01,1,1,0,0,0,-1,-0.99,0,0,-1,-0.99,0,0.9913333333333333,1,0.99,0.99,0.9913333333333333,0,0
160,1.99,0.01,144,142.56,141.13,297.0,297.0,23.88,36.88,36.88,-0.12,-13.12,-13.12,300,300,37,37,0.12,-13,-13,625,625,50,13,13.12,0,625,13,13.12,0,105.14733333333334,12,11.88,0.9899999993972133,80.14733333333334,25,25
161,1.99,0.01,4,3.96,3.92,0.0,0.0,3.98,1.98,1.98,-0.02,1.98,1.98,0,0,2,2,0.02,2,2,0,0,0,-2,-1.98,0,0,-2,-1.98,0,2.970666666666667,2,1.98,0.99,2.970666666666667,0,0
162,1.99,0.01,169,167.31,165.64,0.0,321.75,25.87,12.87,37.87,-0.13,12.87,-12.13,0,325,13,38,0.13,13,-12,0,0,25,-13,-12.87,-25,625,12,12.13,25,93.42933333333333,13,12.87,0.99,93.42933333333333,0,25
163,1.01,0.99,1,0.01,0.0,0.0,0.25,1.01,0.01,25.01,-0.99,0.01,-24.99,0,25,1,26,0.99,1,-24,0,0,25,-1,-0.01,-25,625,24,24.99,25,24.76,1,0.01,0.01,24.76,0,25
164,1.01,0.99,625,6.25,0.06,0.0,0.0,25.25,0.25,0.25,-24.75,0.25,0.25,0,0,25,25,24.75,25,25,0,0,0,-25,-0.25,0,0,-25,-0.25,0,3.514,25,0.25,0.01,3.514,0,0
165,1.99,0.01,625,618.75,612.56,618.75,0.0,49.75,49.75,24.75,-0.25,-0.25,24.75,625,0,50,25,0.25,0,25,625,0,25,0,0.25,25,0,-25,-24.75,-25,346.538,25,24.75,0.99,321.538,25,0
166,1.99,0.01,625,618.75,612.56,0.0,0.0,49.75,24.75,24.75,-0.25,24.75,24.75,0,0,25,25,0.25,25,25,0,0,0,-25,-24.75,0,0,-25,-24.75,0,322.034,25,24.75,0.99,322.034,0,0
167,1.01,0.99,169,1.69,0.02,3.25,3.25,13.13,25.13,25.13,-12.87,-24.87,-24.87,325,325,38,38,12.87,-12,-12,625,625,50,12,24.87,0,625,12,24.87,0,347.4153333333333,13,0.13,0.01,322.4153333333333,25,25
168,1.99,0.01,625,618.75,612.56,618.75,0.0,49.75,49.75,24.75,-0.25,-0.25,24.75,625,0,50,25,0.25,0,25,625,0,25,0,0.25,25,0,-25,-24.75,-25,346.692,25,24.75,0.99,321.692,25,0
169,1.01,0.99,625,6.25,0.06,0.0,6.25,25.25,0.25,25.25,-24.75,0.25,-24.75,0,625,25,50,24.75,25,0,0,0,25,-25,-0.25,-25,625,0,24.75,25,621.5613333333333,25,0.25,0.01,621.5613333333333,0,25
170,1.99,0.01,625,618.75,612.56,0.0,0.0,49.75,24.75,24.75,-0.25,24.75,24.75,0,0,25,25,0.25,25,25,0,0,0,-25,-24.75,0,0,-25,-24.75,0,321.77933333333334,25,24.75,0.99,321.77933333333334,0,0
171,1.99,0.01,625,618.75,612.56,618.75,618.75,49.75,49.75,49.75,-0.25,-0.25,-0.25,625,625,50,50,0.25,0,0,625,625,50,0,0.25,0,625,0,0.25,0,352.82,25,24.75,0.99,327.82,25,25
172,1.99,0.01,625,618.75,612.56,618.75,297.0,49.75,49.75,36.75,-0.25,-0.25,12.75,625,300,50,37,0.25,0,13,625,300,37,0,0.25,13,144,-13,-12.75,-13,349.552,25,24.75,0.99,324.552,25,12
173,1.99,0.01,625,618.75,612.56,0.0,618.75,49.75,24.75,49.75,-0.25,24.75,-0.25,0,625,25,50,0.25,25,0,0,0,25,-25,-24.75,-25,625,0,0.25,25,327.94466666666665,25,24.75,0.99,327.94466666666665,0,25
174,1.99,0.01,169,167.31,165.64,0.0,321.75,25.87,12.87,37.87,-0.13,12.87,-12.13,0,325,13,38,0.13,13,-12,0,0,25,-13,-12.87,-25,625,12,12.13,25,93.68733333333333,13,12.87,0.99,93.68733333333333,0,25
175,1.99,0.01,1,0.99,0.98,0.0,0.99,1.99,0.99,1.99,-0.01,0.99,-0.01,0,1,1,2,0.01,1,0,0,0,1,-1,-0.99,-1,1,0,0.01,1,1.0,1,0.99,0.99,1.0,0,1
176,1.99,0.01,1,0.99,0.98,0.0,0.0,1.99,0.99,0.99,-0.01,0.99,0.99,0,0,1,1,0.01,1,1,0,0,0,-1,-0.99,0,0,-1,-0.99,0,0.994,1,0.99,0.99,0.994,0,0
177,1.01,0.99,1,0.01,0.0,0.24,0.25,1.01,24.01,25.01,-0.99,-23.99,-24.99,24,25,25,26,0.99,-23,-24,576,600,49,23,23.99,-1,625,24,24.99,1,48.792,1,0.01,0.01,24.792,24,25
178,1.99,0.01,4,3.96,3.92,0.0,0.0,3.98,1.98,1.98,-0.02,1.98,1.98,0,0,2,2,0.02,2,2,0,0,0,-2,-1.98,0,0,-2,-1.98,0,2.974,2,1.98,0.99,2.974,0,0
179,1.01,0.99,1,0.01,0.0,0.0,0.0,1.01,0.01,0.01,-0.99,0.01,0.01,0,0,1,1,0.99,1,1,0,0,0,-1,-0.01,0,0,-1,-0.01,0,0.014,1,0.01,0.01,0.014,0,0
180,1.01,0.99,169,1.69,0.02,0.0,0.0,13.13,0.13,0.13,-12.87,0.13,0.13,0,0,13,13,12.87,13,13,0,0,0,-13,-0.13,0,0,-13,-0.13,0,0.8026666666666666,13,0.13,0.01,0.8026666666666666,0,0
181,1.99,0.01,1,0.99,0.98,0.0,0.99,1.99,0.99,1.99,-0.01,0.99,-0.01,0,1,1,2,0.01,1,0,0,0,1,-1,-0.99,-1,1,0,0.01,1,1.0,1,0.99,0.99,1.0,0,1
182,1.01,0.99,4,0.04,0.0,0.0,0.0,2.02,0.02,0.02,-1.98,0.02,0.02,0,0,2,2,1.98,2,2,0,0,0,-2,-0.02,0,0,-2,-0.02,0,0.03133333333333333,2,0.02,0.01,0.03133333333333333,0,0
183,1.99,0.01,1,0.99,0.98,0.0,0.0,1.99,0.99,0.99,-0.01,0.99,0.99,0,0,1,1,0.01,1,1,0,0,0,-1,-0.99,0,0,-1,-0.99,0,0.9873333333333333,1,0.99,0.99,0.9873333333333333,0,0
184,1.01,0.99,169,1.69,0.02,0.0,0.0,13.13,0.13,0.13,-12.87,0.13,0.13,0,0,13,13,12.87,13,13,0,0,0,-13,-0.13,0,0,-13,-0.13,0,0.8473333333333334,13,0.13,0.01,0.8473333333333334,0,0
185,1.01,0.99,1,0.01,0.0,0.25,0.25,1.01,25.01,25.01,-0.99,-24.99,-24.99,25,25,26,26,0.99,-24,-24,625,625,50,24,24.99,0,625,24,24.99,0,49.696,1,0.01,0.01,24.695999999999998,25,25
186,1.99,0.01,4,3.96,3.92,0.0,0.0,3.98,1.98,1.98,-0.02,1.98,1.98,0,0,2,2,0.02,2,2,0,0,0,-2,-1.98,0,0,-2,-1.98,0,2.973333333333333,2,1.98,0.99,2.973333333333333,0,0
187,1.01,0.99,1,0.01,0.0,0.0,0.0,1.01,0.01,0.01,-0.99,0.01,0.01,0,0,1,1,0.99,1,1,0,0,0,-1,-0.01,0,0,-1,-0.01,0,0.009333333333333334,1,0.01,0.01,0.009333333333333334,0,0
188,1.74,0.26,169,125.9,93.8,0.0,0.0,22.68,9.68,9.68,-3.32,9.68,9.68,0,0,13,13,3.32,13,13,0,0,0,-13,-9.68,0,0,-13,-9.68,0,67.78666666666666,13,9.68,0.7449999844779577,67.78666666666666,0,0
189,1.99,0.01,625,618.75,612.56,618.75,321.75,49.75,49.75,37.75,-0.25,-0.25,11.75,625,325,50,38,0.25,0,12,625,325,38,0,0.25,12,169,-12,-11.75,-12,350.1653333333333,25,24.75,0.99,325.1653333333333,25,13
190,1.99,0.01,1,0.99,0.98,0.0,0.99,1.99,0.99,1.99,-0.01,0.99,-0.01,0,1,1,2,0.01,1,0,0,0,1,-1,-0.99,-1,1,0,0.01,1,1.0,1,0.99,0.99,1.0,0,1
191,1.99,0.01,625,618.75,612.56,0.0,618.75,49.75,24.75,49.75,-0.25,24.75,-0.25,0,625,25,50,0.25,25,0,0,0,25,-25,-24.75,-25,625,0,0.25,25,328.106,25,24.75,0.99,328.106,0,25
192,1.99,0.01,1,0.99,0.98,0.0,0.0,1.99,0.99,0.99,-0.01,0.99,0.99,0,0,1,1,0.01,1,1,0,0,0,-1,-0.99,0,0,-1,-0.99,0,0.9913333333333333,1,0.99,0.99,0.9913333333333333,0,0
193,1.99,0.01,144,142.56,141.13,297.0,297.0,23.88,36.88,36.88,-0.12,-13.12,-13.12,300,300,37,37,0.12,-13,-13,625,625,50,13,13.12,0,625,13,13.12,0,105.14733333333334,12,11.88,0.9899999993972133,80.14733333333334,25,25
194,1.99,0.01,4,3.96,3.92,0.0,0.0,3.98,1.98,1.98,-0.02,1.98,1.98,0,0,2,2,0.02,2,2,0,0,0,-2,-1.98,0,0,-2,-1.98,0,2.970666666666667,2,1.98,0.99,2.970666666666667,0,0
195,1.99,0.01,169,167.31,165.64,0.0,321.75,25.87,12.87,37.87,-0.13,12.87,-12.13,0,325,13,38,0.13,13,-12,0,0,25,-13,-12.87,-25,625,12,12.13,25,93.42933333333333,13,12.87,0.99,93.42933333333333,0,25
196,1.01,0.99,1,0.01,0.0,0.0,0.25,1.01,0.01,25.01,-0.99,0.01,-24.99,0,25,1,26,0.99,1,-24,0,0,25,-1,-0.01,-25,625,24,24.99,25,24.76,1,0.01,0.01,24.76,0,25
197,1.01,0.99,625,6.25,0.06,0.0,0.0,25.25,0.25,0.25,-24.75,0.25,0.25,0,0,25,25,24.75,25,25,0,0,0,-25,-0.25,0,0,-25,-0.25,0,3.514,25,0.25,0.01,3.514,0,0
198,1.99,0.01,625,618.75,612.56,618.75,0.0,49.75,49.75,24.75,-0.25,-0.25,24.75,625,0,50,25,0.25,0,25,625,0,25,0,0.25,25,0,-25,-24.75,-25,346.538,25,24.75,0.99,321.538,25,0
199,1.99,0.01,625,618.75,612.56,0.0,0.0,49.75,24.75,24.75,-0.25,24.75,24.75,0,0,25,25,0.25,25,25,0,0,0,-25,-24.75,0,0,-25,-24.75,0,322.034,25,24.75,0.99,322.034,0,0
200,1.01,0.99,169,1.69,0.02,3.25,3.25,13.13,25.13,25.13,-12.87,-24.87,-24.87,325,325,38,38,12.87,-12,-12,625,625,50,12,24.87,0,625,12,24.87,0,347.4153333333333,13,0.13,0.01,322.4153333333333,25,25
201,1.99,0.01,625,618.75,612.56,618.75,0.0,49.75,49.75,24.75,-0.25,-0.25,24.75,625,0,50,25,0.25,0,25,625,0,25,0,0.25,25,0,-25,-24.75,-25,346.692,25,24.75,0.99,321.692,25,0
202,1.01,0.99,625,6.25,0.06,0.0,6.25,25.25,0.25,25.25,-24.75,0.25,-24.75,0,625,25,50,24.75,25,0,0,0,25,-25,-0.25,-25,625,0,24.75,25,621.5613333333333,25,0.25,0.01,621.5613333333333,0,25
203,1.99,0.01,625,618.75,612.56,0.0,0.0,49.75,24.75,24.75,-0.25,24.75,24.75,0,0,25,25,0.25,25,25,0,0,0,-25,-24.75,0,0,-25,-24.75,0,321.77933333333334,25,24.75,0.99,321.77933333333334,0,0
204,1.99,0.01,625,618.75,612.56,618.75,618.75,49.75,49.75,49.75,-0.25,-0.25,-0.25,625,625,50,50,0.25,0,0,625,625,50,0,0.25,0,625,0,0.25,0,352.82,25,24.75,0.99,327.82,25,25
205,1.99,0.01,625,618.75,612.56,618.75,297.0,49.75,49.75,36.75,-0.25,-0.25,12.75,625,300,50,37,0.25,0,13,625,300,37,0,0.25,13,144,-13,-12.75,-13,349.552,25,24.75,0.99,324.552,25,12
206,1.99,0.01,625,618.75,612.56,0.0,618.75,49.75,24.75,49.75,-0.25,24.75,-0.25,0,625,25,50,0.25,25,0,0,0,25,-25,-24.75,-25,625,0,0.25,25,327.94466666666665,25,24.75,0.99,327.94466666666665,0,25
207,1.99,0.01,169,167.31,165.64,0.0,321.75,25.87,12.87,37.87,-0.13,12.87,-12.13,0,325,13,38,0.13,13,-12,0,0,25,-13,-12.87,-25,625,12,12.13,25,93.68733333333333,13,12.87,0.99,93.68733333333333,0,25
208,1.99,0.01,1,0.99,0.98,0.0,0.99,1.99,0.99,1.99,-0.01,0.99,-0.01,0,1,1,2,0.01,1,0,0,0,1,-1,-0.99,-1,1,0,0.01,1,1.0,1,0.99,0.99,1.0,0,1
209,1.99,0.01,1,0.99,0.98,0.0,0.0,1.99,0.99,0.99,-0.01,0.99,0.99,0,0,1,1,0.01,1,1,0,0,0,-1,-0.99,0,0,-1,-0.99,0,0.994,1,0.99,0.99,0.994,0,0
210,1.01,0.99,1,0.01,0.0,0.24,0.25,1.01,24.01,25.01,-0.99,-23.99,-24.99,24,25,25,26,0.99,-23,-24,576,600,49,23,23.99,-1,625,24,24.99,1,48.792,1,0.01,0.01,24.792,24,25
211,1.99,0.01,4,3.96,3.92,0.0,0.0,3.98,1.98,1.98,-0.02,1.98,1.98,0,0,2,2,0.02,2,2,0,0,0,-2,-1.98,0,0,-2,-1.98,0,2.974,2,1.98,0.99,2.974,0,0
212,1.01,0.99,1,0.01,0.0,0.0,0.0,1.01,0.01,0.01,-0.99,0.01,0.01,0,0,1,1,0.99,1,1,0,0,0,-1,-0.01,0,0,-1,-0.01,0,0.014,1,0.01,0.01,0.014,0,0
213,1.01,0.99,169,1.69,0.02,0.0,0.0,13.13,0.13,0.13,-12.87,0.13,0.13,0,0,13,13,12.87,13,13,0,0,0,-13,-0.13,0,0,-13,-0.13,0,0.8026666666666666,13,0.13,0.01,0.8026666666666666,0,0
214,1.99,0.01,1,0.99,0.98,0.0,0.99,1.99,0.99,1.99,-0.01,0.99,-0.01,0,1,1,2,0.01,1,0,0,0,1,-1,-0.99,-1,1,0,0.01,1,1.0,1,0.99,0.99,1.0,0,1
215,1.01,0.99,4,0.04,0.0,0.0,0.0,2.02,0.02,0.02,-1.98,0.02,0.02,0,0,2,2,1.98,2,2,0,0,0,-2,-0.02,0,0,-2,-0.02,0,0.03133333333333333,2,0.02,0.01,0.03133333333333333,0,0
216,1.99,0.01,1,0.99,0.98,0.0,0.0,1.99,0.99,0.99,-0.01,0.99,0.99,0,0,1,1,0.01,1,1,0,0,0,-1,-0.99,0,0,-1,-0.99,0,0.9873333333333333,1,0.99,0.99,0.9873333333333333,0,0
217,1.01,0.99,169,1.69,0.02,0.0,0.0,13.13,0.13,0.13,-12.87,0.13,0.13,0,0,13,13,12.87,13,13,0,0,0,-13,-0.13,0,0,-13,-0.13,0,0.8473333333333334,13,0.13,0.01,0.8473333333333334,0,0
218,1.01,0.99,1,0.01,0.0,0.25,0.25,1.01,25.01,25.01,-0.99,-24.99,-24.99,25,25,26,26,0.99,-24,-24,625,625,50,24,24.99,0,625,24,24.99,0,49.696,1,0.01,0.01,24.695999999999998,25,25
219,1.99,0.01,4,3.96,3.92,0.0,0.0,3.98,1.98,1.98,-0.02,1.98,1.98,0,0,2,2,0.02,2,2,0,0,0,-2,-1.98,0,0,-2,-1.98,0,2.973333333333333,2,1.98,0.99,2.973333333333333,0,0
220,1.01,0.99,1,0.01,0.0,0.0,0.0,1.01,0.01,0.01,-0.99,0.01,0.01,0,0,1,1,0.99,1,1,0,0,0,-1,-0.01,0,0,-1,-0.01,0,0.009333333333333334,1,0.01,0.01,0.009333333333333334,0,0
221,1.74,0.26,169,125.9,93.8,0.0,0.0,22.68,9.68,9.68,-3.32,9.68,9.68,0,0,13,13,3.32,13,13,0,0,0,-13,-9.68,0,0,-13,-9.68,0,67.78666666666666,13,9.68,0.7449999844779577,67.78666666666666,0,0
222,1.99,0.01,625,618.75,612.56,618.75,321.75,49.75,49.75,37.75,-0.25,-0.25,11.75,625,325,50,38,0.25,0,12,625,325,38,0,0.25,12,169,-12,-11.75,-12,350.1653333333333,25,24.75,0.99,325.1653333333333,25,13
223,1.99,0.01,1,0.99,0.98,0.0,0.99,1.99,0.99,1.99,-0.01,0.99,-0.01,0,1,1,2,0.01,1,0,0,0,1,-1,-0.99,-1,1,0,0.01,1,1.0,1,0.99,0.99,1.0,0,1
224,1.99,0.01,625,618.75,612.56,0.0,618.75,49.75,24.75,49.75,-0.25,24.75,-0.25,0,625,25,50,0.25,25,0,0,0,25,-25,-24.75,-25,625,0,0.25,25,328.106,25,24.75,0.99,328.106,0,25
225,1.99,0.01,1,0.99,0.98,0.0,0.0,1.99,0.99,0.99,-0.01,0.99,0.99,0,0,1,1,0.01,1,1,0,0,0,-1,-0.99,0,0,-1,-0.99,0,0.9913333333333333,1,0.99,0.99,0.9913333333333333,0,0
226,1.99,0.01,144,142.56,141.13,297.0,297.0,23.88,36.88,36.88,-0.12,-13.12,-13.12,300,300,37,37,0.12,-13,-13,625,625,50,13,13.12,0,625,13,13.12,0,105.14733333333334,12,11.88,0.9899999993972133,80.14733333333334,25,25
227,1.99,0.01,4,3.96,3.92,0.0,0.0,3.98,1.98,1.98,-0.02,1.98,1.98,0,0,2,2,0.02,2,2,0,0,0,-2,-1.98,0,0,-2,-1.98,0,2.970666666666667,2,1.98,0.99,2.970666666666667,0,0
228,1.99,0.01,169,167.31,165.64,0.0,321.75,25.87,12.87,37.87,-0.13,12.87,-12.13,0,325,13,38,0.13,13,-12,0,0,25,-13,-12.87,-25,625,12,12.13,25,93.42933333333333,13,12.87,0.99,93.42933333333333,0,25
229,1.01,0.99,1,0.01,0.0,0.0,0.25,1.01,0.01,25.01,-0.99,0.01,-24.99,0,25,1,26,0.99,1,-24,0,0,25,-1,-0.01,-25,625,24,24.99,25,24.76,1,0.01,0.01,24.76,0,25
230,1.01,0.99,625,6.25,0.06,0.0,0.0,25.25,0.25,0.25,-24.75,0.25,0.25,0,0,25,25,24.75,25,25,0,0,0,-25,-0.25,0,0,-25,-0.25,0,3.514,25,0.25,0.01,3.514,0,0
231,1.99,0.01,625,618.75,612.56,618.75,0.0,49.75,49.75,24.75,-0.25,-0.25,24.75,625,0,50,25,0.25,0,25,625,0,25,0,0.25,25,0,-25,-24.75,-25,346.538,25,24.75,0.99,321.538,25,0
232,1.99,0.01,625,618.75,612.56,0.0,0.0,49.75,24.75,24.75,-0.25,24.75,24.75,0,0,25,25,0.25,25,25,0,0,0,-25,-24.75,0,0,-25,-24.75,0,322.034,25,24.75,0.99,322.034,0,0
233,1.01,0.99,169,1.69,0.02,3.25,3.25,13.13,25.13,25.13,-12.87,-24.87,-24.87,325,325,38,38,12.87,-12,-12,625,625,50,12,24.87,0,625,12,24.87,0,347.4153333333333,13,0.13,0.01,322.4153333333333,25,25
234,1.99,0.01,625,618.75,612.56,618.75,0.0,49.75,49.75,24.75,-0.25,-0.25,24.75,625,0,50,25,0.25,0,25,625,0,25,0,0.25,25,0,-25,-24.75,-25,346.692,25,24.75,0.99,321.692,25,0
235,1.01,0.99,625,6.25,0.06,0.0,6.25,25.25,0.25,25.25,-24.75,0.25,-24.75,0,625,25,50,24.75,25,0,0,0,25,-25,-0.25,-25,625,0,24.75,25,621.5613333333333,25,0.25,0.01,621.5613333333333,0,25
236,1.99,0.01,625,618.75,612.56,0.0,0.0,49.75,24.75,24.75,-0.25,24.75,24.75,0,0,25,25,0.25,25,25,0,0,0,-25,-24.75,0,0,-25,-24.75,0,321.77933333333334,25,24.75,0.99,321.77933333333334,0,0
237,1.99,0.01,625,618.75,612.56,618.75,618.75,49.75,49.75,49.75,-0.25,-0.25,-0.25,625,625,50,50,0.25,0,0,625,625,50,0,0.25,0,625,0,0.25,0,352.82,25,24.75,0.99,327.82,25,25
238,1.99,0.01,625,618.75,612.56,618.75,297.0,49.75,49.75,36.75,-0.25,-0.25,12.75,625,300,50,37,0.25,0,13,625,300,37,0,0.25,13,144,-13,-12.75,-13,349.552,25,24.75,0.99,324.552,25,12
239,1.99,0.01,625,618.75,612.56,0.0,618.75,49.75,24.75,49.75,-0.25,24.75,-0.25,0,625,25,50,0.25,25,0,0,0,25,-25,-24.75,-25,625,0,0.25,25,327.94466666666665,25,24.75,0.99,327.94466666666665,0,25
240,1.99,0.01,169,167.31,165.64,0.0,321.75,25.87,12.87,37.87,-0.13,12.87,-12.13,0,325,13,38,0.13,13,-12,0,0,25,-13,-12.87,-25,625,12,12.13,25,93.68733333333333,13,12.87,0.99,93.68733333333333,0,25
241,1.99,0.01,1,0.99,0.98,0.0,0.99,1.99,0.99,1.99,-0.01,0.99,-0.01,0,1,1,2,0.01,1,0,0,0,1,-1,-0.99,-1,1,0,0.01,1,1.0,1,0.99,0.99,1.0,0,1
242,1.99,0.01,1,0.99,0.98,0.0,0.0,1.99,0.99,0.99,-0.01,0.99,0.99,0,0,1,1,0.01,1,1,0,0,0,-1,-0.99,0,0,-1,-0.99,0,0.994,1,0.99,0.99,0.994,0,0
243,1.01,0.99,1,0.01,0.0,0.24,0.25,1.01,24.01,25.01,-0.99,-23.99,-24.99,24,25,25,26,0.99,-23,-24,576,600,49,23,23.99,-1,625,24,24.99,1,48.792,1,0.01,0.01,24.792,24,25
244,1.99,0.01,4,3.96,3.92,0.0,0.0,3.98,1.98,1.98,-0.02,1.98,1.98,0,0,2,2,0.02,2,2,0,0,0,-2,-1.98,0,0,-2,-1.98,0,2.974,2,1.98,0.99,2.974,0,0
245,1.01,0.99,1,0.01,0.0,0.0,0.0,1.01,0.01,0.01,-0.99,0.01,0.01,0,0,1,1,0.99,1,1,0,0,0,-1,-0.01,0,0,-1,-0.01,0,0.014,1,0.01,0.01,0.014,0,0
246,1.01,0.99,169,1.69,0.02,0.0,0.0,13.13,0.13,0.13,-12.87,0.13,0.13,0,0,13,13,12.87,13,13,0,0,0,-13,-0.13,0,0,-13,-0.13,0,0.8026666666666666,13,0.13,0.01,0.8026666666666666,0,0
247,1.99,0.01,1,0.99,0.98,0.0,0.99,1.99,0.99,1.99,-0.01,0.99,-0.01,0,1,1,2,0.01,1,0,0,0,1,-1,-0.99,-1,1,0,0.01,1,1.0,1,0.99,0.99,1.0,0,1
248,1.01,0.99,4,0.04,0.0,0.0,0.0,2.02,0.02,0.02,-1.98,0.02,0.02,0,0,2,2,1.98,2,2,0,0,0,-2,-0.02,0,0,-2,-0.02,0,0.03133333333333333,2,0.02,0.01,0.03133333333333333,0,0
249,1.99,0.01,1,0.99,0.98,0.0,0.0,1.99,0.99,0.99,-0.01,0.99,0.99,0,0,1,1,0.01,1,1,0,0,0,-1,-0.99,0,0,-1,-0.99,0,0.9873333333333333,1,0.99,0.99,0.9873333333333333,0,0
250,1.01,0.99,169,1.69,0.02,0.0,0.0,13.13,0.13,0.13,-12.87,0.13,0.13,0,0,13,13,12.87,13,13,0,0,0,-13,-0.13,0,0,-13,-0.13,0,0.8473333333333334,13,0.13,0.01,0.8473333333333334,0,0
251,1.01,0.99,1,0.01,0.0,0.25,0.25,1.01,25.01,25.01,-0.99,-24.99,-24.99,25,25,26,26,0.99,-24,-24,625,625,50,24,24.99,0,625,24,24.99,0,49.696,1,0.01,0.01,24.695999999999998,25,25
252,1.99,0.01,4,3.96,3.92,0.0,0.0,3.98,1.98,1.98,-0.02,1.98,1.98,0,0,2,2,0.02,2,2,0,0,0,-2,-1.98,0,0,-2,-1.98,0,2.973333333333333,2,1.98,0.99,2.973333333333333,0,0
253,1.01,0.99,1,0.01,0.0,0.0,0.0,1.01,0.01,0.01,-0.99,0.01,0.01,0,0,1,1,0.99,1,1,0,0,0,-1,-0.01,0,0,-1,-0.01,0,0.009333333333333334,1,0.01,0.01,0.009333333333333334,0,0
254,1.74,0.26,169,125.9,93.8,0.0,0.0,22.68,9.68,9.68,-3.32,9.68,9.68,0,0,13,13,3.32,13,13,0,0,0,-13,-9.68,0,0,-13,-9.68,0,67.78666666666666,13,9.68,0.7449999844779577,67.78666666666666,0,0
255,1.99,0.01,625,618.75,612.56,618.75,321.75,49.75,49.75,37.75,-0.25,-0.25,11.75,625,325,50,38,0.25,0,12,625,325,38,0,0.25,12,169,-12,-11.75,-12,350.1653333333333,25,24.75,0.99,325.1653333333333,25,13
256,1.99,0.01,1,0.99,0.98,0.0,0.99,1.99,0.99,1.99,-0.01,0.99,-0.01,0,1,1,2,0.01,1,0,0,0,1,-1,-0.99,-1,1,0,0.01,1,1.0,1,0.99,0.99,1.0,0,1
257,1.99,0.01,625,618.75,612.56,0.0,618.75,49.75,24.75,49.75,-0.25,24.75,-0.25,0,625,25,50,0.25,25,0,0,0,25,-25,-24.75,-25,625,0,0.25,25,328.106,25,24.75,0.99,328.106,0,25
258,1.99,0.01,1,0.99,0.98,0.0,0.0,1.99,0.99,0.99,-0.01,0.99,0.99,0,0,1,1,0.01,1,1,0,0,0,-1,-0.99,0,0,-1,-0.99,0,0.9913333333333333,1,0.99,0.99,0.9913333333333333,0,0
259,1.99,0.01,144,142.56,141.13,297.0,297.0,23.88,36.88,36.88,-0.12,-13.12,-13.12,300,300,37,37,0.12,-13,-13,625,625,50,13,13.12,0,625,13,13.12,0,105.14733333333334,12,11.88,0.9899999993972133,80.14733333333334,25,25
260,1.99,0.01,4,3.96,3.92,0.0,0.0,3.98,1.98,1.98,-0.02,1.98,1.98,0,0,2,2,0.02,2,2,0,0,0,-2,-1.98,0,0,-2,-1.98,0,2.970666666666667,2,1.98,0.99,2.970666666666667,0,0
261,1.99,0.01,169,167.31,165.64,0.0,321.75,25.87,12.87,37.87,-0.13,12.87,-12.13,0,325,13,38,0.13,13,-12,0,0,25,-13,-12.87,-25,625,12,12.13,25,93.42933333333333,13,12.87,0.99,93.42933333333333,0,25
262,1.01,0.99,1,0.01,0.0,0.0,0.25,1.01,0.01,25.01,-0.99,0.01,-24.99,0,25,1,26,0.99,1,-24,0,0,25,-1,-0.01,-25,625,24,24.99,25,24.76,1,0.01,0.01,24.76,0,25
263,1.01,0.99,625,6.25,0.06,0.0,0.0,25.25,0.25,0.25,-24.75,0.25,0.25,0,0,25,25,24.75,25,25,0,0,0,-25,-0.25,0,0,-25,-0.25,0,3.514,25,0.25,0.01,3.514,0,0
264,1.99,0.01,625,618.75,612.56,618.75,0.0,49.75,49.75,24.75,-0.25,-0.25,24.75,625,0,50,25,0.25,0,25,625,0,25,0,0.25,25,0,-25,-24.75,-25,346.538,25,24.75,0.99,321.538,25,0
265,1.99,0.01,625,618.75,612.56,0.0,0.0,49.75,24.75,24.75,-0.25,24.75,24.75,0,0,25,25,0.25,25,25,0,0,0,-25,-24.75,0,0,-25,-24.75,0,322.034,25,24.75,0.99,322.034,0,0
266,1.01,0.99,169,1.69,0.02,3.25,3.25,13.13,25.13,25.13,-12.87,-24.87,-24.87,325,325,38,38,12.87,-12,-12,625,625,50,12,24.87,0,625,12,24.87,0,347.4153333333333,13,0.13,0.01,322.4153333333333,25,25
267,1.99,0.01,625,618.75,612.56,618.75,0.0,49.75,49.75,24.75,-0.25,-0.25,24.75,625,0,50,25,0.25,0,25,625,0,25,0,0.25,25,0,-25,-24.75,-25,346.692,25,24.75,0.99,321.692,25,0
268,1.01,0.99,625,6.25,0.06,0.0,6.25,25.25,0.25,25.25,-24.75,0.25,-24.75,0,625,25,50,24.75,25,0,0,0,25,-25,-0.25,-25,625,0,24.75,25,621.5613333333333,25,0.25,0.01,621.5613333333333,0,25
269,1.99,0.01,625,618.75,612.56,0.0,0.0,49.75,24.75,24.75,-0.25,24.75,24.75,0,0,25,25,0.25,25,25,0,0,0,-25,-24.75,0,0,-25,-24.75,0,321.77933333333334,25,24.75,0.99,321.77933333333334,0,0
270,1.99,0.01,625,618.75,612.56,618.75,618.75,49.75,49.75,49.75,-0.25,-0.25,-0.25,625,625,50,50,0.25,0,0,625,625,50,0,0.25,0,625,0,0.25,0,352.82,25,24.75,0.99,327.82,25,25
271,1.99,0.01,625,618.75,612.56,618.75,297.0,49.75,49.75,36.75,-0.25,-0.25,12.75,625,300,50,37,0.25,0,13,625,300,37,0,0.25,13,144,-13,-12.75,-13,349.552,25,24.75,0.99,324.552,25,12
272,1.99,0.01,625,618.75,612.56,0.0,618.75,49.75,24.75,49.75,-0.25,24.75,-0.25,0,625,25,50,0.25,25,0,0,0,25,-25,-24.75,-25,625,0,0.25,25,327.94466666666665,25,24.75,0.99,327.94466666666665,0,25
273,1.99,0.01,169,167.31,165.64,0.0,321.75,25.87,12.87,37.87,-0.13,12.87,-12.13,0,325,13,38,0.13,13,-12,0,0,25,-13,-12.87,-25,625,12,12.13,25,93.68733333333333,13,12.87,0.99,93.68733333333333,0,25
274,1.99,0.01,1,0.99,0.98,0.0,0.99,1.99,0.99,1.99,-0.01,0.99,-0.01,0,1,1,2,0.01,1,0,0,0,1,-1,-0.99,-1,1,0,0.01,1,1.0,1,0.99,0.99,1.0,0,1
275,1.99,0.01,1,0.99,0.98,0.0,0.0,1.99,0.99,0.99,-0.01,0.99,0.99,0,0,1,1,0.01,1,1,0,0,0,-1,-0.99,0,0,-1,-0.99,0,0.994,1,0.99,0.99,0.994,0,0
276,1.01,0.99,1,0.01,0.0,0.24,0.25,1.01,24.01,25.01,-0.99,-23.99,-24.99,24,25,25,26,0.99,-23,-24,576,600,49,23,23.99,-1,625,24,24.99,1,48.792,1,0.01,0.01,24.792,24,25
277,1.99,0.01,4,3.96,3.92,0.0,0.0,3.98,1.98,1.98,-0.02,1.98,1.98,0,0,2,2,0.02,2,2,0,0,0,-2,-1.98,0,0,-2,-1.98,0,2.974,2,1.98,0.99,2.974,0,0
278,1.01,0.99,1,0.01,0.0,0.0,0.0,1.01,0.01,0.01,-0.99,0.01,0.01,0,0,1,1,0.99,1,1,0,0,0,-1,-0.01,0,0,-1,-0.01,0,0.014,1,0.01,0.01,0.014,0,0
279,1.01,0.99,169,1.69,0.02,0.0,0.0,13.13,0.13,0.13,-12.87,0.13,0.13,0,0,13,13,12.87,13,13,0,0,0,-13,-0.13,0,0,-13,-0.13,0,0.8026666666666666,13,0.13,0.01,0.8026666666666666,0,0
280,1.99,0.01,1,0.99,0.98,0.0,0.99,1.99,0.99,1.99,-0.01,0.99,-0.01,0,1,1,2,0.01,1,0,0,0,1,-1,-0.99,-1,1,0,0.01,1,1.0,1,0.99,0.99,1.0,0,1
281,1.01,0.99,4,0.04,0.0,0.0,0.0,2.02,0.02,0.02,-1.98,0.02,0.02,0,0,2,2,1.98,2,2,0,0,0,-2,-0.02,0,0,-2,-0.02,0,0.03133333333333333,2,0.02,0.01,0.03133333333333333,0,0
282,1.99,0.01,1,0.99,0.98,0.0,0.0,1.99,0.99,0.99,-0.01,0.99,0.99,0,0,1,1,0.01,1,1,0,0,0,-1,-0.99,0,0,-1,-0.99,0,0.9873333333333333,1,0.99,0.99,0.9873333333333333,0,0
283,1.01,0.99,169,1.69,0.02,0.0,0.0,13.13,0.13,0.13,-12.87,0.13,0.13,0,0,13,13,12.87,13,13,0,0,0,-13,-0.13,0,0,-13,-0.13,0,0.8473333333333334,13,0.13,0.01,0.8473333333333334,0,0
284,1.01,0.99,1,0.01,0.0,0.25,0.25,1.01,25.01,25.01,-0.99,-24.99,-24.99,25,25,26,26,0.99,-24,-24,625,625,50,24,24.99,0,625,24,24.99,0,49.696,1,0.01,0.01,24.695999999999998,25,25
285,1.99,0.01,4,3.96,3.92,0.0,0.0,3.98,1.98,1.98,-0.02,1.98,1.98,0,0,2,2,0.02,2,2,0,0,0,-2,-1.98,0,0,-2,-1.98,0,2.973333333333333,2,1.98,0.99,2.973333333333333,0,0
286,1.01,0.99,1,0.01,0.0,0.0,0.0,1.01,0.01,0.01,-0.99,0.01,0.01,0,0,1,1,0.99,1,1,0,0,0,-1,-0.01,0,0,-1,-0.01,0,0.009333333333333334,1,0.01,0.01,0.009333333333333334,0,0
287,1.74,0.26,169,125.9,93.8,0.0,0.0,22.68,9.68,9.68,-3.32,9.68,9.68,0,0,13,13,3.32,13,13,0,0,0,-13,-9.68,0,0,-13,-9.68,0,67.78666666666666,13,9.68,0.7449999844779577,67.78666666666666,0,0
288,1.99,0.01,625,618.75,612.56,618.75,321.75,49.75,49.75,37.75,-0.25,-0.25,11.75,625,325,50,38,0.25,0,12,625,325,38,0,0.25,12,169,-12,-11.75,-12,350.1653333333333,25,24.75,0.99,325.1653333333333,25,13
289,1.99,0.01,1,0.99,0.98,0.0,0.99,1.99,0.99,1.99,-0.01,0.99,-0.01,0,1,1,2,0.01,1,0,0,0,1,-1,-0.99,-1,1,0,0.01,1,1.0,1,0.99,0.99,1.0,0,1
290,1.99,0.01,625,618.75,612.56,0.0,618.75,49.75,24.75,49.75,-0.25,24.75,-0.25,0,625,25,50,0.25,25,0,0,0,25,-25,-24.75,-25,625,0,0.25,25,328.106,25,24.75,0.99,328.106,0,25
291,1.99,0.01,1,0.99,0.98,0.0,0.0,1.99,0.99,0.99,-0.01,0.99,0.99,0,0,1,1,0.01,1,1,0,0,0,-1,-0.99,0,0,-1,-0.99,0,0.9913333333333333,1,0.99,0.99,0.9913333333333333,0,0
292,1.99,0.01,144,142.56,141.13,297.0,297.0,23.88,36.88,36.88,-0.12,-13.12,-13.12,300,300,37,37,0.12,-13,-13,625,625,50,13,13.12,0,625,13,13.12,0,105.14733333333334,12,11.88,0.9899999993972133,80.14733333333334,25,25
293,1.99,0.01,4,3.96,3.92,0.0,0.0,3.98,1.98,1.98,-0.02,1.98,1.98,0,0,2,2,0.02,2,2,0,0,0,-2,-1.98,0,0,-2,-1.98,0,2.970666666666667,2,1.98,0.99,2.970666666666667,0,0
294,1.99,0.01,169,167.31,165.64,0.0,321.75,25.87,12.87,37.87,-0.13,12.87,-12.13,0,325,13,38,0.13,13,-12,0,0,25,-13,-12.87,-25,625,12,12.13,25,93.42933333333333,13,12.87,0.99,93.42933333333333,0,25
295,1.01,0.99,1,0.01,0.0,0.0,0.25,1.01,0.01,25.01,-0.99,0.01,-24.99,0,25,1,26,0.99,1,-24,0,0,25,-1,-0.01,-25,625,24,24.99,25,24.76,1,0.01,0.01,24.76,0,25
296,1.01,0.99,625,6.25,0.06,0.0,0.0,25.25,0.25,0.25,-24.75,0.25,0.25,0,0,25,25,24.75,25,25,0,0,0,-25,-0.25,0,0,-25,-0.25,0,3.514,25,0.25,0.01,3.514,0,0
297,1.99,0.01,625,618.75,612.56,618.75,0.0,49.75,49.75,24.75,-0.25,-0.25,24.75,625,0,50,25,0.25,0,25,625,0,25,0,0.25,25,0,-25,-24.75,-25,346.538,25,24.75,0.99,321.538,25,0
298,1.99,0.01,625,618.75,612.56,0.0,0.0,49.75,24.75,24.75,-0.25,24.75,24.75,0,0,25,25,0.25,25,25,0,0,0,-25,-24.75,0,0,-25,-24.75,0,322.034,25,24.75,0.99,322.034,0,0
299,1.01,0.99,169,1.69,0.02,3.25,3.25,13.13,25.13,25.13,-12.87,-24.87,-24.87,325,325,38,38,12.87,-12,-12,625,625,50,12,24.87,0,625,12,24.87,0,347.4153333333333,13,0.13,0.01,322.4153333333333,25,25
300,1.99,0.01,625,618.75,612.56,618.75,0.0,49.75,49.75,24.75,-0.25,-0.25,24.75,625,0,50,25,0.25,0,25,625,0,25,0,0.25,25,0,-25,-24.75,-25,346.692,25,24.75,0.99,321.692,25,0
301,1.01,0.99,625,6.25,0.06,0.0,6.25,25.25,0.25,25.25,-24.75,0.25,-24.75,0,625,25,50,24.75,25,0,0,0,25,-25,-0.25,-25,625,0,24.75,25,621.5613333333333,25,0.25,0.01,621.5613333333333,0,25
302,1.99,0.01,625,618.75,612.56,0.0,0.0,49.75,24.75,24.75,-0.25,24.75,24.75,0,0,25,25,0.25,25,25,0,0,0,-25,-24.75,0,0,-25,-24.75,0,321.77933333333334,25,24.75,0.99,321.77933333333334,0,0
303,1.99,0.01,625,618.75,612.56,618.75,618.75,49.75,49.75,49.75,-0.25,-0.25,-0.25,625,625,50,50,0.25,0,0,625,625,50,0,0.25,0,625,0,0.25,0,352.82,25,24.75,0.99,327.82,25,25
304,1.99,0.01,625,618.75,612.56,618.75,297.0,49.75,49.75,36.75,-0.25,-0.25,12.75,625,300,50,37,0.25,0,13,625,300,37,0,0.25,13,144,-13,-12.75,-13,349.552,25,24.75,0.99,324.552,25,12
305,1.99,0.01,625,618.75,612.56,0.0,618.75,49.75,24.75,49.75,-0.25,24.75,-0.25,0,625,25,50,0.25,25,0,0,0,25,-25,-24.75,-25,625,0,0.25,25,327.94466666666665,25,24.75,0.99,327.94466666666665,0,25
306,1.99,0.01,169,167.31,165.64,0.0,321.75,25.87,12.87,37.87,-0.13,12.87,-12.13,0,325,13,38,0.13,13,-12,0,0,25,-13,-12.87,-25,625,12,12.13,25,93.68733333333333,13,12.87,0.99,93.68733333333333,0,25
307,1.99,0.01,1,0.99,0.98,0.0,0.99,1.99,0.99,1.99,-0.01,0.99,-0.01,0,1,1,2,0.01,1,0,0,0,1,-1,-0.99,-1,1,0,0.01,1,1.0,1,0.99,0.99,1.0,0,1
308,1.99,0.01,1,0.99,0.98,0.0,0.0,1.99,0.99,0.99,-0.01,0.99,0.99,0,0,1,1,0.01,1,1,0,0,0,-1,-0.99,0,0,-1,-0.99,0,0.994,1,0.99,0.99,0.994,0,0
309,1.01,0.99,1,0.01,0.0,0.24,0.25,1.01,24.01,25.01,-0.99,-23.99,-24.99,24,25,25,26,0.99,-23,-24,576,600,49,23,23.99,-1,625,24,24.99,1,48.792,1,0.01,0.01,24.792,24,25
310,1.99,0.01,4,3.96,3.92,0.0,0.0,3.98,1.98,1.98,-0.02,1.98,1.98,0,0,2,2,0.02,2,2,0,0,0,-2,-1.98,0,0,-2,-1.98,0,2.974,2,1.98,0.99,2.974,0,0
311,1.01,0.99,1,0.01,0.0,0.0,0.0,1.01,0.01,0.01,-0.99,0.01,0.01,0,0,1,1,0.99,1,1,0,0,0,-1,-0.01,0,0,-1,-0.01,0,0.014,1,0.01,0.01,0.014,0,0
312,1.01,0.99,169,1.69,0.02,0.0,0.0,13.13,0.13,0.13,-12.87,0.13,0.13,0,0,13,13,12.87,13,13,0,0,0,-13,-0.13,0,0,-13,-0.13,0,0.8026666666666666,13,0.13,0.01,0.8026666666666666,0,0
313,1.99,0.01,1,0.99,0.98,0.0,0.99,1.99,0.99,1.99,-0.01,0.99,-0.01,0,1,1,2,0.01,1,0,0,0,1,-1,-0.99,-1,1,0,0.01,1,1.0,1,0.99,0.99,1.0,0,1
314,1.01,0.99,4,0.04,0.0,0.0,0.0,2.02,0.02,0.02,-1.98,0.02,0.02,0,0,2,2,1.98,2,2,0,0,0,-2,-0.02,0,0,-2,-0.02,0,0.03133333333333333,2,0.02,0.01,0.03133333333333333,0,0
315,1.99,0.01,1,0.99,0.98,0.0,0.0,1.99,0.99,0.99,-0.01,0.99,0.99,0,0,1,1,0.01,1,1,0,0,0,-1,-0.99,0,0,-1,-0.99,0,0.9873333333333333,1,0.99,0.99,0.9873333333333333,0,0
316,1.01,0.99,169,1.69,0.02,0.0,0.0,13.13,0.13,0.13,-12.87,0.13,0.13,0,0,13,13,12.87,13,13,0,0,0,-13,-0.13,0,0,-13,-0.13,0,0.8473333333333334,13,0.13,0.01,0.8473333333333334,0,0
317,1.01,0.99,1,0.01,0.0,0.25,0.25,1.01,25.01,25.01,-0.99,-24.99,-24.99,25,25,26,26,0.99,-24,-24,625,625,50,24,24.99,0,625,24,24.99,0,49.696,1,0.01,0.01,24.695999999999998,25,25
318,1.99,0.01,4,3.96,3.92,0.0,0.0,3.98,1.98,1.98,-0.02,1.98,1.98,0,0,2,2,0.02,2,2,0,0,0,-2,-1.98,0,0,-2,-1.98,0,2.973333333333333,2,1.98,0.99,2.973333333333333,0,0
319,1.01,0.99,1,0.01,0.0,0.0,0.0,1.01,0.01,0.01,-0.99,0.01,0.01,0,0,1,1,0.99,1,1,0,0,0,-1,-0.01,0,0,-1,-0.01,0,0.009333333333333334,1,0.01,0.01,0.009333333333333334,0,0
320,1.74,0.26,169,125.9,93.8,0.0,0.0,22.68,9.68,9.68,-3.32,9.68,9.68,0,0,13,13,3.32,13,13,0,0,0,-13,-9.68,0,0,-13,-9.68,0,67.78666666666666,13,9.68,0.7449999844779577,67.78666666666666,0,0
321,1.99,0.01,625,618.75,612.56,618.75,321.75,49.75,49.75,37.75,-0.25,-0.25,11.75,625,325,50,38,0.25,0,12,625,325,38,0,0.25,12,169,-12,-11.75,-12,350.1653333333333,25,24.75,0.99,325.1653333333333,25,13
322,1.99,0.01,1,0.99,0.98,0.0,0.99,1.99,0.99,1.99,-0.01,0.99,-0.01,0,1,1,2,0.01,1,0,0,0,1,-1,-0.99,-1,1,0,0.01,1,1.0,1,0.99,0.99,1.0,0,1
323,1.99,0.01,625,618.75,612.56,0.0,618.75,49.75,24.75,49.75,-0.25,24.75,-0.25,0,625,25,50,0.25,25,0,0,0,25,-25,-24.75,-25,625,0,0.25,25,328.106,25,24.75,0.99,328.106,0,25
324,1.99,0.01,1,0.99,0.98,0.0,0.0,1.99,0.99,0.99,-0.01,0.99,0.99,0,0,1,1,0.01,1,1,0,0,0,-1,-0.99,0,0,-1,-0.99,0,0.9913333333333333,1,0.99,0.99,0.9913333333333333,0,0
325,1.99,0.01,144,142.56,141.13,297.0,297.0,23.88,36.88,36.88,-0.12,-13.12,-13.12,300,300,37,37,0.12,-13,-13,625,625,50,13,13.12,0,625,13,13.12,0,105.14733333333334,12,11.88,0.9899999993972133,80.14733333333334,25,25
326,1.99,0.01,4,3.96,3.92,0.0,0.0,3.98,1.98,1.98,-0.02,1.98,1.98,0,0,2,2,0.02,2,2,0,0,0,-2,-1.98,0,0,-2,-1.98,0,2.970666666666667,2,1.98,0.99,2.970666666666667,0,0
327,1.99,0.01,169,167.31,165.64,0.0,321.75,25.87,12.87,37.87,-0.13,12.87,-12.13,0,325,13,38,0.13,13,-12,0,0,25,-13,-12.87,-25,625,12,12.13,25,93.42933333333333,13,12.87,0.99,93.42933333333333,0,25
328,1.01,0.99,1,0.01,0.0,0.0,0.25,1.01,0.01,25.01,-0.99,0.01,-24.99,0,25,1,26,0.99,1,-24,0,0,25,-1,-0.01,-25,625,24,24.99,25,24.76,1,0.01,0.01,24.76,0,25
329,1.01,0.99,625,6.25,0.06,0.0,0.0,25.25,0.25,0.25,-24.75,0.25,0.25,0,0,25,25,24.75,25,25,0,0,0,-25,-0.25,0,0,-25,-0.25,0,3.514,25,0.25,0.01,3.514,0,0
330,1.99,0.01,625,618.75,612.56,618.75,0.0,49.75,49.75,24.75,-0.25,-0.25,24.75,625,0,50,25,0.25,0,25,625,0,25,0,0.25,25,0,-25,-24.75,-25,346.538,25,24.75,0.99,321.538,25,0
331,1.99,0.01,625,618.75,612.56,0.0,0.0,49.75,24.75,24.75,-0.25,24.75,24.75,0,0,25,25,0.25,25,25,0,0,0,-25,-24.75,0,0,-25,-24.75,0,322.034,25,24.75,0.99,322.034,0,0
332,1.01,0.99,169,1.69,0.02,3.25,3.25,13.13,25.13,25.13,-12.87,-24.87,-24.87,325,325,38,38,12.87,-12,-12,625,625,50,12,24.87,0,625,12,24.87,0,347.4153333333333,13,0.13,0.01,322.4153333333333,25,25
333,1.99,0.01,625,618.75,612.56,618.75,0.0,49.75,49.75,24.75,-0.25,-0.25,24.75,625,0,50,25,0.25,0,25,625,0,25,0,0.25,25,0,-25,-24.75,-25,346.692,25,24.75,0.99,321.692,25,0
334,1.01,0.99,625,6.25,0.06,0.0,6.25,25.25,0.25,25.25,-24.75,0.25,-24.75,0,625,25,50,24.75,25,0,0,0,25,-25,-0.25,-25,625,0,24.75,25,621.5613333333333,25,0.25,0.01,621.5613333333333,0,25
335,1.99,0.01,625,618.75,612.56,0.0,0.0,49.75,24.75,24.75,-0.25,24.75,24.75,0,0,25,25,0.25,25,25,0,0,0,-25,-24.75,0,0,-25,-24.75,0,321.77933333333334,25,24.75,0.99,321.77933333333334,0,0
336,1.99,0.01,625,618.75,612.56,618.75,618.75,49.75,49.75,49.75,-0.25,-0.25,-0.25,625,625,50,50,0.25,0,0,625,625,50,0,0.25,0,625,0,0.25,0,352.82,25,24.75,0.99,327.82,25,25
337,1.99,0.01,625,618.75,612.56,618.75,297.0,49.75,49.75,36.75,-0.25,-0.25,12.75,625,300,50,37,0.25,0,13,625,300,37,0,0.25,13,144,-13,-12.75,-13,349.552,25,24.75,0.99,324.552,25,12
338,1.99,0.01,625,618.75,612.56,0.0,618.75,49.75,24.75,49.75,-0.25,24.75,-0.25,0,625,25,50,0.25,25,0,0,0,25,-25,-24.75,-25,625,0,0.25,25,327.94466666666665,25,24.75,0.99,327.94466666666665,0,25
339,1.99,0.01,169,167.31,165.64,0.0,321.75,25.87,12.87,37.87,-0.13,12.87,-12.13,0,325,13,38,0.13,13,-12,0,0,25,-13,-12.87,-25,625,12,12.13,25,93.68733333333333,13,12.87,0.99,93.68733333333333,0,25
340,1.99,0.01,1,0.99,0.98,0.0,0.99,1.99,0.99,1.99,-0.01,0.99,-0.01,0,1,1,2,0.01,1,0,0,0,1,-1,-0.99,-1,1,0,0.01,1,1.0,1,0.99,0.99,1.0,0,1
341,1.99,0.01,1,0.99,0.98,0.0,0.0,1.99,0.99,0.99,-0.01,0.99,0.99,0,0,1,1,0.01,1,1,0,0,0,-1,-0.99,0,0,-1,-0.99,0,0.994,1,0.99,0.99,0.994,0,0
342,1.01,0.99,1,0.01,0.0,0.24,0.25,1.01,24.01,25.01,-0.99,-23.99,-24.99,24,25,25,26,0.99,-23,-24,576,600,49,23,23.99,-1,625,24,24.99,1,48.792,1,0.01,0.01,24.792,24,25
343,1.99,0.01,4,3.96,3.92,0.0,0.0,3.98,1.98,1.98,-0.02,1.98,1.98,0,0,2,2,0.02,2,2,0,0,0,-2,-1.98,0,0,-2,-1.98,0,2.974,2,1.98,0.99,2.974,0,0
344,1.01,0.99,1,0.01,0.0,0.0,0.0,1.01,0.01,0.01,-0.99,0.01,0.01,0,0,1,1,0.99,1,1,0,0,0,-1,-0.01,0,0,-1,-0.01,0,0.014,1,0.01,0.01,0.014,0,0
345,1.01,0.99,169,1.69,0.02,0.0,0.0,13.13,0.13,0.13,-12.87,0.13,0.13,0,0,13,13,12.87,13,13,0,0,0,-13,-0.13,0,0,-13,-0.13,0,0.8026666666666666,13,0.13,0.01,0.8026666666666666,0,0
346,1.99,0.01,1,0.99,0.98,0.0,0.99,1.99,0.99,1.99,-0.01,0.99,-0.01,0,1,1,2,0.01,1,0,0,0,1,-1,-0.99,-1,1,0,0.01,1,1.0,1,0.99,0.99,1.0,0,1
347,1.01,0.99,4,0.04,0.0,0.0,0.0,2.02,0.02,0.02,-1.98,0.02,0.02,0,0,2,2,1.98,2,2,0,0,0,-2,-0.02,0,0,-2,-0.02,0,0.03133333333333333,2,0.02,0.01,0.03133333333333333,0,0
348,1.99,0.01,1,0.99,0.98,0.0,0.0,1.99,0.99,0.99,-0.01,0.99,0.99,0,0,1,1,0.01,1,1,0,0,0,-1,-0.99,0,0,-1,-0.99,0,0.9873333333333333,1,0.99,0.99,0.9873333333333333,0,0
349,1.01,0.99,169,1.69,0.02,0.0,0.0,13.13,0.13,0.13,-12.87,0.13,0.13,0,0,13,13,12.87,13,13,0,0,0,-13,-0.13,0,0,-13,-0.13,0,0.8473333333333334,13,0.13,0.01,0.8473333333333334,0,0
350,1.01,0.99,1,0.01,0.0,0.25,0.25,1.01,25.01,25.01,-0.99,-24.99,-24.99,25,25,26,26,0.99,-24,-24,625,625,50,24,24.99,0,625,24,24.99,0,49.696,1,0.01,0.01,24.695999999999998,25,25
351,1.99,0.01,4,3.96,3.92,0.0,0.0,3.98,1.98,1.98,-0.02,1.98,1.98,0,0,2,2,0.02,2,2,0,0,0,-2,-1.98,0,0,-2,-1.98,0,2.973333333333333,2,1.98,0.99,2.973333333333333,0,0
352,1.01,0.99,1,0.01,0.0,0.0,0.0,1.01,0.01,0.01,-0.99,0.01,0.01,0,0,1,1,0.99,1,1,0,0,0,-1,-0.01,0,0,-1,-0.01,0,0.009333333333333334,1,0.01,0.01,0.009333333333333334,0,0
353,1.74,0.26,169,125.9,93.8,0.0,0.0,22.68,9.68,9.68,-3.32,9.68,9.68,0,0,13,13,3.32,13,13,0,0,0,-13,-9.68,0,0,-13,-9.68,0,67.78666666666666,13,9.68,0.7449999844779577,67.78666666666666,0,0
354,1.99,0.01,625,618.75,612.56,618.75,321.75,49.75,49.75,37.75,-0.25,-0.25,11.75,625,325,50,38,0.25,0,12,625,325,38,0,0.25,12,169,-12,-11.75,-12,350.1653333333333,25,24.75,0.99,325.1653333333333,25,13
355,1.99,0.01,1,0.99,0.98,0.0,0.99,1.99,0.99,1.99,-0.01,0.99,-0.01,0,1,1,2,0.01,1,0,0,0,1,-1,-0.99,-1,1,0,0.01,1,1.0,1,0.99,0.99,1.0,0,1
356,1.99,0.01,625,618.75,612.56,0.0,618.75,49.75,24.75,49.75,-0.25,24.75,-0.25,0,625,25,50,0.25,25,0,0,0,25,-25,-24.75,-25,625,0,0.25,25,328.106,25,24.75,0.99,328.106,0,25
357,1.99,0.01,1,0.99,0.98,0.0,0.0,1.99,0.99,0.99,-0.01,0.99,0.99,0,0,1,1,0.01,1,1,0,0,0,-1,-0.99,0,0,-1,-0.99,0,0.9913333333333333,1,0.99,0.99,0.9913333333333333,0,0
358,1.99,0.01,144,142.56,141.13,297.0,297.0,23.88,36.88,36.88,-0.12,-13.12,-13.12,300,300,37,37,0.12,-13,-13,625,625,50,13,13.12,0,625,13,13.12,0,105.14733333333334,12,11.88,0.9899999993972133,80.14733333333334,25,25
359,1.99,0.01,4,3.96,3.92,0.0,0.0,3.98,1.98,1.98,-0.02,1.98,1.98,0,0,2,2,0.02,2,2,0,0,0,-2,-1.98,0,0,-2,-1.98,0,2.970666666666667,2,1.98,0.99,2.970666666666667,0,0
360,1.99,0.01,169,167.31,165.64,0.0,321.75,25.87,12.87,37.87,-0.13,12.87,-12.13,0,325,13,38,0.13,13,-12,0,0,25,-13,-12.87,-25,625,12,12.13,25,93.42933333333333,13,12.87,0.99,93.42933333333333,0,25
361,1.01,0.99,1,0.01,0.0,0.0,0.25,1.01,0.01,25.01,-0.99,0.01,-24.99,0,25,1,26,0.99,1,-24,0,0,25,-1,-0.01,-25,625,24,24.99,25,24.76,1,0.01,0.01,24.76,0,25
362,1.01,0.99,625,6.25,0.06,0.0,0.0,25.25,0.25,0.25,-24.75,0.25,0.25,0,0,25,25,24.75,25,25,0,0,0,-25,-0.25,0,0,-25,-0.25,0,3.514,25,0.25,0.01,3.514,0,0
363,1.99,0.01,625,618.75,612.56,618.75,0.0,49.75,49.75,24.75,-0.25,-0.25,24.75,625,0,50,25,0.25,0,25,625,0,25,0,0.25,25,0,-25,-24.75,-25,346.538,25,24.75,0.99,321.538,25,0
364,1.99,0.01,625,618.75,612.56,0.0,0.0,49.75,24.75,24.75,-0.25,24.75,24.75,0,0,25,25,0.25,25,25,0,0,0,-25,-24.75,0,0,-25,-24.75,0,322.034,25,24.75,0.99,322.034,0,0
365,1.01,0.99,169,1.69,0.02,3.25,3.25,13.13,25.13,25.13,-12.87,-24.87,-24.87,325,325,38,38,12.87,-12,-12,625,625,50,12,24.87,0,625,12,24.87,0,347.4153333333333,13,0.13,0.01,322.4153333333333,25,25
366,1.99,0.01,625,618.75,612.56,618.75,0.0,49.75,49.75,24.75,-0.25,-0.25,24.75,625,0,50,25,0.25,0,25,625,0,25,0,0.25,25,0,-25,-24.75,-25,346.692,25,24.75,0.99,321.692,25,0
367,1.01,0.99,625,6.25,0.06,0.0,6.25,25.25,0.25,25.25,-24.75,0.25,-24.75,0,625,25,50,24.75,25,0,0,0,25,-25,-0.25,-25,625,0,24.75,25,621.5613333333333,25,0.25,0.01,621.5613333333333,0,25
368,1.99,0.01,625,618.75,612.56,0.0,0.0,49.75,24.75,24.75,-0.25,24.75,24.75,0,0,25,25,0.25,25,25,0,0,0,-25,-24.75,0,0,-25,-24.75,0,321.77933333333334,25,24.75,0.99,321.77933333333334,0,0
369,1.99,0.01,625,618.75,612.56,618.75,618.75,49.75,49.75,49.75,-0.25,-0.25,-0.25,625,625,50,50,0.25,0,0,625,625,50,0,0.25,0,625,0,0.25,0,352.82,25,24.75,0.99,327.82,25,25
370,1.99,0.01,625,618.75,612.56,618.75,297.0,49.75,49.75,36.75,-0.25,-0.25,12.75,625,300,50,37,0.25,0,13,625,300,37,0,0.25,13,144,-13,-12.75,-13,349.552,25,24.75,0.99,324.552,25,12
371,1.99,0.01,625,618.75,612.56,0.0,618.75,49.75,24.75,49.75,-0.25,24.75,-0.25,0,625,25,50,0.25,25,0,0,0,25,-25,-24.75,-25,625,0,0.25,25,327.94466666666665,25,24.75,0.99,327.94466666666665,0,25
372,1.99,0.01,169,167.31,165.64,0.0,321.75,25.87,12.87,37.87,-0.13,12.87,-12.13,0,325,13,38,0.13,13,-12,0,0,25,-13,-12.87,-25,625,12,12.13,25,93.68733333333333,13,12.87,0.99,93.68733333333333,0,25
373,1.99,0.01,1,0.99,0.98,0.0,0.99,1.99,0.99,1.99,-0.01,0.99,-0.01,0,1,1,2,0.01,1,0,0,0,1,-1,-0.99,-1,1,0,0.01,1,1.0,1,0.99,0.99,1.0,0,1
374,1.99,0.01,1,0.99,0.98,0.0,0.0,1.99,0.99,0.99,-0.01,0.99,0.99,0,0,1,1,0.01,1,1,0,0,0,-1,-0.99,0,0,-1,-0.99,0,0.994,1,0.99,0.99,0.994,0,0
375,1.01,0.99,1,0.01,0.0,0.24,0.25,1.01,24.01,25.01,-0.99,-23.99,-24.99,24,25,25,26,0.99,-23,-24,576,600,49,23,23.99,-1,625,24,24.99,1,48.792,1,0.01,0.01,24.792,24,25
376,1.99,0.01,4,3.96,3.92,0.0,0.0,3.98,1.98,1.98,-0.02,1.98,1.98,0,0,2,2,0.02,2,2,0,0,0,-2,-1.98,0,0,-2,-1.98,0,2.974,2,1.98,0.99,2.974,0,0
377,1.01,0.99,1,0.01,0.0,0.0,0.0,1.01,0.01,0.01,-0.99,0.01,0.01,0,0,1,1,0.99,1,1,0,0,0,-1,-0.01,0,0,-1,-0.01,0,0.014,1,0.01,0.01,0.014,0,0
378,1.01,0.99,169,1.69,0.02,0.0,0.0,13.13,0.13,0.13,-12.87,0.13,0.13,0,0,13,13,12.87,13,13,0,0,0,-13,-0.13,0,0,-13,-0.13,0,0.8026666666666666,13,0.13,0.01,0.8026666666666666,0,0
379,1.99,0.01,1,0.99,0.98,0.0,0.99,1.99,0.99,1.99,-0.01,0.99,-0.01,0,1,1,2,0.01,1,0,0,0,1,-1,-0.99,-1,1,0,0.01,1,1.0,1,0.99,0.99,1.0,0,1
380,1.01,0.99,4,0.04,0.0,0.0,0.0,2.02,0.02,0.02,-1.98,0.02,0.02,0,0,2,2,1.98,2,2,0,0,0,-2,-0.02,0,0,-2,-0.02,0,0.03133333333333333,2,0.02,0.01,0.03133333333333333,0,0
381,1.99,0.01,1,0.99,0.98,0.0,0.0,1.99,0.99,0.99,-0.01,0.99,0.99,0,0,1,1,0.01,1,1,0,0,0,-1,-0.99,0,0,-1,-0.99,0,0.9873333333333333,1,0.99,0.99,0.9873333333333333,0,0
382,1.01,0.99,169,1.69,0.02,0.0,0.0,13.13,0.13,0.13,-12.87,0.13,0.13,0,0,13,13,12.87,13,13,0,0,0,-13,-0.13,0,0,-13,-0.13,0,0.8473333333333334,13,0.13,0.01,0.8473333333333334,0,0
383,1.01,0.99,1,0.01,0.0,0.25,0.25,1.01,25.01,25.01,-0.99,-24.99,-24.99,25,25,26,26,0.99,-24,-24,625,625,50,24,24.99,0,625,24,24.99,0,49.696,1,0.01,0.01,24.695999999999998,25,25
384,1.99,0.01,4,3.96,3.92,0.0,0.0,3.98,1.98,1.98,-0.02,1.98,1.98,0,0,2,2,0.02,2,2,0,0,0,-2,-1.98,0,0,-2,-1.98,0,2.973333333333333,2,1.98,0.99,2.973333333333333,0,0
385,1.01,0.99,1,0.01,0.0,0.0,0.0,1.01,0.01,0.01,-0.99,0.01,0.01,0,0,1,1,0.99,1,1,0,0,0,-1,-0.01,0,0,-1,-0.01,0,0.009333333333333334,1,0.01,0.01,0.009333333333333334,0,0
386,1.74,0.26,169,125.9,93.8,0.0,0.0,22.68,9.68,9.68,-3.32,9.68,9.68,0,0,13,13,3.32,13,13,0,0,0,-13,-9.68,0,0,-13,-9.68,0,67.78666666666666,13,9.68,0.7449999844779577,67.78666666666666,0,0
387,1.99,0.01,625,618.75,612.56,618.75,321.75,49.75,49.75,37.75,-0.25,-0.25,11.75,625,325,50,38,0.25,0,12,625,325,38,0,0.25,12,169,-12,-11.75,-12,350.1653333333333,25,24.75,0.99,325.1653333333333,25,13
388,1.99,0.01,1,0.99,0.98,0.0,0.99,1.99,0.99,1.99,-0.01,0.99,-0.01,0,1,1,2,0.01,1,0,0,0,1,-1,-0.99,-1,1,0,0.01,1,1.0,1,0.99,0.99,1.0,0,1
389,1.99,0.01,625,618.75,612.56,0.0,618.75,49.75,24.75,49.75,-0.25,24.75,-0.25,0,625,25,50,0.25,25,0,0,0,25,-25,-24.75,-25,625,0,0.25,25,328.106,25,24.75,0.99,328.106,0,25
390,1.99,0.01,1,0.99,0.98,0.0,0.0,1.99,0.99,0.99,-0.01,0.99,0.99,0,0,1,1,0.01,1,1,0,0,0,-1,-0.99,0,0,-1,-0.99,0,0.9913333333333333,1,0.99,0.99,0.9913333333333333,0,0
391,1.99,0.01,144,142.56,141.13,297.0,297.0,23.88,36.88,36.88,-0.12,-13.12,-13.12,300,300,37,37,0.12,-13,-13,625,625,50,13,13.12,0,625,13,13.12,0,105.14733333333334,12,11.88,0.9899999993972133,80.14733333333334,25,25
392,1.99,0.01,4,3.96,3.92,0.0,0.0,3.98,1.98,1.98,-0.02,1.98,1.98,0,0,2,2,0.02,2,2,0,0,0,-2,-1.98,0,0,-2,-1.98,0,2.970666666666667,2,1.98,0.99,2.970666666666667,0,0
393,1.99,0.01,169,167.31,165.64,0.0,321.75,25.87,12.87,37.87,-0.13,12.87,-12.13,0,325,13,38,0.13,13,-12,0,0,25,-13,-12.87,-25,625,12,12.13,25,93.42933333333333,13,12.87,0.99,93.42933333333333,0,25
394,1.01,0.99,1,0.01,0.0,0.0,0.25,1.01,0.01,25.01,-0.99,0.01,-24.99,0,25,1,26,0.99,1,-24,0,0,25,-1,-0.01,-25,625,24,24.99,25,24.76,1,0.01,0.01,24.76,0,25
395,1.01,0.99,625,6.25,0.06,0.0,0.0,25.25,0.25,0.25,-24.75,0.25,0.25,0,0,25,25,24.75,25,25,0,0,0,-25,-0.25,0,0,-25,-0.25,0,3.514,25,0.25,0.01,3.514,0,0
396,1.99,0.01,625,618.75,612.56,618.75,0.0,49.75,49.75,24.75,-0.25,-0.25,24.75,625,0,50,25,0.25,0,25,625,0,25,0,0.25,25,0,-25,-24.75,-25,346.538,25,24.75,0.99,321.538,25,0
397,1.99,0.01,625,618.75,612.56,0.0,0.0,49.75,24.75,24.75,-0.25,24.75,24.75,0,0,25,25,0.25,25,25,0,0,0,-25,-24.75,0,0,-25,-24.75,0,322.034,25,24.75,0.99,322.034,0,0
398,1.01,0.99,169,1.69,0.02,3.25,3.25,13.13,25.13,25.13,-12.87,-24.87,-24.87,325,325,38,38,12.87,-12,-12,625,625,50,12,24.87,0,625,12,24.87,0,347.4153333333333,13,0.13,0.01,322.4153333333333,25,25
399,1.99,0.01,625,618.75,612.56,618.75,0.0,49.75,49.75,24.75,-0.25,-0.25,24.75,625,0,50,25,0.25,0,25,625,0,25,0,0.25,25,0,-25,-24.75,-25,346.692,25,24.75,0.99,321.692,25,0
400,1.01,0.99,625,6.25,0.06,0.0,6.25,25.25,0.25,25.25,-24.75,0.25,-24.75,0,625,25,50,24.75,25,0,0,0,25,-25,-0.25,-25,625,0,24.75,25,621.5613333333333,25,0.25,0.01,621.5613333333333,0,25
401,1.99,0.01,625,618.75,612.56,0.0,0.0,49.75,24.75,24.75,-0.25,24.75,24.75,0,0,25,25,0.25,25,25,0,0,0,-25,-24.75,0,0,-25,-24.75,0,321.77933333333334,25,24.75,0.99,321.77933333333334,0,0
402,1.99,0.01,625,618.75,612.56,618.75,618.75,49.75,49.75,49.75,-0.25,-0.25,-0.25,625,625,50,50,0.25,0,0,625,625,50,0,0.25,0,625,0,0.25,0,352.82,25,24.75,0.99,327.82,25,25
403,1.99,0.01,625,618.75,612.56,618.75,297.0,49.75,49.75,36.75,-0.25,-0.25,12.75,625,300,50,37,0.25,0,13,625,300,37,0,0.25,13,144,-13,-12.75,-13,349.552,25,24.75,0.99,324.552,25,12
404,1.99,0.01,625,618.75,612.56,0.0,618.75,49.75,24.75,49.75,-0.25,24.75,-0.25,0,625,25,50,0.25,25,0,0,0,25,-25,-24.75,-25,625,0,0.25,25,327.94466666666665,25,24.75,0.99,327.94466666666665,0,25
405,1.99,0.01,169,167.31,165.64,0.0,321.75,25.87,12.87,37.87,-0.13,12.87,-12.13,0,325,13,38,0.13,13,-12,0,0,25,-13,-12.87,-25,625,12,12.13,25,93.68733333333333,13,12.87,0.99,93.68733333333333,0,25
406,1.99,0.01,1,0.99,0.98,0.0,0.99,1.99,0.99,1.99,-0.01,0.99,-0.01,0,1,1,2,0.01,1,0,0,0,1,-1,-0.99,-1,1,0,0.01,1,1.0,1,0.99,0.99,1.0,0,1
407,1.99,0.01,1,0.99,0.98,0.0,0.0,1.99,0.99,0.99,-0.01,0.99,0.99,0,0,1,1,0.01,1,1,0,0,0,-1,-0.99,0,0,-1,-0.99,0,0.994,1,0.99,0.99,0.994,0,0
408,1.01,0.99,1,0.01,0.0,0.24,0.25,1.01,24.01,25.01,-0.99,-23.99,-24.99,24,25,25,26,0.99,-23,-24,576,600,49,23,23.99,-1,625,24,24.99,1,48.792,1,0.01,0.01,24.792,24,25
409,1.99,0.01,4,3.96,3.92,0.0,0.0,3.98,1.98,1.98,-0.02,1.98,1.98,0,0,2,2,0.02,2,2,0,0,0,-2,-1.98,0,0,-2,-1.98,0,2.974,2,1.98,0.99,2.974,0,0
410,1.01,0.99,1,0.01,0.0,0.0,0.0,1.01,0.01,0.01,-0.99,0.01,0.01,0,0,1,1,0.99,1,1,0,0,0,-1,-0.01,0,0,-1,-0.01,0,0.014,1,0.01,0.01,0.014,0,0
411,1.01,0.99,169,1.69,0.02,0.0,0.0,13.13,0.13,0.13,-12.87,0.13,0.13,0,0,13,13,12.87,13,13,0,0,0,-13,-0.13,0,0,-13,-0.13,0,0.8026666666666666,13,0.13,0.01,0.8026666666666666,0,0
412,1.99,0.01,1,0.99,0.98,0.0,0.99,1.99,0.99,1.99,-0.01,0.99,-0.01,0,1,1,2,0.01,1,0,0,0,1,-1,-0.99,-1,1,0,0.01,1,1.0,1,0.99,0.99,1.0,0,1
413,1.01,0.99,4,0.04,0.0,0.0,0.0,2.02,0.02,0.02,-1.98,0.02,0.02,0,0,2,2,1.98,2,2,0,0,0,-2,-0.02,0,0,-2,-0.02,0,0.03133333333333333,2,0.02,0.01,0.03133333333333333,0,0
414,1.99,0.01,1,0.99,0.98,0.0,0.0,1.99,0.99,0.99,-0.01,0.99,0.99,0,0,1,1,0.01,1,1,0,0,0,-1,-0.99,0,0,-1,-0.99,0,0.9873333333333333,1,0.99,0.99,0.9873333333333333,0,0
415,1.01,0.99,169,1.69,0.02,0.0,0.0,13.13,0.13,0.13,-12.87,0.13,0.13,0,0,13,13,12.87,13,13,0,0,0,-13,-0.13,0,0,-13,-0.13,0,0.8473333333333334,13,0.13,0.01,0.8473333333333334,0,0
416,1.01,0.99,1,0.01,0.0,0.25,0.25,1.01,25.01,25.01,-0.99,-24.99,-24.99,25,25,26,26,0.99,-24,-24,625,625,50,24,24.99,0,625,24,24.99,0,49.696,1,0.01,0.01,24.695999999999998,25,25
417,1.99,0.01,4,3.96,3.92,0.0,0.0,3.98,1.98,1.98,-0.02,1.98,1.98,0,0,2,2,0.02,2,2,0,0,0,-2,-1.98,0,0,-2,-1.98,0,2.973333333333333,2,1.98,0.99,2.973333333333333,0,0
418,1.01,0.99,1,0.01,0.0,0.0,0.0,1.01,0.01,0.01,-0.99,0.01,0.01,0,0,1,1,0.99,1,1,0,0,0,-1,-0.01,0,0,-1,-0.01,0,0.009333333333333334,1,0.01,0.01,0.009333333333333334,0,0
419,1.74,0.26,169,125.9,93.8,0.0,0.0,22.68,9.68,9.68,-3.32,9.68,9.68,0,0,13,13,3.32,13,13,0,0,0,-13,-9.68,0,0,-13,-9.68,0,67.78666666666666,13,9.68,0.7449999844779577,67.78666666666666,0,0
420,1.99,0.01,625,618.75,612.56,618.75,321.75,49.75,49.75,37.75,-0.25,-0.25,11.75,625,325,50,38,0.25,0,12,625,325,38,0,0.25,12,169,-12,-11.75,-12,350.1653333333333,25,24.75,0.99,325.1653333333333,25,13
421,1.99,0.01,1,0.99,0.98,0.0,0.99,1.99,0.99,1.99,-0.01,0.99,-0.01,0,1,1,2,0.01,1,0,0,0,1,-1,-0.99,-1,1,0,0.01,1,1.0,1,0.99,0.99,1.0,0,1
422,1.99,0.01,625,618.75,612.56,0.0,618.75,49.75,24.75,49.75,-0.25,24.75,-0.25,0,625,25,50,0.25,25,0,0,0,25,-25,-24.75,-25,625,0,0.25,25,328.106,25,24.75,0.99,328.106,0,25
423,1.99,0.01,1,0.99,0.98,0.0,0.0,1.99,0.99,0.99,-0.01,0.99,0.99,0,0,1,1,0.01,1,1,0,0,0,-1,-0.99,0,0,-1,-0.99,0,0.9913333333333333,1,0.99,0.99,0.9913333333333333,0,0
424,1.99,0.01,144,142.56,141.13,297.0,297.0,23.88,36.88,36.88,-0.12,-13.12,-13.12,300,300,37,37,0.12,-13,-13,625,625,50,13,13.12,0,625,13,13.12,0,105.14733333333334,12,11.88,0.9899999993972133,80.14733333333334,25,25
425,1.99,0.01,4,3.96,3.92,0.0,0.0,3.98,1.98,1.98,-0.02,1.98,1.98,0,0,2,2,0.02,2,2,0,0,0,-2,-1.98,0,0,-2,-1.98,0,2.970666666666667,2,1.98,0.99,2.970666666666667,0,0
426,1.99,0.01,169,167.31,165.64,0.0,321.75,25.87,12.87,37.87,-0.13,12.87,-12.13,0,325,13,38,0.13,13,-12,0,0,25,-13,-12.87,-25,625,12,12.13,25,93.42933333333333,13,12.87,0.99,93.42933333333333,0,25
427,1.01,0.99,1,0.01,0.0,0.0,0.25,1.01,0.01,25.01,-0.99,0.01,-24.99,0,25,1,26,0.99,1,-24,0,0,25,-1,-0.01,-25,625,24,24.99,25,24.76,1,0.01,0.01,24.76,0,25
428,1.01,0.99,625,6.25,0.06,0.0,0.0,25.25,0.25,0.25,-24.75,0.25,0.25,0,0,25,25,24.75,25,25,0,0,0,-25,-0.25,0,0,-25,-0.25,0,3.514,25,0.25,0.01,3.514,0,0
429,1.99,0.01,625,618.75,612.56,618.75,0.0,49.75,49.75,24.75,-0.25,-0.25,24.75,625,0,50,25,0.25,0,25,625,0,25,0,0.25,25,0,-25,-24.75,-25,346.538,25,24.75,0.99,321.538,25,0
430,1.99,0.01,625,618.75,612.56,0.0,0.0,49.75,24.75,24.75,-0.25,24.75,24.75,0,0,25,25,0.25,25,25,0,0,0,-25,-24.75,0,0,-25,-24.75,0,322.034,25,24.75,0.99,322.034,0,0
431,1.01,0.99,169,1.69,0.02,3.25,3.25,13.13,25.13,25.13,-12.87,-24.87,-24.87,325,325,38,38,12.87,-12,-12,625,625,50,12,24.87,0,625,12,24.87,0,347.4153333333333,13,0.13,0.01,322.4153333333333,25,25
432,1.99,0.01,625,618.75,612.56,618.75,0.0,49.75,49.75,24.75,-0.25,-0.25,24.75,625,0,50,25,0.25,0,25,625,0,25,0,0.25,25,0,-25,-24.75,-25,346.692,25,24.75,0.99,321.692,25,0
433,1.01,0.99,625,6.25,0.06,0.0,6.25,25.25,0.25,25.25,-24.75,0.25,-24.75,0,625,25,50,24.75,25,0,0,0,25,-25,-0.25,-25,625,0,24.75,25,621.5613333333333,25,0.25,0.01,621.5613333333333,0,25
434,1.99,0.01,625,618.75,612.56,0.0,0.0,49.75,24.75,24.75,-0.25,24.75,24.75,0,0,25,25,0.25,25,25,0,0,0,-25,-24.75,0,0,-25,-24.75,0,321.77933333333334,25,24.75,0.99,321.77933333333334,0,0
435,1.99,0.01,625,618.75,612.56,618.75,618.75,49.75,49.75,49.75,-0.25,-0.25,-0.25,625,625,50,50,0.25,0,0,625,625,50,0,0.25,0,625,0,0.25,0,352.82,25,24.75,0.99,327.82,25,25
436,1.99,0.01,625,618.75,612.56,618.75,297.0,49.75,49.75,36.75,-0.25,-0.25,12.75,625,300,50,37,0.25,0,13,625,300,37,0,0.25,13,144,-13,-12.75,-13,349.552,25,24.75,0.99,324.552,25,12
437,1.99,0.01,625,618.75,612.56,0.0,618.75,49.75,24.75,49.75,-0.25,24.75,-0.25,0,625,25,50,0.25,25,0,0,0,25,-25,-24.75,-25,625,0,0.25,25,327.94466666666665,25,24.75,0.99,327.94466666666665,0,25
438,1.99,0.01,169,167.31,165.64,0.0,321.75,25.87,12.87,37.87,-0.13,12.87,-12.13,0,325,13,38,0.13,13,-12,0,0,25,-13,-12.87,-25,625,12,12.13,25,93.68733333333333,13,12.87,0.99,93.68733333333333,0,25
439,1.99,0.01,1,0.99,0.98,0.0,0.99,1.99,0.99,1.99,-0.01,0.99,-0.01,0,1,1,2,0.01,1,0,0,0,1,-1,-0.99,-1,1,0,0.01,1,1.0,1,0.99,0.99,1.0,0,1
440,1.99,0.01,1,0.99,0.98,0.0,0.0,1.99,0.99,0.99,-0.01,0.99,0.99,0,0,1,1,0.01,1,1,0,0,0,-1,-0.99,0,0,-1,-0.99,0,0.994,1,0.99,0.99,0.994,0,0
441,1.01,0.99,1,0.01,0.0,0.24,0.25,1.01,24.01,25.01,-0.99,-23.99,-24.99,24,25,25,26,0.99,-23,-24,576,600,49,23,23.99,-1,625,24,24.99,1,48.792,1,0.01,0.01,24.792,24,25
442,1.99,0.01,4,3.96,3.92,0.0,0.0,3.98,1.98,1.98,-0.02,1.98,1.98,0,0,2,2,0.02,2,2,0,0,0,-2,-1.98,0,0,-2,-1.98,0,2.974,2,1.98,0.99,2.974,0,0
443,1.01,0.99,1,0.01,0.0,0.0,0.0,1.01,0.01,0.01,-0.99,0.01,0.01,0,0,1,1,0.99,1,1,0,0,0,-1,-0.01,0,0,-1,-0.01,0,0.014,1,0.01,0.01,0.014,0,0
444,1.01,0.99,169,1.69,0.02,0.0,0.0,13.13,0.13,0.13,-12.87,0.13,0.13,0,0,13,13,12.87,13,13,0,0,0,-13,-0.13,0,0,-13,-0.13,0,0.8026666666666666,13,0.13,0.01,0.8026666666666666,0,0
445,1.99,0.01,1,0.99,0.98,0.0,0.99,1.99,0.99,1.99,-0.01,0.99,-0.01,0,1,1,2,0.01,1,0,0,0,1,-1,-0.99,-1,1,0,0.01,1,1.0,1,0.99,0.99,1.0,0,1
446,1.01,0.99,4,0.04,0.0,0.0,0.0,2.02,0.02,0.02,-1.98,0.02,0.02,0,0,2,2,1.98,2,2,0,0,0,-2,-0.02,0,0,-2,-0.02,0,0.03133333333333333,2,0.02,0.01,0.03133333333333333,0,0
447,1.99,0.01,1,0.99,0.98,0.0,0.0,1.99,0.99,0.99,-0.01,0.99,0.99,0,0,1,1,0.01,1,1,0,0,0,-1,-0.99,0,0,-1,-0.99,0,0.9873333333333333,1,0.99,0.99,0.9873333333333333,0,0
448,1.01,0.99,169,1.69,0.02,0.0,0.0,13.13,0.13,0.13,-12.87,0.13,0.13,0,0,13,13,12.87,13,13,0,0,0,-13,-0.13,0,0,-13,-0.13,0,0.8473333333333334,13,0.13,0.01,0.8473333333333334,0,0
449,1.01,0.99,1,0.01,0.0,0.25,0.25,1.01,25.01,25.01,-0.99,-24.99,-24.99,25,25,26,26,0.99,-24,-24,625,625,50,24,24.99,0,625,24,24.99,0,49.696,1,0.01,0.01,24.695999999999998,25,25
450,1.99,0.01,4,3.96,3.92,0.0,0.0,3.98,1.98,1.98,-0.02,1.98,1.98,0,0,2,2,0.02,2,2,0,0,0,-2,-1.98,0,0,-2,-1.98,0,2.973333333333333,2,1.98,0.99,2.973333333333333,0,0
451,1.01,0.99,1,0.01,0.0,0.0,0.0,1.01,0.01,0.01,-0.99,0.01,0.01,0,0,1,1,0.99,1,1,0,0,0,-1,-0.01,0,0,-1,-0.01,0,0.009333333333333334,1,0.01,0.01,0.009333333333333334,0,0
452,1.74,0.26,169,125.9,93.8,0.0,0.0,22.68,9.68,9.68,-3.32,9.68,9.68,0,0,13,13,3.32,13,13,0,0,0,-13,-9.68,0,0,-13,-9.68,0,67.78666666666666,13,9.68,0.7449999844779577,67.78666666666666,0,0
453,1.99,0.01,625,618.75,612.56,618.75,321.75,49.75,49.75,37.75,-0.25,-0.25,11.75,625,325,50,38,0.25,0,12,625,325,38,0,0.25,12,169,-12,-11.75,-12,350.1653333333333,25,24.75,0.99,325.1653333333333,25,13
454,1.99,0.01,1,0.99,0.98,0.0,0.99,1.99,0.99,1.99,-0.01,0.99,-0.01,0,1,1,2,0.01,1,0,0,0,1,-1,-0.99,-1,1,0,0.01,1,1.0,1,0.99,0.99,1.0,0,1
455,1.99,0.01,625,618.75,612.56,0.0,618.75,49.75,24.75,49.75,-0.25,24.75,-0.25,0,625,25,50,0.25,25,0,0,0,25,-25,-24.75,-25,625,0,0.25,25,328.106,25,24.75,0.99,328.106,0,25
456,1.99,0.01,1,0.99,0.98,0.0,0.0,1.99,0.99,0.99,-0.01,0.99,0.99,0,0,1,1,0.01,1,1,0,0,0,-1,-0.99,0,0,-1,-0.99,0,0.9913333333333333,1,0.99,0.99,0.9913333333333333,0,0
457,1.99,0.01,144,142.56,141.13,297.0,297.0,23.88,36.88,36.88,-0.12,-13.12,-13.12,300,300,37,37,0.12,-13,-13,625,625,50,13,13.12,0,625,13,13.12,0,105.14733333333334,12,11.88,0.9899999993972133,80.14733333333334,25,25
458,1.99,0.01,4,3.96,3.92,0.0,0.0,3.98,1.98,1.98,-0.02,1.98,1.98,0,0,2,2,0.02,2,2,0,0,0,-2,-1.98,0,0,-2,-1.98,0,2.970666666666667,2,1.98,0.99,2.970666666666667,0,0
459,1.99,0.01,169,167.31,165.64,0.0,321.75,25.87,12.87,37.87,-0.13,12.87,-12.13,0,325,13,38,0.13,13,-12,0,0,25,-13,-12.87,-25,625,12,12.13,25,93.42933333333333,13,12.87,0.99,93.42933333333333,0,25
460,1.01,0.99,1,0.01,0.0,0.0,0.25,1.01,0.01,25.01,-0.99,0.01,-24.99,0,25,1,26,0.99,1,-24,0,0,25,-1,-0.01,-25,625,24,24.99,25,24.76,1,0.01,0.01,24.76,0,25
461,1.01,0.99,625,6.25,0.06,0.0,0.0,25.25,0.25,0.25,-24.75,0.25,0.25,0,0,25,25,24.75,25,25,0,0,0,-25,-0.25,0,0,-25,-0.25,0,3.514,25,0.25,0.01,3.514,0,0
462,1.99,0.01,625,618.75,612.56,618.75,0.0,49.75,49.75,24.75,-0.25,-0.25,24.75,625,0,50,25,0.25,0,25,625,0,25,0,0.25,25,0,-25,-24.75,-25,346.538,25,24.75,0.99,321.538,25,0
463,1.99,0.01,625,618.75,612.56,0.0,0.0,49.75,24.75,24.75,-0.25,24.75,24.75,0,0,25,25,0.25,25,25,0,0,0,-25,-24.75,0,0,-25,-24.75,0,322.034,25,24.75,0.99,322.034,0,0
464,1.01,0.99,169,1.69,0.02,3.25,3.25,13.13,25.13,25.13,-12.87,-24.87,-24.87,325,325,38,38,12.87,-12,-12,625,625,50,12,24.87,0,625,12,24.87,0,347.4153333333333,13,0.13,0.01,322.4153333333333,25,25
465,1.99,0.01,625,618.75,612.56,618.75,0.0,49.75,49.75,24.75,-0.25,-0.25,24.75,625,0,50,25,0.25,0,25,625,0,25,0,0.25,25,0,-25,-24.75,-25,346.692,25,24.75,0.99,321.692,25,0
466,1.01,0.99,625,6.25,0.06,0.0,6.25,25.25,0.25,25.25,-24.75,0.25,-24.75,0,625,25,50,24.75,25,0,0,0,25,-25,-0.25,-25,625,0,24.75,25,621.5613333333333,25,0.25,0.01,621.5613333333333,0,25
467,1.99,0.01,625,618.75,612.56,0.0,0.0,49.75,24.75,24.75,-0.25,24.75,24.75,0,0,25,25,0.25,25,25,0,0,0,-25,-24.75,0,0,-25,-24.75,0,321.77933333333334,25,24.75,0.99,321.77933333333334,0,0
468,1.99,0.01,625,618.75,612.56,618.75,618.75,49.75,49.75,49.75,-0.25,-0.25,-0.25,625,625,50,50,0.25,0,0,625,625,50,0,0.25,0,625,0,0.25,0,352.82,25,24.75,0.99,327.82,25,25
469,1.99,0.01,625,618.75,612.56,618.75,297.0,49.75,49.75,36.75,-0.25,-0.25,12.75,625,300,50,37,0.25,0,13,625,300,37,0,0.25,13,144,-13,-12.75,-13,349.552,25,24.75,0.99,324.552,25,12
470,1.99,0.01,625,618.75,612.56,0.0,618.75,49.75,24.75,49.75,-0.25,24.75,-0.25,0,625,25,50,0.25,25,0,0,0,25,-25,-24.75,-25,625,0,0.25,25,327.94466666666665,25,24.75,0.99,327.94466666666665,0,25
471,1.99,0.01,169,167.31,165.64,0.0,321.75,25.87,12.87,37.87,-0.13,12.87,-12.13,0,325,13,38,0.13,13,-12,0,0,25,-13,-12.87,-25,625,12,12.13,25,93.68733333333333,13,12.87,0.99,93.68733333333333,0,25
472,1.99,0.01,1,0.99,0.98,0.0,0.99,1.99,0.99,1.99,-0.01,0.99,-0.01,0,1,1,2,0.01,1,0,0,0,1,-1,-0.99,-1,1,0,0.01,1,1.0,1,0.99,0.99,1.0,0,1
473,1.99,0.01,1,0.99,0.98,0.0,0.0,1.99,0.99,0.99,-0.01,0.99,0.99,0,0,1,1,0.01,1,1,0,0,0,-1,-0.99,0,0,-1,-0.99,0,0.994,1,0.99,0.99,0.994,0,0
474,1.01,0.99,1,0.01,0.0,0.24,0.25,1.01,24.01,25.01,-0.99,-23.99,-24.99,24,25,25,26,0.99,-23,-24,576,600,49,23,23.99,-1,625,24,24.99,1,48.792,1,0.01,0.01,24.792,24,25
475,1.99,0.01,4,3.96,3.92,0.0,0.0,3.98,1.98,1.98,-0.02,1.98,1.98,0,0,2,2,0.02,2,2,0,0,0,-2,-1.98,0,0,-2,-1.98,0,2.974,2,1.98,0.99,2.974,0,0
476,1.01,0.99,1,0.01,0.0,0.0,0.0,1.01,0.01,0.01,-0.99,0.01,0.01,0,0,1,1,0.99,1,1,0,0,0,-1,-0.01,0,0,-1,-0.01,0,0.014,1,0.01,0.01,0.014,0,0
477,1.01,0.99,169,1.69,0.02,0.0,0.0,13.13,0.13,0.13,-12.87,0.13,0.13,0,0,13,13,12.87,13,13,0,0,0,-13,-0.13,0,0,-13,-0.13,0,0.8026666666666666,13,0.13,0.01,0.8026666666666666,0,0
478,1.99,0.01,1,0.99,0.98,0.0,0.99,1.99,0.99,1.99,-0.01,0.99,-0.01,0,1,1,2,0.01,1,0,0,0,1,-1,-0.99,-1,1,0,0.01,1,1.0,1,0.99,0.99,1.0,0,1
479,1.01,0.99,4,0.04,0.0,0.0,0.0,2.02,0.02,0.02,-1.98,0.02,0.02,0,0,2,2,1.98,2,2,0,0,0,-2,-0.02,0,0,-2,-0.02,0,0.03133333333333333,2,0.02,0.01,0.03133333333333333,0,0
480,1.99,0.01,1,0.99,0.98,0.0,0.0,1.99,0.99,0.99,-0.01,0.99,0.99,0,0,1,1,0.01,1,1,0,0,0,-1,-0.99,0,0,-1,-0.99,0,0.9873333333333333,1,0.99,0.99,0.9873333333333333,0,0
481,1.01,0.99,169,1.69,0.02,0.0,0.0,13.13,0.13,0.13,-12.87,0.13,0.13,0,0,13,13,12.87,13,13,0,0,0,-13,-0.13,0,0,-13,-0.13,0,0.8473333333333334,13,0.13,0.01,0.8473333333333334,0,0
482,1.01,0.99,1,0.01,0.0,0.25,0.25,1.01,25.01,25.01,-0.99,-24.99,-24.99,25,25,26,26,0.99,-24,-24,625,625,50,24,24.99,0,625,24,24.99,0,49.696,1,0.01,0.01,24.695999999999998,25,25
483,1.99,0.01,4,3.96,3.92,0.0,0.0,3.98,1.98,1.98,-0.02,1.98,1.98,0,0,2,2,0.02,2,2,0,0,0,-2,-1.98,0,0,-2,-1.98,0,2.973333333333333,2,1.98,0.99,2.973333333333333,0,0
484,1.01,0.99,1,0.01,0.0,0.0,0.0,1.01,0.01,0.01,-0.99,0.01,0.01,0,0,1,1,0.99,1,1,0,0,0,-1,-0.01,0,0,-1,-0.01,0,0.009333333333333334,1,0.01,0.01,0.009333333333333334,0,0
485,1.74,0.26,169,125.9,93.8,0.0,0.0,22.68,9.68,9.68,-3.32,9.68,9.68,0,0,13,13,3.32,13,13,0,0,0,-13,-9.68,0,0,-13,-9.68,0,67.78666666666666,13,9.68,0.7449999844779577,67.78666666666666,0,0
486,1.99,0.01,625,618.75,612.56,618.75,321.75,49.75,49.75,37.75,-0.25,-0.25,11.75,625,325,50,38,0.25,0,12,625,325,38,0,0.25,12,169,-12,-11.75,-12,350.1653333333333,25,24.75,0.99,325.1653333333333,25,13
487,1.99,0.01,1,0.99,0.98,0.0,0.99,1.99,0.99,1.99,-0.01,0.99,-0.01,0,1,1,2,0.01,1,0,0,0,1,-1,-0.99,-1,1,0,0.01,1,1.0,1,0.99,0.99,1.0,0,1
488,1.99,0.01,625,618.75,612.56,0.0,618.75,49.75,24.75,49.75,-0.25,24.75,-0.25,0,625,25,50,0.25,25,0,0,0,25,-25,-24.75,-25,625,0,0.25,25,328.106,25,24.75,0.99,328.106,0,25
489,1.99,0.01,1,0.99,0.98,0.0,0.0,1.99,0.99,0.99,-0.01,0.99,0.99,0,0,1,1,0.01,1,1,0,0,0,-1,-0.99,0,0,-1,-0.99,0,0.9913333333333333,1,0.99,0.99,0.9913333333333333,0,0
490,1.99,0.01,144,142.56,141.13,297.0,297.0,23.88,36.88,36.88,-0.12,-13.12,-13.12,300,300,37,37,0.12,-13,-13,625,625,50,13,13.12,0,625,13,13.12,0,105.14733333333334,12,11.88,0.9899999993972133,80.14733333333334,25,25
491,1.99,0.01,4,3.96,3.92,0.0,0.0,3.98,1.98,1.98,-0.02,1.98,1.98,0,0,2,2,0.02,2,2,0,0,0,-2,-1.98,0,0,-2,-1.98,0,2.970666666666667,2,1.98,0.99,2.970666666666667,0,0
492,1.99,0.01,169,167.31,165.64,0.0,321.75,25.87,12.87,37.87,-0.13,12.87,-12.13,0,325,13,38,0.13,13,-12,0,0,25,-13,-12.87,-25,625,12,12.13,25,93.42933333333333,13,12.87,0.99,93.42933333333333,0,25
493,1.01,0.99,1,0.01,0.0,0.0,0.25,1.01,0.01,25.01,-0.99,0.01,-24.99,0,25,1,26,0.99,1,-24,0,0,25,-1,-0.01,-25,625,24,24.99,25,24.76,1,0.01,0.01,24.76,0,25
494,1.01,0.99,625,6.25,0.06,0.0,0.0,25.25,0.25,0.25,-24.75,0.25,0.25,0,0,25,25,24.75,25,25,0,0,0,-25,-0.25,0,0,-25,-0.25,0,3.514,25,0.25,0.01,3.514,0,0
495,1.99,0.01,625,618.75,612.56,618.75,0.0,49.75,49.75,24.75,-0.25,-0.25,24.75,625,0,50,25,0.25,0,25,625,0,25,0,0.25,25,0,-25,-24.75,-25,346.538,25,24.75,0.99,321.538,25,0
496,1.99,0.01,625,618.75,612.56,0.0,0.0,49.75,24.75,24.75,-0.25,24.75,24.75,0,0,25,25,0.25,25,25,0,0,0,-25,-24.75,0,0,-25,-24.75,0,322.034,25,24.75,0.99,322.034,0,0
497,1.01,0.99,169,1.69,0.02,3.25,3.25,13.13,25.13,25.13,-12.87,-24.87,-24.87,325,325,38,38,12.87,-12,-12,625,625,50,12,24.87,0,625,12,24.87,0,347.4153333333333,13,0.13,0.01,322.4153333333333,25,25
498,1.99,0.01,625,618.75,612.56,618.75,0.0,49.75,49.75,24.75,-0.25,-0.25,24.75,625,0,50,25,0.25,0,25,625,0,25,0,0.25,25,0,-25,-24.75,-25,346.692,25,24.75,0.99,321.692,25,0
499,1.01,0.99,625,6.25,0.06,0.0,6.25,25.25,0.25,25.25,-24.75,0.25,-24.75,0,625,25,50,24.75,25,0,0,0,25,-25,-0.25,-25,625,0,24.75,25,621.5613333333333,25,0.25,0.01,621.5613333333333,0,25
500,1.99,0.01,625,618.75,612.56,0.0,0.0,49.75,24.75,24.75,-0.25,24.75,24.75,0,0,25,25,0.25,25,25,0,0,0,-25,-24.75,0,0,-25,-24.75,0,321.77933333333334,25,24.75,0.99,321.77933333333334,0,0
501,1.99,0.01,625,618.75,612.56,618.75,618.75,49.75,49.75,49.75,-0.25,-0.25,-0.25,625,625,50,50,0.25,0,0,625,625,50,0,0.25,0,625,0,0.25,0,352.82,25,24.75,0.99,327.82,25,25
502,1.99,0.01,625,618.75,612.56,618.75,297.0,49.75,49.75,36.75,-0.25,-0.25,12.75,625,300,50,37,0.25,0,13,625,300,37,0,0.25,13,144,-13,-12.75,-13,349.552,25,24.75,0.99,324.552,25,12
503,1.99,0.01,625,618.75,612.56,0.0,618.75,49.75,24.75,49.75,-0.25,24.75,-0.25,0,625,25,50,0.25,25,0,0,0,25,-25,-24.75,-25,625,0,0.25,25,327.94466666666665,25,24.75,0.99,327.94466666666665,0,25
504,1.99,0.01,169,167.31,165.64,0.0,321.75,25.87,12.87,37.87,-0.13,12.87,-12.13,0,325,13,38,0.13,13,-12,0,0,25,-13,-12.87,-25,625,12,12.13,25,93.68733333333333,13,12.87,0.99,93.68733333333333,0,25
505,1.99,0.01,1,0.99,0.98,0.0,0.99,1.99,0.99,1.99,-0.01,0.99,-0.01,0,1,1,2,0.01,1,0,0,0,1,-1,-0.99,-1,1,0,0.01,1,1.0,1,0.99,0.99,1.0,0,1
506,1.99,0.01,1,0.99,0.98,0.0,0.0,1.99,0.99,0.99,-0.01,0.99,0.99,0,0,1,1,0.01,1,1,0,0,0,-1,-0.99,0,0,-1,-0.99,0,0.994,1,0.99,0.99,0.994,0,0
507,1.01,0.99,1,0.01,0.0,0.24,0.25,1.01,24.01,25.01,-0.99,-23.99,-24.99,24,25,25,26,0.99,-23,-24,576,600,49,23,23.99,-1,625,24,24.99,1,48.792,1,0.01,0.01,24.792,24,25
508,1.99,0.01,4,3.96,3.92,0.0,0.0,3.98,1.98,1.98,-0.02,1.98,1.98,0,0,2,2,0.02,2,2,0,0,0,-2,-1.98,0,0,-2,-1.98,0,2.974,2,1.98,0.99,2.974,0,0
509,1.01,0.99,1,0.01,0.0,0.0,0.0,1.01,0.01,0.01,-0.99,0.01,0.01,0,0,1,1,0.99,1,1,0,0,0,-1,-0.01,0,0,-1,-0.01,0,0.014,1,0.01,0.01,0.014,0,0
510,1.01,0.99,169,1.69,0.02,0.0,0.0,13.13,0.13,0.13,-12.87,0.13,0.13,0,0,13,13,12.87,13,13,0,0,0,-13,-0.13,0,0,-13,-0.13,0,0.8026666666666666,13,0.13,0.01,0.8026666666666666,0,0
511,1.99,0.01,1,0.99,0.98,0.0,0.99,1.99,0.99,1.99,-0.01,0.99,-0.01,0,1,1,2,0.01,1,0,0,0,1,-1,-0.99,-1,1,0,0.01,1,1.0,1,0.99,0.99,1.0,0,1
512,1.01,0.99,4,0.04,0.0,0.0,0.0,2.02,0.02,0.02,-1.98,0.02,0.02,0,0,2,2,1.98,2,2,0,0,0,-2,-0.02,0,0,-2,-0.02,0,0.03133333333333333,2,0.02,0.01,0.03133333333333333,0,0
513,1.99,0.01,1,0.99,0.98,0.0,0.0,1.99,0.99,0.99,-0.01,0.99,0.99,0,0,1,1,0.01,1,1,0,0,0,-1,-0.99,0,0,-1,-0.99,0,0.9873333333333333,1,0.99,0.99,0.9873333333333333,0,0
514,1.01,0.99,169,1.69,0.02,0.0,0.0,13.13,0.13,0.13,-12.87,0.13,0.13,0,0,13,13,12.87,13,13,0,0,0,-13,-0.13,0,0,-13,-0.13,0,0.8473333333333334,13,0.13,0.01,0.8473333333333334,0,0
515,1.01,0.99,1,0.01,0.0,0.25,0.25,1.01,25.01,25.01,-0.99,-24.99,-24.99,25,25,26,26,0.99,-24,-24,625,625,50,24,24.99,0,625,24,24.99,0,49.696,1,0.01,0.01,24.695999999999998,25,25
516,1.99,0.01,4,3.96,3.92,0.0,0.0,3.98,1.98,1.98,-0.02,1.98,1.98,0,0,2,2,0.02,2,2,0,0,0,-2,-1.98,0,0,-2,-1.98,0,2.973333333333333,2,1.98,0.99,2.973333333333333,0,0
517,1.01,0.99,1,0.01,0.0,0.0,0.0,1.01,0.01,0.01,-0.99,0.01,0.01,0,0,1,1,0.99,1,1,0,0,0,-1,-0.01,0,0,-1,-0.01,0,0.009333333333333334,1,0.01,0.01,0.009333333333333334,0,0
518,1.74,0.26,169,125.9,93.8,0.0,0.0,22.68,9.68,9.68,-3.32,9.68,9.68,0,0,13,13,3.32,13,13,0,0,0,-13,-9.68,0,0,-13,-9.68,0,67.78666666666666,13,9.68,0.7449999844779577,67.78666666666666,0,0
519,1.99,0.01,625,618.75,612.56,618.75,321.75,49.75,49.75,37.75,-0.25,-0.25,11.75,625,325,50,38,0.25,0,12,625,325,38,0,0.25,12,169,-12,-11.75,-12,350.1653333333333,25,24.75,0.99,325.1653333333333,25,13
520,1.99,0.01,1,0.99,0.98,0.0,0.99,1.99,0.99,1.99,-0.01,0.99,-0.01,0,1,1,2,0.01,1,0,0,0,1,-1,-0.99,-1,1,0,0.01,1,1.0,1,0.99,0.99,1.0,0,1
521,1.99,0.01,625,618.75,612.56,0.0,618.75,49.75,24.75,49.75,-0.25,24.75,-0.25,0,625,25,50,0.25,25,0,0,0,25,-25,-24.75,-25,625,0,0.25,25,328.106,25,24.75,0.99,328.106,0,25
522,1.99,0.01,1,0.99,0.98,0.0,0.0,1.99,0.99,0.99,-0.01,0.99,0.99,0,0,1,1,0.01,1,1,0,0,0,-1,-0.99,0,0,-1,-0.99,0,0.9913333333333333,1,0.99,0.99,0.9913333333333333,0,0
523,1.99,0.01,144,142.56,141.13,297.0,297.0,23.88,36.88,36.88,-0.12,-13.12,-13.12,300,300,37,37,0.12,-13,-13,625,625,50,13,13.12,0,625,13,13.12,0,105.14733333333334,12,11.88,0.9899999993972133,80.14733333333334,25,25
524,1.99,0.01,4,3.96,3.92,0.0,0.0,3.98,1.98,1.98,-0.02,1.98,1.98,0,0,2,2,0.02,2,2,0,0,0,-2,-1.98,0,0,-2,-1.98,0,2.970666666666667,2,1.98,0.99,2.970666666666667,0,0
525,1.99,0.01,169,167.31,165.64,0.0,321.75,25.87,12.87,37.87,-0.13,12.87,-12.13,0,325,13,38,0.13,13,-12,0,0,25,-13,-12.87,-25,625,12,12.13,25,93.42933333333333,13,12.87,0.99,93.42933333333333,0,25
526,1.01,0.99,1,0.01,0.0,0.0,0.25,1.01,0.01,25.01,-0.99,0.01,-24.99,0,25,1,26,0.99,1,-24,0,0,25,-1,-0.01,-25,625,24,24.99,25,24.76,1,0.01,0.01,24.76,0,25
527,1.01,0.99,625,6.25,0.06,0.0,0.0,25.25,0.25,0.25,-24.75,0.25,0.25,0,0,25,25,24.75,25,25,0,0,0,-25,-0.25,0,0,-25,-0.25,0,3.514,25,0.25,0.01,3.514,0,0
528,1.99,0.01,625,618.75,612.56,618.75,0.0,49.75,49.75,24.75,-0.25,-0.25,24.75,625,0,50,25,0.25,0,25,625,0,25,0,0.25,25,0,-25,-24.75,-25,346.538,25,24.75,0.99,321.538,25,0
529,1.99,0.01,625,618.75,612.56,0.0,0.0,49.75,24.75,24.75,-0.25,24.75,24.75,0,0,25,25,0.25,25,25,0,0,0,-25,-24.75,0,0,-25,-24.75,0,322.034,25,24.75,0.99,322.034,0,0
530,1.01,0.99,169,1.69,0.02,3.25,3.25,13.13,25.13,25.13,-12.87,-24.87,-24.87,325,325,38,38,12.87,-12,-12,625,625,50,12,24.87,0,625,12,24.87,0,347.4153333333333,13,0.13,0.01,322.4153333333333,25,25
531,1.99,0.01,625,618.75,612.56,618.75,0.0,49.75,49.75,24.75,-0.25,-0.25,24.75,625,0,50,25,0.25,0,25,625,0,25,0,0.25,25,0,-25,-24.75,-25,346.692,25,24.75,0.99,321.692,25,0
532,1.01,0.99,625,6.25,0.06,0.0,6.25,25.25,0.25,25.25,-24.75,0.25,-24.75,0,625,25,50,24.75,25,0,0,0,25,-25,-0.25,-25,625,0,24.75,25,621.5613333333333,25,0.25,0.01,621.5613333333333,0,25
533,1.99,0.01,625,618.75,612.56,0.0,0.0,49.75,24.75,24.75,-0.25,24.75,24.75,0,0,25,25,0.25,25,25,0,0,0,-25,-24.75,0,0,-25,-24.75,0,321.77933333333334,25,24.75,0.99,321.77933333333334,0,0
534,1.99,0.01,625,618.75,612.56,618.75,618.75,49.75,49.75,49.75,-0.25,-0.25,-0.25,625,625,50,50,0.25,0,0,625,625,50,0,0.25,0,625,0,0.25,0,352.82,25,24.75,0.99,327.82,25,25
535,1.99,0.01,625,618.75,612.56,618.75,297.0,49.75,49.75,36.75,-0.25,-0.25,12.75,625,300,50,37,0.25,0,13,625,300,37,0,0.25,13,144,-13,-12.75,-13,349.552,25,24.75,0.99,324.552,25,12
536,1.99,0.01,625,618.75,612.56,0.0,618.75,49.75,24.75,49.75,-0.25,24.75,-0.25,0,625,25,50,0.25,25,0,0,0,25,-25,-24.75,-25,625,0,0.25,25,327.94466666666665,25,24.75,0.99,327.94466666666665,0,25
537,1.99,0.01,169,167.31,165.64,0.0,321.75,25.87,12.87,37.87,-0.13,12.87,-12.13,0,325,13,38,0.13,13,-12,0,0,25,-13,-12.87,-25,625,12,12.13,25,93.68733333333333,13,12.87,0.99,93.68733333333333,0,25
538,1.99,0.01,1,0.99,0.98,0.0,0.99,1.99,0.99,1.99,-0.01,0.99,-0.01,0,1,1,2,0.01,1,0,0,0,1,-1,-0.99,-1,1,0,0.01,1,1.0,1,0.99,0.99,1.0,0,1
539,1.99,0.01,1,0.99,0.98,0.0,0.0,1.99,0.99,0.99,-0.01,0.99,0.99,0,0,1,1,0.01,1,1,0,0,0,-1,-0.99,0,0,-1,-0.99,0,0.994,1,0.99,0.99,0.994,0,0
540,1.01,0.99,1,0.01,0.0,0.24,0.25,1.01,24.01,25.01,-0.99,-23.99,-24.99,24,25,25,26,0.99,-23,-24,576,600,49,23,23.99,-1,625,24,24.99,1,48.792,1,0.01,0.01,24.792,24,25
541,1.99,0.01,4,3.96,3.92,0.0,0.0,3.98,1.98,1.98,-0.02,1.98,1.98,0,0,2,2,0.02,2,2,0,0,0,-2,-1.98,0,0,-2,-1.98,0,2.974,2,1.98,0.99,2.974,0,0
542,1.01,0.99,1,0.01,0.0,0.0,0.0,1.01,0.01,0.01,-0.99,0.01,0.01,0,0,1,1,0.99,1,1,0,0,0,-1,-0.01,0,0,-1,-0.01,0,0.014,1,0.01,0.01,0.014,0,0
543,1.01,0.99,169,1.69,0.02,0.0,0.0,13.13,0.13,0.13,-12.87,0.13,0.13,0,0,13,13,12.87,13,13,0,0,0,-13,-0.13,0,0,-13,-0.13,0,0.8026666666666666,13,0.13,0.01,0.8026666666666666,0,0
544,1.99,0.01,1,0.99,0.98,0.0,0.99,1.99,0.99,1.99,-0.01,0.99,-0.01,0,1,1,2,0.01,1,0,0,0,1,-1,-0.99,-1,1,0,0.01,1,1.0,1,0.99,0.99,1.0,0,1
545,1.01,0.99,4,0.04,0.0,0.0,0.0,2.02,0.02,0.02,-1.98,0.02,0.02,0,0,2,2,1.98,2,2,0,0,0,-2,-0.02,0,0,-2,-0.02,0,0.03133333333333333,2,0.02,0.01,0.03133333333333333,0,0
546,1.99,0.01,1,0.99,0.98,0.0,0.0,1.99,0.99,0.99,-0.01,0.99,0.99,0,0,1,1,0.01,1,1,0,0,0,-1,-0.99,0,0,-1,-0.99,0,0.9873333333333333,1,0.99,0.99,0.9873333333333333,0,0
547,1.01,0.99,169,1.69,0.02,0.0,0.0,13.13,0.13,0.13,-12.87,0.13,0.13,0,0,13,13,12.87,13,13,0,0,0,-13,-0.13,0,0,-13,-0.13,0,0.8473333333333334,13,0.13,0.01,0.8473333333333334,0,0
548,1.01,0.99,1,0.01,0.0,0.25,0.25,1.01,25.01,25.01,-0.99,-24.99,-24.99,25,25,26,26,0.99,-24,-24,625,625,50,24,24.99,0,625,24,24.99,0,49.696,1,0.01,0.01,24.695999999999998,25,25
549,1.99,0.01,4,3.96,3.92,0.0,0.0,3.98,1.98,1.98,-0.02,1.98,1.98,0,0,2,2,0.02,2,2,0,0,0,-2,-1.98,0,0,-2,-1.98,0,2.973333333333333,2,1.98,0.99,2.973333333333333,0,0
550,1.01,0.99,1,0.01,0.0,0.0,0.0,1.01,0.01,0.01,-0.99,0.01,0.01,0,0,1,1,0.99,1,1,0,0,0,-1,-0.01,0,0,-1,-0.01,0,0.009333333333333334,1,0.01,0.01,0.009333333333333334,0,0
551,1.74,0.26,169,125.9,93.8,0.0,0.0,22.68,9.68,9.68,-3.32,9.68,9.68,0,0,13,13,3.32,13,13,0,0,0,-13,-9.68,0,0,-13,-9.68,0,67.78666666666666,13,9.68,0.7449999844779577,67.78666666666666,0,0
552,1.99,0.01,625,618.75,612.56,618.75,321.75,49.75,49.75,37.75,-0.25,-0.25,11.75,625,325,50,38,0.25,0,12,625,325,38,0,0.25,12,169,-12,-11.75,-12,350.1653333333333,25,24.75,0.99,325.1653333333333,25,13
553,1.99,0.01,1,0.99,0.98,0.0,0.99,1.99,0.99,1.99,-0.01,0.99,-0.01,0,1,1,2,0.01,1,0,0,0,1,-1,-0.99,-1,1,0,0.01,1,1.0,1,0.99,0.99,1.0,0,1
554,1.99,0.01,625,618.75,612.56,0.0,618.75,49.75,24.75,49.75,-0.25,24.75,-0.25,0,625,25,50,0.25,25,0,0,0,25,-25,-24.75,-25,625,0,0.25,25,328.106,25,24.75,0.99,328.106,0,25
555,1.99,0.01,1,0.99,0.98,0.0,0.0,1.99,0.99,0.99,-0.01,0.99,0.99,0,0,1,1,0.01,1,1,0,0,0,-1,-0.99,0,0,-1,-0.99,0,0.9913333333333333,1,0.99,0.99,0.9913333333333333,0,0
556,1.99,0.01,144,142.56,141.13,297.0,297.0,23.88,36.88,36.88,-0.12,-13.12,-13.12,300,300,37,37,0.12,-13,-13,625,625,50,13,13.12,0,625,13,13.12,0,105.14733333333334,12,11.88,0.9899999993972133,80.14733333333334,25,25
557,1.99,0.01,4,3.96,3.92,0.0,0.0,3.98,1.98,1.98,-0.02,1.98,1.98,0,0,2,2,0.02,2,2,0,0,0,-2,-1.98,0,0,-2,-1.98,0,2.970666666666667,2,1.98,0.99,2.970666666666667,0,0
558,1.99,0.01,169,167.31,165.64,0.0,321.75,25.87,12.87,37.87,-0.13,12.87,-12.13,0,325,13,38,0.13,13,-12,0,0,25,-13,-12.87,-25,625,12,12.13,25,93.42933333333333,13,12.87,0.99,93.42933333333333,0,25
559,1.01,0.99,1,0.01,0.0,0.0,0.25,1.01,0.01,25.01,-0.99,0.01,-24.99,0,25,1,26,0.99,1,-24,0,0,25,-1,-0.01,-25,625,24,24.99,25,24.76,1,0.01,0.01,24.76,0,25
560,1.01,0.99,625,6.25,0.06,0.0,0.0,25.25,0.25,0.25,-24.75,0.25,0.25,0,0,25,25,24.75,25,25,0,0,0,-25,-0.25,0,0,-25,-0.25,0,3.514,25,0.25,0.01,3.514,0,0
561,1.99,0.01,625,618.75,612.56,618.75,0.0,49.75,49.75,24.75,-0.25,-0.25,24.75,625,0,50,25,0.25,0,25,625,0,25,0,0.25,25,0,-25,-24.75,-25,346.538,25,24.75,0.99,321.538,25,0
562,1.99,0.01,625,618.75,612.56,0.0,0.0,49.75,24.75,24.75,-0.25,24.75,24.75,0,0,25,25,0.25,25,25,0,0,0,-25,-24.75,0,0,-25,-24.75,0,322.034,25,24.75,0.99,322.034,0,0
563,1.01,0.99,169,1.69,0.02,3.25,3.25,13.13,25.13,25.13,-12.87,-24.87,-24.87,325,325,38,38,12.87,-12,-12,625,625,50,12,24.87,0,625,12,24.87,0,347.4153333333333,13,0.13,0.01,322.4153333333333,25,25
564,1.99,0.01,625,618.75,612.56,618.75,0.0,49.75,49.75,24.75,-0.25,-0.25,24.75,625,0,50,25,0.25,0,25,625,0,25,0,0.25,25,0,-25,-24.75,-25,346.692,25,24.75,0.99,321.692,25,0
565,1.01,0.99,625,6.25,0.06,0.0,6.25,25.25,0.25,25.25,-24.75,0.25,-24.75,0,625,25,50,24.75,25,0,0,0,25,-25,-0.25,-25,625,0,24.75,25,621.5613333333333,25,0.25,0.01,621.5613333333333,0,25
566,1.99,0.01,625,618.75,612.56,0.0,0.0,49.75,24.75,24.75,-0.25,24.75,24.75,0,0,25,25,0.25,25,25,0,0,0,-25,-24.75,0,0,-25,-24.75,0,321.77933333333334,25,24.75,0.99,321.77933333333334,0,0
567,1.99,0.01,625,618.75,612.56,618.75,618.75,49.75,49.75,49.75,-0.25,-0.25,-0.25,625,625,50,50,0.25,0,0,625,625,50,0,0.25,0,625,0,0.25,0,352.82,25,24.75,0.99,327.82,25,25
568,1.99,0.01,625,618.75,612.56,618.75,297.0,49.75,49.75,36.75,-0.25,-0.25,12.75,625,300,50,37,0.25,0,13,625,300,37,0,0.25,13,144,-13,-12.75,-13,349.552,25,24.75,0.99,324.552,25,12
569,1.99,0.01,625,618.75,612.56,0.0,618.75,49.75,24.75,49.75,-0.25,24.75,-0.25,0,625,25,50,0.25,25,0,0,0,25,-25,-24.75,-25,625,0,0.25,25,327.94466666666665,25,24.75,0.99,327.94466666666665,0,25
570,1.99,0.01,169,167.31,165.64,0.0,321.75,25.87,12.87,37.87,-0.13,12.87,-12.13,0,325,13,38,0.13,13,-12,0,0,25,-13,-12.87,-25,625,12,12.13,25,93.68733333333333,13,12.87,0.99,93.68733333333333,0,25
571,1.99,0.01,1,0.99,0.98,0.0,0.99,1.99,0.99,1.99,-0.01,0.99,-0.01,0,1,1,2,0.01,1,0,0,0,1,-1,-0.99,-1,1,0,0.01,1,1.0,1,0.99,0.99,1.0,0,1
572,1.99,0.01,1,0.99,0.98,0.0,0.0,1.99,0.99,0.99,-0.01,0.99,0.99,0,0,1,1,0.01,1,1,0,0,0,-1,-0.99,0,0,-1,-0.99,0,0.994,1,0.99,0.99,0.994,0,0
573,1.01,0.99,1,0.01,0.0,0.24,0.25,1.01,24.01,25.01,-0.99,-23.99,-24.99,24,25,25,26,0.99,-23,-24,576,600,49,23,23.99,-1,625,24,24.99,1,48.792,1,0.01,0.01,24.792,24,25
574,1.99,0.01,4,3.96,3.92,0.0,0.0,3.98,1.98,1.98,-0.02,1.98,1.98,0,0,2,2,0.02,2,2,0,0,0,-2,-1.98,0,0,-2,-1.98,0,2.974,2,1.98,0.99,2.974,0,0
575,1.01,0.99,1,0.01,0.0,0.0,0.0,1.01,0.01,0.01,-0.99,0.01,0.01,0,0,1,1,0.99,1,1,0,0,0,-1,-0.01,0,0,-1,-0.01,0,0.014,1,0.01,0.01,0.014,0,0
576,1.01,0.99,169,1.69,0.02,0.0,0.0,13.13,0.13,0.13,-12.87,0.13,0.13,0,0,13,13,12.87,13,13,0,0,0,-13,-0.13,0,0,-13,-0.13,0,0.8026666666666666,13,0.13,0.01,0.8026666666666666,0,0
577,1.99,0.01,1,0.99,0.98,0.0,0.99,1.99,0.99,1.99,-0.01,0.99,-0.01,0,1,1,2,0.01,1,0,0,0,1,-1,-0.99,-1,1,0,0.01,1,1.0,1,0.99,0.99,1.0,0,1
578,1.01,0.99,4,0.04,0.0,0.0,0.0,2.02,0.02,0.02,-1.98,0.02,0.02,0,0,2,2,1.98,2,2,0,0,0,-2,-0.02,0,0,-2,-0.02,0,0.03133333333333333,2,0.02,0.01,0.03133333333333333,0,0
579,1.99,0.01,1,0.99,0.98,0.0,0.0,1.99,0.99,0.99,-0.01,0.99,0.99,0,0,1,1,0.01,1,1,0,0,0,-1,-0.99,0,0,-1,-0.99,0,0.9873333333333333,1,0.99,0.99,0.9873333333333333,0,0
580,1.01,0.99,169,1.69,0.02,0.0,0.0,13.13,0.13,0.13,-12.87,0.13,0.13,0,0,13,13,12.87,13,13,0,0,0,-13,-0.13,0,0,-13,-0.13,0,0.8473333333333334,13,0.13,0.01,0.8473333333333334,0,0
581,1.01,0.99,1,0.01,0.0,0.25,0.25,1.01,25.01,25.01,-0.99,-24.99,-24.99,25,25,26,26,0.99,-24,-24,625,625,50,24,24.99,0,625,24,24.99,0,49.696,1,0.01,0.01,24.695999999999998,25,25
582,1.99,0.01,4,3.96,3.92,0.0,0.0,3.98,1.98,1.98,-0.02,1.98,1.98,0,0,2,2,0.02,2,2,0,0,0,-2,-1.98,0,0,-2,-1.98,0,2.973333333333333,2,1.98,0.99,2.973333333333333,0,0
583,1.01,0.99,1,0.01,0.0,0.0,0.0,1.01,0.01,0.01,-0.99,0.01,0.01,0,0,1,1,0.99,1,1,0,0,0,-1,-0.01,0,0,-1,-0.01,0,0.009333333333333334,1,0.01,0.01,0.009333333333333334,0,0
584,1.74,0.26,169,125.9,93.8,0.0,0.0,22.68,9.68,9.68,-3.32,9.68,9.68,0,0,13,13,3.32,13,13,0,0,0,-13,-9.68,0,0,-13,-9.68,0,67.78666666666666,13,9.68,0.7449999844779577,67.78666666666666,0,0
585,1.99,0.01,625,618.75,612.56,618.75,321.75,49.75,49.75,37.75,-0.25,-0.25,11.75,625,325,50,38,0.25,0,12,625,325,38,0,0.25,12,169,-12,-11.75,-12,350.1653333333333,25,24.75,0.99,325.1653333333333,25,13
586,1.99,0.01,1,0.99,0.98,0.0,0.99,1.99,0.99,1.99,-0.01,0.99,-0.01,0,1,1,2,0.01,1,0,0,0,1,-1,-0.99,-1,1,0,0.01,1,1.0,1,0.99,0.99,1.0,0,1
587,1.99,0.01,625,618.75,612.56,0.0,618.75,49.75,24.75,49.75,-0.25,24.75,-0.25,0,625,25,50,0.25,25,0,0,0,25,-25,-24.75,-25,625,0,0.25,25,328.106,25,24.75,0.99,328.106,0,25
588,1.99,0.01,1,0.99,0.98,0.0,0.0,1.99,0.99,0.99,-0.01,0.99,0.99,0,0,1,1,0.01,1,1,0,0,0,-1,-0.99,0,0,-1,-0.99,0,0.9913333333333333,1,0.99,0.99,0.9913333333333333,0,0
589,1.99,0.01,144,142.56,141.13,297.0,297.0,23.88,36.88,36.88,-0.12,-13.12,-13.12,300,300,37,37,0.12,-13,-13,625,625,50,13,13.12,0,625,13,13.12,0,105.14733333333334,12,11.88,0.9899999993972133,80.14733333333334,25,25
590,1.99,0.01,4,3.96,3.92,0.0,0.0,3.98,1.98,1.98,-0.02,1.98,1.98,0,0,2,2,0.02,2,2,0,0,0,-2,-1.98,0,0,-2,-1.98,0,2.970666666666667,2,1.98,0.99,2.970666666666667,0,0
591,1.99,0.01,169,167.31,165.64,0.0,321.75,25.87,12.87,37.87,-0.13,12.87,-12.13,0,325,13,38,0.13,13,-12,0,0,25,-13,-12.87,-25,625,12,12.13,25,93.42933333333333,13,12.87,0.99,93.42933333333333,0,25
592,1.01,0.99,1,0.01,0.0,0.0,0.25,1.01,0.01,25.01,-0.99,0.01,-24.99,0,25,1,26,0.99,1,-24,0,0,25,-1,-0.01,-25,625,24,24.99,25,24.76,1,0.01,0.01,24.76,0,25
593,1.01,0.99,625,6.25,0.06,0.0,0.0,25.25,0.25,0.25,-24.75,0.25,0.25,0,0,25,25,24.75,25,25,0,0,0,-25,-0.25,0,0,-25,-0.25,0,3.514,25,0.25,0.01,3.514,0,0
594,1.99,0.01,625,618.75,612.56,618.75,0.0,49.75,49.75,24.75,-0.25,-0.25,24.75,625,0,50,25,0.25,0,25,625,0,25,0,0.25,25,0,-25,-24.75,-25,346.538,25,24.75,0.99,321.538,25,0
595,1.99,0.01,625,618.75,612.56,0.0,0.0,49.75,24.75,24.75,-0.25,24.75,24.75,0,0,25,25,0.25,25,25,0,0,0,-25,-24.75,0,0,-25,-24.75,0,322.034,25,24.75,0.99,322.034,0,0
596,1.01,0.99,169,1.69,0.02,3.25,3.25,13.13,25.13,25.13,-12.87,-24.87,-24.87,325,325,38,38,12.87,-12,-12,625,625,50,12,24.87,0,625,12,24.87,0,347.4153333333333,13,0.13,0.01,322.4153333333333,25,25
597,1.99,0.01,625,618.75,612.56,618.75,0.0,49.75,49.75,24.75,-0.25,-0.25,24.75,625,0,50,25,0.25,0,25,625,0,25,0,0.25,25,0,-25,-24.75,-25,346.692,25,24.75,0.99,321.692,25,0
598,1.01,0.99,625,6.25,0.06,0.0,6.25,25.25,0.25,25.25,-24.75,0.25,-24.75,0,625,25,50,24.75,25,0,0,0,25,-25,-0.25,-25,625,0,24.75,25,621.5613333333333,25,0.25,0.01,621.5613333333333,0,25
599,1.99,0.01,625,618.75,612.56,0.0,0.0,49.75,24.75,24.75,-0.25,24.75,24.75,0,0,25,25,0.25,25,25,0,0,0,-25,-24.75,0,0,-25,-24.75,0,321.77933333333334,25,24.75,0.99,321.77933333333334,0,0
600,1.99,0.01,625,618.75,612.56,618.75,618.75,49.75,49.75,49.75,-0.25,-0.25,-0.25,625,625,50,50,0.25,0,0,625,625,50,0,0.25,0,625,0,0.25,0,352.82,25,24.75,0.99,327.82,25,25
601,1.99,0.01,625,618.75,612.56,618.75,297.0,49.75,49.75,36.75,-0.25,-0.25,12.75,625,300,50,37,0.25,0,13,625,300,37,0,0.25,13,144,-13,-12.75,-13,349.552,25,24.75,0.99,324.552,25,12
602,1.99,0.01,625,618.75,612.56,0.0,618.75,49.75,24.75,49.75,-0.25,24.75,-0.25,0,625,25,50,0.25,25,0,0,0,25,-25,-24.75,-25,625,0,0.25,25,327.94466666666665,25,24.75,0.99,327.94466666666665,0,25
603,1.99,0.01,169,167.31,165.64,0.0,321.75,25.87,12.87,37.87,-0.13,12.87,-12.13,0,325,13,38,0.13,13,-12,0,0,25,-13,-12.87,-25,625,12,12.13,25,93.68733333333333,13,12.87,0.99,93.68733333333333,0,25
604,1.99,0.01,1,0.99,0.98,0.0,0.99,1.99,0.99,1.99,-0.01,0.99,-0.01,0,1,1,2,0.01,1,0,0,0,1,-1,-0.99,-1,1,0,0.01,1,1.0,1,0.99,0.99,1.0,0,1
605,1.99,0.01,1,0.99,0.98,0.0,0.0,1.99,0.99,0.99,-0.01,0.99,0.99,0,0,1,1,0.01,1,1,0,0,0,-1,-0.99,0,0,-1,-0.99,0,0.994,1,0.99,0.99,0.994,0,0
606,1.01,0.99,1,0.01,0.0,0.24,0.25,1.01,24.01,25.01,-0.99,-23.99,-24.99,24,25,25,26,0.99,-23,-24,576,600,49,23,23.99,-1,625,24,24.99,1,48.792,1,0.01,0.01,24.792,24,25
607,1.99,0.01,4,3.96,3.92,0.0,0.0,3.98,1.98,1.98,-0.02,1.98,1.98,0,0,2,2,0.02,2,2,0,0,0,-2,-1.98,0,0,-2,-1.98,0,2.974,2,1.98,0.99,2.974,0,0
608,1.01,0.99,1,0.01,0.0,0.0,0.0,1.01,0.01,0.01,-0.99,0.01,0.01,0,0,1,1,0.99,1,1,0,0,0,-1,-0.01,0,0,-1,-0.01,0,0.014,1,0.01,0.01,0.014,0,0
609,1.01,0.99,169,1.69,0.02,0.0,0.0,13.13,0.13,0.13,-12.87,0.13,0.13,0,0,13,13,12.87,13,13,0,0,0,-13,-0.13,0,0,-13,-0.13,0,0.8026666666666666,13,0.13,0.01,0.8026666666666666,0,0
610,1.99,0.01,1,0.99,0.98,0.0,0.99,1.99,0.99,1.99,-0.01,0.99,-0.01,0,1,1,2,0.01,1,0,0,0,1,-1,-0.99,-1,1,0,0.01,1,1.0,1,0.99,0.99,1.0,0,1
611,1.01,0.99,4,0.04,0.0,0.0,0.0,2.02,0.02,0.02,-1.98,0.02,0.02,0,0,2,2,1.98,2,2,0,0,0,-2,-0.02,0,0,-2,-0.02,0,0.03133333333333333,2,0.02,0.01,0.03133333333333333,0,0
612,1.99,0.01,1,0.99,0.98,0.0,0.0,1.99,0.99,0.99,-0.01,0.99,0.99,0,0,1,1,0.01,1,1,0,0,0,-1,-0.99,0,0,-1,-0.99,0,0.9873333333333333,1,0.99,0.99,0.9873333333333333,0,0
613,1.01,0.99,169,1.69,0.02,0.0,0.0,13.13,0.13,0.13,-12.87,0.13,0.13,0,0,13,13,12.87,13,13,0,0,0,-13,-0.13,0,0,-13,-0.13,0,0.8473333333333334,13,0.13,0.01,0.8473333333333334,0,0
614,1.01,0.99,1,0.01,0.0,0.25,0.25,1.01,25.01,25.01,-0.99,-24.99,-24.99,25,25,26,26,0.99,-24,-24,625,625,50,24,24.99,0,625,24,24.99,0,49.696,1,0.01,0.01,24.695999999999998,25,25
615,1.99,0.01,4,3.96,3.92,0.0,0.0,3.98,1.98,1.98,-0.02,1.98,1.98,0,0,2,2,0.02,2,2,0,0,0,-2,-1.98,0,0,-2,-1.98,0,2.973333333333333,2,1.98,0.99,2.973333333333333,0,0
616,1.01,0.99,1,0.01,0.0,0.0,0.0,1.01,0.01,0.01,-0.99,0.01,0.01,0,0,1,1,0.99,1,1,0,0,0,-1,-0.01,0,0,-1,-0.01,0,0.009333333333333334,1,0.01,0.01,0.009333333333333334,0,0
617,1.74,0.26,169,125.9,93.8,0.0,0.0,22.68,9.68,9.68,-3.32,9.68,9.68,0,0,13,13,3.32,13,13,0,0,0,-13,-9.68,0,0,-13,-9.68,0,67.78666666666666,13,9.68,0.7449999844779577,67.78666666666666,0,0
618,1.99,0.01,625,618.75,612.56,618.75,321.75,49.75,49.75,37.75,-0.25,-0.25,11.75,625,325,50,38,0.25,0,12,625,325,38,0,0.25,12,169,-12,-11.75,-12,350.1653333333333,25,24.75,0.99,325.1653333333333,25,13
619,1.99,0.01,1,0.99,0.98,0.0,0.99,1.99,0.99,1.99,-0.01,0.99,-0.01,0,1,1,2,0.01,1,0,0,0,1,-1,-0.99,-1,1,0,0.01,1,1.0,1,0.99,0.99,1.0,0,1
620,1.99,0.01,625,618.75,612.56,0.0,618.75,49.75,24.75,49.75,-0.25,24.75,-0.25,0,625,25,50,0.25,25,0,0,0,25,-25,-24.75,-25,625,0,0.25,25,328.106,25,24.75,0.99,328.106,0,25
621,1.99,0.01,1,0.99,0.98,0.0,0.0,1.99,0.99,0.99,-0.01,0.99,0.99,0,0,1,1,0.01,1,1,0,0,0,-1,-0.99,0,0,-1,-0.99,0,0.9913333333333333,1,0.99,0.99,0.9913333333333333,0,0
622,1.99,0.01,144,142.56,141.13,297.0,297.0,23.88,36.88,36.88,-0.12,-13.12,-13.12,300,300,37,37,0.12,-13,-13,625,625,50,13,13.12,0,625,13,13.12,0,105.14733333333334,12,11.88,0.9899999993972133,80.14733333333334,25,25
623,1.99,0.01,4,3.96,3.92,0.0,0.0,3.98,1.98,1.98,-0.02,1.98,1.98,0,0,2,2,0.02,2,2,0,0,0,-2,-1.98,0,0,-2,-1.98,0,2.970666666666667,2,1.98,0.99,2.970666666666667,0,0
624,1.99,0.01,169,167.31,165.64,0.0,321.75,25.87,12.87,37.87,-0.13,12.87,-12.13,0,325,13,38,0.13,13,-12,0,0,25,-13,-12.87,-25,625,12,12.13,25,93.42933333333333,13,12.87,0.99,93.42933333333333,0,25
625,1.01,0.99,1,0.01,0.0,0.0,0.25,1.01,0.01,25.01,-0.99,0.01,-24.99,0,25,1,26,0.99,1,-24,0,0,25,-1,-0.01,-25,625,24,24.99,25,24.76,1,0.01,0.01,24.76,0,25
626,1.01,0.99,625,6.25,0.06,0.0,0.0,25.25,0.25,0.25,-24.75,0.25,0.25,0,0,25,25,24.75,25,25,0,0,0,-25,-0.25,0,0,-25,-0.25,0,3.514,25,0.25,0.01,3.514,0,0
627,1.99,0.01,625,618.75,612.56,618.75,0.0,49.75,49.75,24.75,-0.25,-0.25,24.75,625,0,50,25,0.25,0,25,625,0,25,0,0.25,25,0,-25,-24.75,-25,346.538,25,24.75,0.99,321.538,25,0
628,1.99,0.01,625,618.75,612.56,0.0,0.0,49.75,24.75,24.75,-0.25,24.75,24.75,0,0,25,25,0.25,25,25,0,0,0,-25,-24.75,0,0,-25,-24.75,0,322.034,25,24.75,0.99,322.034,0,0
629,1.01,0.99,169,1.69,0.02,3.25,3.25,13.13,25.13,25.13,-12.87,-24.87,-24.87,325,325,38,38,12.87,-12,-12,625,625,50,12,24.87,0,625,12,24.87,0,347.4153333333333,13,0.13,0.01,322.4153333333333,25,25
630,1.99,0.01,625,618.75,612.56,618.75,0.0,49.75,49.75,24.75,-0.25,-0.25,24.75,625,0,50,25,0.25,0,25,625,0,25,0,0.25,25,0,-25,-24.75,-25,346.692,25,24.75,0.99,321.692,25,0
631,1.01,0.99,625,6.25,0.06,0.0,6.25,25.25,0.25,25.25,-24.75,0.25,-24.75,0,625,25,50,24.75,25,0,0,0,25,-25,-0.25,-25,625,0,24.75,25,621.5613333333333,25,0.25,0.01,621.5613333333333,0,25
632,1.99,0.01,625,618.75,612.56,0.0,0.0,49.75,24.75,24.75,-0.25,24.75,24.75,0,0,25,25,0.25,25,25,0,0,0,-25,-24.75,0,0,-25,-24.75,0,321.77933333333334,25,24.75,0.99,321.77933333333334,0,0
633,1.99,0.01,625,618.75,612.56,618.75,618.75,49.75,49.75,49.75,-0.25,-0.25,-0.25,625,625,50,50,0.25,0,0,625,625,50,0,0.25,0,625,0,0.25,0,352.82,25,24.75,0.99,327.82,25,25
634,1.99,0.01,625,618.75,612.56,618.75,297.0,49.75,49.75,36.75,-0.25,-0.25,12.75,625,300,50,37,0.25,0,13,625,300,37,0,0.25,13,144,-13,-12.75,-13,349.552,25,24.75,0.99,324.552,25,12
635,1.99,0.01,625,618.75,612.56,0.0,618.75,49.75,24.75,49.75,-0.25,24.75,-0.25,0,625,25,50,0.25,25,0,0,0,25,-25,-24.75,-25,625,0,0.25,25,327.94466666666665,25,24.75,0.99,327.94466666666665,0,25
636,1.99,0.01,169,167.31,165.64,0.0,321.75,25.87,12.87,37.87,-0.13,12.87,-12.13,0,325,13,38,0.13,13,-12,0,0,25,-13,-12.87,-25,625,12,12.13,25,93.68733333333333,13,12.87,0.99,93.68733333333333,0,25
637,1.99,0.01,1,0.99,0.98,0.0,0.99,1.99,0.99,1.99,-0.01,0.99,-0.01,0,1,1,2,0.01,1,0,0,0,1,-1,-0.99,-1,1,0,0.01,1,1.0,1,0.99,0.99,1.0,0,1
638,1.99,0.01,1,0.99,0.98,0.0,0.0,1.99,0.99,0.99,-0.01,0.99,0.99,0,0,1,1,0.01,1,1,0,0,0,-1,-0.99,0,0,-1,-0.99,0,0.994,1,0.99,0.99,0.994,0,0
639,1.01,0.99,1,0.01,0.0,0.24,0.25,1.01,24.01,25.01,-0.99,-23.99,-24.99,24,25,25,26,0.99,-23,-24,576,600,49,23,23.99,-1,625,24,24.99,1,48.792,1,0.01,0.01,24.792,24,25
640,1.99,0.01,4,3.96,3.92,0.0,0.0,3.98,1.98,1.98,-0.02,1.98,1.98,0,0,2,2,0.02,2,2,0,0,0,-2,-1.98,0,0,-2,-1.98,0,2.974,2,1.98,0.99,2.974,0,0
641,1.01,0.99,1,0.01,0.0,0.0,0.0,1.01,0.01,0.01,-0.99,0.01,0.01,0,0,1,1,0.99,1,1,0,0,0,-1,-0.01,0,0,-1,-0.01,0,0.014,1,0.01,0.01,0.014,0,0
642,1.01,0.99,169,1.69,0.02,0.0,0.0,13.13,0.13,0.13,-12.87,0.13,0.13,0,0,13,13,12.87,13,13,0,0,0,-13,-0.13,0,0,-13,-0.13,0,0.8026666666666666,13,0.13,0.01,0.8026666666666666,0,0
643,1.99,0.01,1,0.99,0.98,0.0,0.99,1.99,0.99,1.99,-0.01,0.99,-0.01,0,1,1,2,0.01,1,0,0,0,1,-1,-0.99,-1,1,0,0.01,1,1.0,1,0.99,0.99,1.0,0,1
644,1.01,0.99,4,0.04,0.0,0.0,0.0,2.02,0.02,0.02,-1.98,0.02,0.02,0,0,2,2,1.98,2,2,0,0,0,-2,-0.02,0,0,-2,-0.02,0,0.03133333333333333,2,0.02,0.01,0.03133333333333333,0,0
645,1.99,0.01,1,0.99,0.98,0.0,0.0,1.99,0.99,0.99,-0.01,0.99,0.99,0,0,1,1,0.01,1,1,0,0,0,-1,-0.99,0,0,-1,-0.99,0,0.9873333333333333,1,0.99,0.99,0.9873333333333333,0,0
646,1.01,0.99,169,1.69,0.02,0.0,0.0,13.13,0.13,0.13,-12.87,0.13,0.13,0,0,13,13,12.87,13,13,0,0,0,-13,-0.13,0,0,-13,-0.13,0,0.8473333333333334,13,0.13,0.01,0.8473333333333334,0,0
647,1.01,0.99,1,0.01,0.0,0.25,0.25,1.01,25.01,25.01,-0.99,-24.99,-24.99,25,25,26,26,0.99,-24,-24,625,625,50,24,24.99,0,625,24,24.99,0,49.696,1,0.01,0.01,24.695999999999998,25,25
648,1.99,0.01,4,3.96,3.92,0.0,0.0,3.98,1.98,1.98,-0.02,1.98,1.98,0,0,2,2,0.02,2,2,0,0,0,-2,-1.98,0,0,-2,-1.98,0,2.973333333333333,2,1.98,0.99,2.973333333333333,0,0
649,1.01,0.99,1,0.01,0.0,0.0,0.0,1.01,0.01,0.01,-0.99,0.01,0.01,0,0,1,1,0.99,1,1,0,0,0,-1,-0.01,0,0,-1,-0.01,0,0.009333333333333334,1,0.01,0.01,0.009333333333333334,0,0
650,1.74,0.26,169,125.9,93.8,0.0,0.0,22.68,9.68,9.68,-3.32,9.68,9.68,0,0,13,13,3.32,13,13,0,0,0,-13,-9.68,0,0,-13,-9.68,0,67.78666666666666,13,9.68,0.7449999844779577,67.78666666666666,0,0
651,1.99,0.01,625,618.75,612.56,618.75,321.75,49.75,49.75,37.75,-0.25,-0.25,11.75,625,325,50,38,0.25,0,12,625,325,38,0,0.25,12,169,-12,-11.75,-12,350.1653333333333,25,24.75,0.99,325.1653333333333,25,13
652,1.99,0.01,1,0.99,0.98,0.0,0.99,1.99,0.99,1.99,-0.01,0.99,-0.01,0,1,1,2,0.01,1,0,0,0,1,-1,-0.99,-1,1,0,0.01,1,1.0,1,0.99,0.99,1.0,0,1
653,1.99,0.01,625,618.75,612.56,0.0,618.75,49.75,24.75,49.75,-0.25,24.75,-0.25,0,625,25,50,0.25,25,0,0,0,25,-25,-24.75,-25,625,0,0.25,25,328.106,25,24.75,0.99,328.106,0,25
654,1.99,0.01,1,0.99,0.98,0.0,0.0,1.99,0.99,0.99,-0.01,0.99,0.99,0,0,1,1,0.01,1,1,0,0,0,-1,-0.99,0,0,-1,-0.99,0,0.9913333333333333,1,0.99,0.99,0.9913333333333333,0,0
655,1.99,0.01,144,142.56,141.13,297.0,297.0,23.88,36.88,36.88,-0.12,-13.12,-13.12,300,300,37,37,0.12,-13,-13,625,625,50,13,13.12,0,625,13,13.12,0,105.14733333333334,12,11.88,0.9899999993972133,80.14733333333334,25,25
656,1.99,0.01,4,3.96,3.92,0.0,0.0,3.98,1.98,1.98,-0.02,1.98,1.98,0,0,2,2,0.02,2,2,0,0,0,-2,-1.98,0,0,-2,-1.98,0,2.970666666666667,2,1.98,0.99,2.970666666666667,0,0
657,1.99,0.01,169,167.31,165.64,0.0,321.75,25.87,12.87,37.87,-0.13,12.87,-12.13,0,325,13,38,0.13,13,-12,0,0,25,-13,-12.87,-25,625,12,12.13,25,93.42933333333333,13,12.87,0.99,93.42933333333333,0,25
658,1.01,0.99,1,0.01,0.0,0.0,0.25,1.01,0.01,25.01,-0.99,0.01,-24.99,0,25,1,26,0.99,1,-24,0,0,25,-1,-0.01,-25,625,24,24.99,25,24.76,1,0.01,0.01,24.76,0,25
659,1.01,0.99,625,6.25,0.06,0.0,0.0,25.25,0.25,0.25,-24.75,0.25,0.25,0,0,25,25,24.75,25,25,0,0,0,-25,-0.25,0,0,-25,-0.25,0,3.514,25,0.25,0.01,3.514,0,0
660,1.99,0.01,625,618.75,612.56,618.75,0.0,49.75,49.75,24.75,-0.25,-0.25,24.75,625,0,50,25,0.25,0,25,625,0,25,0,0.25,25,0,-25,-24.75,-25,346.538,25,24.75,0.99,321.538,25,0
661,1.99,0.01,625,618.75,612.56,0.0,0.0,49.75,24.75,24.75,-0.25,24.75,24.75,0,0,25,25,0.25,25,25,0,0,0,-25,-24.75,0,0,-25,-24.75,0,322.034,25,24.75,0.99,322.034,0,0
662,1.01,0.99,169,1.69,0.02,3.25,3.25,13.13,25.13,25.13,-12.87,-24.87,-24.87,325,325,38,38,12.87,-12,-12,625,625,50,12,24.87,0,625,12,24.87,0,347.4153333333333,13,0.13,0.01,322.4153333333333,25,25
663,1.99,0.01,625,618.75,612.56,618.75,0.0,49.75,49.75,24.75,-0.25,-0.25,24.75,625,0,50,25,0.25,0,25,625,0,25,0,0.25,25,0,-25,-24.75,-25,346.692,25,24.75,0.99,321.692,25,0
664,1.01,0.99,625,6.25,0.06,0.0,6.25,25.25,0.25,25.25,-24.75,0.25,-24.75,0,625,25,50,24.75,25,0,0,0,25,-25,-0.25,-25,625,0,24.75,25,621.5613333333333,25,0.25,0.01,621.5613333333333,0,25
665,1.99,0.01,625,618.75,612.56,0.0,0.0,49.75,24.75,24.75,-0.25,24.75,24.75,0,0,25,25,0.25,25,25,0,0,0,-25,-24.75,0,0,-25,-24.75,0,321.77933333333334,25,24.75,0.99,321.77933333333334,0,0
666,1.99,0.01,625,618.75,612.56,618.75,618.75,49.75,49.75,49.75,-0.25,-0.25,-0.25,625,625,50,50,0.25,0,0,625,625,50,0,0.25,0,625,0,0.25,0,352.82,25,24.75,0.99,327.82,25,25
667,1.99,0.01,625,618.75,612.56,618.75,297.0,49.75,49.75,36.75,-0.25,-0.25,12.75,625,300,50,37,0.25,0,13,625,300,37,0,0.25,13,144,-13,-12.75,-13,349.552,25,24.75,0.99,324.552,25,12
668,1.99,0.01,625,618.75,612.56,0.0,618.75,49.75,24.75,49.75,-0.25,24.75,-0.25,0,625,25,50,0.25,25,0,0,0,25,-25,-24.75,-25,625,0,0.25,25,327.94466666666665,25,24.75,0.99,327.94466666666665,0,25
669,1.99,0.01,169,167.31,165.64,0.0,321.75,25.87,12.87,37.87,-0.13,12.87,-12.13,0,325,13,38,0.13,13,-12,0,0,25,-13,-12.87,-25,625,12,12.13,25,93.68733333333333,13,12.87,0.99,93.68733333333333,0,25
670,1.99,0.01,1,0.99,0.98,0.0,0.99,1.99,0.99,1.99,-0.01,0.99,-0.01,0,1,1,2,0.01,1,0,0,0,1,-1,-0.99,-1,1,0,0.01,1,1.0,1,0.99,0.99,1.0,0,1
671,1.99,0.01,1,0.99,0.98,0.0,0.0,1.99,0.99,0.99,-0.01,0.99,0.99,0,0,1,1,0.01,1,1,0,0,0,-1,-0.99,0,0,-1,-0.99,0,0.994,1,0.99,0.99,0.994,0,0
672,1.01,0.99,1,0.01,0.0,0.24,0.25,1.01,24.01,25.01,-0.99,-23.99,-24.99,24,25,25,26,0.99,-23,-24,576,600,49,23,23.99,-1,625,24,24.99,1,48.792,1,0.01,0.01,24.792,24,25
673,1.99,0.01,4,3.96,3.92,0.0,0.0,3.98,1.98,1.98,-0.02,1.98,1.98,0,0,2,2,0.02,2,2,0,0,0,-2,-1.98,0,0,-2,-1.98,0,2.974,2,1.98,0.99,2.974,0,0
674,1.01,0.99,1,0.01,0.0,0.0,0.0,1.01,0.01,0.01,-0.99,0.01,0.01,0,0,1,1,0.99,1,1,0,0,0,-1,-0.01,0,0,-1,-0.01,0,0.014,1,0.01,0.01,0.014,0,0
675,1.01,0.99,169,1.69,0.02,0.0,0.0,13.13,0.13,0.13,-12.87,0.13,0.13,0,0,13,13,12.87,13,13,0,0,0,-13,-0.13,0,0,-13,-0.13,0,0.8026666666666666,13,0.13,0.01,0.8026666666666666,0,0
676,1.99,0.01,1,0.99,0.98,0.0,0.99,1.99,0.99,1.99,-0.01,0.99,-0.01,0,1,1,2,0.01,1,0,0,0,1,-1,-0.99,-1,1,0,0.01,1,1.0,1,0.99,0.99,1.0,0,1
677,1.01,0.99,4,0.04,0.0,0.0,0.0,2.02,0.02,0.02,-1.98,0.02,0.02,0,0,2,2,1.98,2,2,0,0,0,-2,-0.02,0,0,-2,-0.02,0,0.03133333333333333,2,0.02,0.01,0.03133333333333333,0,0
678,1.99,0.01,1,0.99,0.98,0.0,0.0,1.99,0.99,0.99,-0.01,0.99,0.99,0,0,1,1,0.01,1,1,0,0,0,-1,-0.99,0,0,-1,-0.99,0,0.9873333333333333,1,0.99,0.99,0.9873333333333333,0,0
679,1.01,0.99,169,1.69,0.02,0.0,0.0,13.13,0.13,0.13,-12.87,0.13,0.13,0,0,13,13,12.87,13,13,0,0,0,-13,-0.13,0,0,-13,-0.13,0,0.8473333333333334,13,0.13,0.01,0.8473333333333334,0,0
680,1.01,0.99,1,0.01,0.0,0.25,0.25,1.01,25.01,25.01,-0.99,-24.99,-24.99,25,25,26,26,0.99,-24,-24,625,625,50,24,24.99,0,625,24,24.99,0,49.696,1,0.01,0.01,24.695999999999998,25,25
681,1.99,0.01,4,3.96,3.92,0.0,0.0,3.98,1.98,1.98,-0.02,1.98,1.98,0,0,2,2,0.02,2,2,0,0,0,-2,-1.98,0,0,-2,-1.98,0,2.973333333333333,2,1.98,0.99,2.973333333333333,0,0
682,1.01,0.99,1,0.01,0.0,0.0,0.0,1.01,0.01,0.01,-0.99,0.01,0.01,0,0,1,1,0.99,1,1,0,0,0,-1,-0.01,0,0,-1,-0.01,0,0.009333333333333334,1,0.01,0.01,0.009333333333333334,0,0
683,1.74,0.26,169,125.9,93.8,0.0,0.0,22.68,9.68,9.68,-3.32,9.68,9.68,0,0,13,13,3.32,13,13,0,0,0,-13,-9.68,0,0,-13,-9.68,0,67.78666666666666,13,9.68,0.7449999844779577,67.78666666666666,0,0
684,1.99,0.01,625,618.75,612.56,618.75,321.75,49.75,49.75,37.75,-0.25,-0.25,11.75,625,325,50,38,0.25,0,12,625,325,38,0,0.25,12,169,-12,-11.75,-12,350.1653333333333,25,24.75,0.99,325.1653333333333,25,13
685,1.99,0.01,1,0.99,0.98,0.0,0.99,1.99,0.99,1.99,-0.01,0.99,-0.01,0,1,1,2,0.01,1,0,0,0,1,-1,-0.99,-1,1,0,0.01,1,1.0,1,0.99,0.99,1.0,0,1
686,1.99,0.01,625,618.75,612.56,0.0,618.75,49.75,24.75,49.75,-0.25,24.75,-0.25,0,625,25,50,0.25,25,0,0,0,25,-25,-24.75,-25,625,0,0.25,25,328.106,25,24.75,0.99,328.106,0,25
687,1.99,0.01,1,0.99,0.98,0.0,0.0,1.99,0.99,0.99,-0.01,0.99,0.99,0,0,1,1,0.01,1,1,0,0,0,-1,-0.99,0,0,-1,-0.99,0,0.9913333333333333,1,0.99,0.99,0.9913333333333333,0,0
688,1.99,0.01,144,142.56,141.13,297.0,297.0,23.88,36.88,36.88,-0.12,-13.12,-13.12,300,300,37,37,0.12,-13,-13,625,625,50,13,13.12,0,625,13,13.12,0,105.14733333333334,12,11.88,0.9899999993972133,80.14733333333334,25,25
689,1.99,0.01,4,3.96,3.92,0.0,0.0,3.98,1.98,1.98,-0.02,1.98,1.98,0,0,2,2,0.02,2,2,0,0,0,-2,-1.98,0,0,-2,-1.98,0,2.970666666666667,2,1.98,0.99,2.970666666666667,0,0
690,1.99,0.01,169,167.31,165.64,0.0,321.75,25.87,12.87,37.87,-0.13,12.87,-12.13,0,325,13,38,0.13,13,-12,0,0,25,-13,-12.87,-25,625,12,12.13,25,93.42933333333333,13,12.87,0.99,93.42933333333333,0,25
691,1.01,0.99,1,0.01,0.0,0.0,0.25,1.01,0.01,25.01,-0.99,0.01,-24.99,0,25,1,26,0.99,1,-24,0,0,25,-1,-0.01,-25,625,24,24.99,25,24.76,1,0.01,0.01,24.76,0,25
692,1.01,0.99,625,6.25,0.06,0.0,0.0,25.25,0.25,0.25,-24.75,0.25,0.25,0,0,25,25,24.75,25,25,0,0,0,-25,-0.25,0,0,-25,-0.25,0,3.514,25,0.25,0.01,3.514,0,0
693,1.99,0.01,625,618.75,612.56,618.75,0.0,49.75,49.75,24.75,-0.25,-0.25,24.75,625,0,50,25,0.25,0,25,625,0,25,0,0.25,25,0,-25,-24.75,-25,346.538,25,24.75,0.99,321.538,25,0
694,1.99,0.01,625,618.75,612.56,0.0,0.0,49.75,24.75,24.75,-0.25,24.75,24.75,0,0,25,25,0.25,25,25,0,0,0,-25,-24.75,0,0,-25,-24.75,0,322.034,25,24.75,0.99,322.034,0,0
695,1.01,0.99,169,1.69,0.02,3.25,3.25,13.13,25.13,25.13,-12.87,-24.87,-24.87,325,325,38,38,12.87,-12,-12,625,625,50,12,24.87,0,625,12,24.87,0,347.4153333333333,13,0.13,0.01,322.4153333333333,25,25
696,1.99,0.01,625,618.75,612.56,618.75,0.0,49.75,49.75,24.75,-0.25,-0.25,24.75,625,0,50,25,0.25,0,25,625,0,25,0,0.25,25,0,-25,-24.75,-25,346.692,25,24.75,0.99,321.692,25,0
697,1.01,0.99,625,6.25,0.06,0.0,6.25,25.25,0.25,25.25,-24.75,0.25,-24.75,0,625,25,50,24.75,25,0,0,0,25,-25,-0.25,-25,625,0,24.75,25,621.5613333333333,25,0.25,0.01,621.5613333333333,0,25
698,1.99,0.01,625,618.75,612.56,0.0,0.0,49.75,24.75,24.75,-0.25,24.75,24.75,0,0,25,25,0.25,25,25,0,0,0,-25,-24.75,0,0,-25,-24.75,0,321.77933333333334,25,24.75,0.99,321.77933333333334,0,0
699,1.99,0.01,625,618.75,612.56,618.75,618.75,49.75,49.75,49.75,-0.25,-0.25,-0.25,625,625,50,50,0.25,0,0,625,625,50,0,0.25,0,625,0,0.25,0,352.82,25,24.75,0.99,327.82,25,25
700,1.99,0.01,625,618.75,612.56,618.75,297.0,49.75,49.75,36.75,-0.25,-0.25,12.75,625,300,50,37,0.25,0,13,625,300,37,0,0.25,13,144,-13,-12.75,-13,349.552,25,24.75,0.99,324.552,25,12
701,1.99,0.01,625,618.75,612.56,0.0,618.75,49.75,24.75,49.75,-0.25,24.75,-0.25,0,625,25,50,0.25,25,0,0,0,25,-25,-24.75,-25,625,0,0.25,25,327.94466666666665,25,24.75,0.99,327.94466666666665,0,25
702,1.99,0.01,169,167.31,165.64,0.0,321.75,25.87,12.87,37.87,-0.13,12.87,-12.13,0,325,13,38,0.13,13,-12,0,0,25,-13,-12.87,-25,625,12,12.13,25,93.68733333333333,13,12.87,0.99,93.68733333333333,0,25
703,1.99,0.01,1,0.99,0.98,0.0,0.99,1.99,0.99,1.99,-0.01,0.99,-0.01,0,1,1,2,0.01,1,0,0,0,1,-1,-0.99,-1,1,0,0.01,1,1.0,1,0.99,0.99,1.0,0,1
704,1.99,0.01,1,0.99,0.98,0.0,0.0,1.99,0.99,0.99,-0.01,0.99,0.99,0,0,1,1,0.01,1,1,0,0,0,-1,-0.99,0,0,-1,-0.99,0,0.994,1,0.99,0.99,0.994,0,0
705,1.01,0.99,1,0.01,0.0,0.24,0.25,1.01,24.01,25.01,-0.99,-23.99,-24.99,24,25,25,26,0.99,-23,-24,576,600,49,23,23.99,-1,625,24,24.99,1,48.792,1,0.01,0.01,24.792,24,25
706,1.99,0.01,4,3.96,3.92,0.0,0.0,3.98,1.98,1.98,-0.02,1.98,1.98,0,0,2,2,0.02,2,2,0,0,0,-2,-1.98,0,0,-2,-1.98,0,2.974,2,1.98,0.99,2.974,0,0
707,1.01,0.99,1,0.01,0.0,0.0,0.0,1.01,0.01,0.01,-0.99,0.01,0.01,0,0,1,1,0.99,1,1,0,0,0,-1,-0.01,0,0,-1,-0.01,0,0.014,1,0.01,0.01,0.014,0,0
708,1.01,0.99,169,1.69,0.02,0.0,0.0,13.13,0.13,0.13,-12.87,0.13,0.13,0,0,13,13,12.87,13,13,0,0,0,-13,-0.13,0,0,-13,-0.13,0,0.8026666666666666,13,0.13,0.01,0.8026666666666666,0,0
709,1.99,0.01,1,0.99,0.98,0.0,0.99,1.99,0.99,1.99,-0.01,0.99,-0.01,0,1,1,2,0.01,1,0,0,0,1,-1,-0.99,-1,1,0,0.01,1,1.0,1,0.99,0.99,1.0,0,1
710,1.01,0.99,4,0.04,0.0,0.0,0.0,2.02,0.02,0.02,-1.98,0.02,0.02,0,0,2,2,1.98,2,2,0,0,0,-2,-0.02,0,0,-2,-0.02,0,0.03133333333333333,2,0.02,0.01,0.03133333333333333,0,0
711,1.99,0.01,1,0.99,0.98,0.0,0.0,1.99,0.99,0.99,-0.01,0.99,0.99,0,0,1,1,0.01,1,1,0,0,0,-1,-0.99,0,0,-1,-0.99,0,0.9873333333333333,1,0.99,0.99,0.9873333333333333,0,0
712,1.01,0.99,169,1.69,0.02,0.0,0.0,13.13,0.13,0.13,-12.87,0.13,0.13,0,0,13,13,12.87,13,13,0,0,0,-13,-0.13,0,0,-13,-0.13,0,0.8473333333333334,13,0.13,0.01,0.8473333333333334,0,0
713,1.01,0.99,1,0.01,0.0,0.25,0.25,1.01,25.01,25.01,-0.99,-24.99,-24.99,25,25,26,26,0.99,-24,-24,625,625,50,24,24.99,0,625,24,24.99,0,49.696,1,0.01,0.01,24.695999999999998,25,25
714,1.99,0.01,4,3.96,3.92,0.0,0.0,3.98,1.98,1.98,-0.02,1.98,1.98,0,0,2,2,0.02,2,2,0,0,0,-2,-1.98,0,0,-2,-1.98,0,2.973333333333333,2,1.98,0.99,2.973333333333333,0,0
715,1.01,0.99,1,0.01,0.0,0.0,0.0,1.01,0.01,0.01,-0.99,0.01,0.01,0,0,1,1,0.99,1,1,0,0,0,-1,-0.01,0,0,-1,-0.01,0,0.009333333333333334,1,0.01,0.01,0.009333333333333334,0,0
716,1.74,0.26,169,125.9,93.8,0.0,0.0,22.68,9.68,9.68,-3.32,9.68,9.68,0,0,13,13,3.32,13,13,0,0,0,-13,-9.68,0,0,-13,-9.68,0,67.78666666666666,13,9.68,0.7449999844779577,67.78666666666666,0,0
717,1.99,0.01,625,618.75,612.56,618.75,321.75,49.75,49.75,37.75,-0.25,-0.25,11.75,625,325,50,38,0.25,0,12,625,325,38,0,0.25,12,169,-12,-11.75,-12,350.1653333333333,25,24.75,0.99,325.1653333333333,25,13
718,1.99,0.01,1,0.99,0.98,0.0,0.99,1.99,0.99,1.99,-0.01,0.99,-0.01,0,1,1,2,0.01,1,0,0,0,1,-1,-0.99,-1,1,0,0.01,1,1.0,1,0.99,0.99,1.0,0,1
719,1.99,0.01,625,618.75,612.56,0.0,618.75,49.75,24.75,49.75,-0.25,24.75,-0.25,0,625,25,50,0.25,25,0,0,0,25,-25,-24.75,-25,625,0,0.25,25,328.106,25,24.75,0.99,328.106,0,25
720,1.99,0.01,1,0.99,0.98,0.0,0.0,1.99,0.99,0.99,-0.01,0.99,0.99,0,0,1,1,0.01,1,1,0,0,0,-1,-0.99,0,0,-1,-0.99,0,0.9913333333333333,1,0.99,0.99,0.9913333333333333,0,0
721,1.99,0.01,144,142.56,141.13,297.0,297.0,23.88,36.88,36.88,-0.12,-13.12,-13.12,300,300,37,37,0.12,-13,-13,625,625,50,13,13.12,0,625,13,13.12,0,105.14733333333334,12,11.88,0.9899999993972133,80.14733333333334,25,25
722,1.99,0.01,4,3.96,3.92,0.0,0.0,3.98,1.98,1.98,-0.02,1.98,1.98,0,0,2,2,0.02,2,2,0,0,0,-2,-1.98,0,0,-2,-1.98,0,2.970666666666667,2,1.98,0.99,2.970666666666667,0,0
723,1.99,0.01,169,167.31,165.64,0.0,321.75,25.87,12.87,37.87,-0.13,12.87,-12.13,0,325,13,38,0.13,13,-12,0,0,25,-13,-12.87,-25,625,12,12.13,25,93.42933333333333,13,12.87,0.99,93.42933333333333,0,25
724,1.01,0.99,1,0.01,0.0,0.0,0.25,1.01,0.01,25.01,-0.99,0.01,-24.99,0,25,1,26,0.99,1,-24,0,0,25,-1,-0.01,-25,625,24,24.99,25,24.76,1,0.01,0.01,24.76,0,25
725,1.01,0.99,625,6.25,0.06,0.0,0.0,25.25,0.25,0.25,-24.75,0.25,0.25,0,0,25,25,24.75,25,25,0,0,0,-25,-0.25,0,0,-25,-0.25,0,3.514,25,0.25,0.01,3.514,0,0
726,1.99,0.01,625,618.75,612.56,618.75,0.0,49.75,49.75,24.75,-0.25,-0.25,24.75,625,0,50,25,0.25,0,25,625,0,25,0,0.25,25,0,-25,-24.75,-25,346.538,25,24.75,0.99,321.538,25,0
727,1.99,0.01,625,618.75,612.56,0.0,0.0,49.75,24.75,24.75,-0.25,24.75,24.75,0,0,25,25,0.25,25,25,0,0,0,-25,-24.75,0,0,-25,-24.75,0,322.034,25,24.75,0.99,322.034,0,0
728,1.01,0.99,169,1.69,0.02,3.25,3.25,13.13,25.13,25.13,-12.87,-24.87,-24.87,325,325,38,38,12.87,-12,-12,625,625,50,12,24.87,0,625,12,24.87,0,347.4153333333333,13,0.13,0.01,322.4153333333333,25,25
729,1.99,0.01,625,618.75,612.56,618.75,0.0,49.75,49.75,24.75,-0.25,-0.25,24.75,625,0,50,25,0.25,0,25,625,0,25,0,0.25,25,0,-25,-24.75,-25,346.692,25,24.75,0.99,321.692,25,0
730,1.01,0.99,625,6.25,0.06,0.0,6.25,25.25,0.25,25.25,-24.75,0.25,-24.75,0,625,25,50,24.75,25,0,0,0,25,-25,-0.25,-25,625,0,24.75,25,621.5613333333333,25,0.25,0.01,621.5613333333333,0,25
731,1.99,0.01,625,618.75,612.56,0.0,0.0,49.75,24.75,24.75,-0.25,24.75,24.75,0,0,25,25,0.25,25,25,0,0,0,-25,-24.75,0,0,-25,-24.75,0,321.77933333333334,25,24.75,0.99,321.77933333333334,0,0
732,1.99,0.01,625,618.75,612.56,618.75,618.75,49.75,49.75,49.75,-0.25,-0.25,-0.25,625,625,50,50,0.25,0,0,625,625,50,0,0.25,0,625,0,0.25,0,352.82,25,24.75,0.99,327.82,25,25
733,1.99,0.01,625,618.75,612.56,618.75,297.0,49.75,49.75,36.75,-0.25,-0.25,12.75,625,300,50,37,0.25,0,13,625,300,37,0,0.25,13,144,-13,-12.75,-13,349.552,25,24.75,0.99,324.552,25,12
734,1.99,0.01,625,618.75,612.56,0.0,618.75,49.75,24.75,49.75,-0.25,24.75,-0.25,0,625,25,50,0.25,25,0,0,0,25,-25,-24.75,-25,625,0,0.25,25,327.94466666666665,25,24.75,0.99,327.94466666666665,0,25
735,1.99,0.01,169,167.31,165.64,0.0,321.75,25.87,12.87,37.87,-0.13,12.87,-12.13,0,325,13,38,0.13,13,-12,0,0,25,-13,-12.87,-25,625,12,12.13,25,93.68733333333333,13,12.87,0.99,93.68733333333333,0,25
736,1.99,0.01,1,0.99,0.98,0.0,0.99,1.99,0.99,1.99,-0.01,0.99,-0.01,0,1,1,2,0.01,1,0,0,0,1,-1,-0.99,-1,1,0,0.01,1,1.0,1,0.99,0.99,1.0,0,1
737,1.99,0.01,1,0.99,0.98,0.0,0.0,1.99,0.99,0.99,-0.01,0.99,0.99,0,0,1,1,0.01,1,1,0,0,0,-1,-0.99,0,0,-1,-0.99,0,0.994,1,0.99,0.99,0.994,0,0
738,1.01,0.99,1,0.01,0.0,0.24,0.25,1.01,24.01,25.01,-0.99,-23.99,-24.99,24,25,25,26,0.99,-23,-24,576,600,49,23,23.99,-1,625,24,24.99,1,48.792,1,0.01,0.01,24.792,24,25
739,1.99,0.01,4,3.96,3.92,0.0,0.0,3.98,1.98,1.98,-0.02,1.98,1.98,0,0,2,2,0.02,2,2,0,0,0,-2,-1.98,0,0,-2,-1.98,0,2.974,2,1.98,0.99,2.974,0,0
740,1.01,0.99,1,0.01,0.0,0.0,0.0,1.01,0.01,0.01,-0.99,0.01,0.01,0,0,1,1,0.99,1,1,0,0,0,-1,-0.01,0,0,-1,-0.01,0,0.014,1,0.01,0.01,0.014,0,0
741,1.01,0.99,169,1.69,0.02,0.0,0.0,13.13,0.13,0.13,-12.87,0.13,0.13,0,0,13,13,12.87,13,13,0,0,0,-13,-0.13,0,0,-13,-0.13,0,0.8026666666666666,13,0.13,0.01,0.8026666666666666,0,0
742,1.99,0.01,1,0.99,0.98,0.0,0.99,1.99,0.99,1.99,-0.01,0.99,-0.01,0,1,1,2,0.01,1,0,0,0,1,-1,-0.99,-1,1,0,0.01,1,1.0,1,0.99,0.99,1.0,0,1
743,1.01,0.99,4,0.04,0.0,0.0,0.0,2.02,0.02,0.02,-1.98,0.02,0.02,0,0,2,2,1.98,2,2,0,0,0,-2,-0.02,0,0,-2,-0.02,0,0.03133333333333333,2,0.02,0.01,0.03133333333333333,0,0
744,1.99,0.01,1,0.99,0.98,0.0,0.0,1.99,0.99,0.99,-0.01,0.99,0.99,0,0,1,1,0.01,1,1,0,0,0,-1,-0.99,0,0,-1,-0.99,0,0.9873333333333333,1,0.99,0.99,0.9873333333333333,0,0
745,1.01,0.99,169,1.69,0.02,0.0,0.0,13.13,0.13,0.13,-12.87,0.13,0.13,0,0,13,13,12.87,13,13,0,0,0,-13,-0.13,0,0,-13,-0.13,0,0.8473333333333334,13,0.13,0.01,0.8473333333333334,0,0
746,1.01,0.99,1,0.01,0.0,0.25,0.25,1.01,25.01,25.01,-0.99,-24.99,-24.99,25,25,26,26,0.99,-24,-24,625,625,50,24,24.99,0,625,24,24.99,0,49.696,1,0.01,0.01,24.695999999999998,25,25
747,1.99,0.01,4,3.96,3.92,0.0,0.0,3.98,1.98,1.98,-0.02,1.98,1.98,0,0,2,2,0.02,2,2,0,0,0,-2,-1.98,0,0,-2,-1.98,0,2.973333333333333,2,1.98,0.99,2.973333333333333,0,0
748,1.01,0.99,1,0.01,0.0,0.0,0.0,1.01,0.01,0.01,-0.99,0.01,0.01,0,0,1,1,0.99,1,1,0,0,0,-1,-0.01,0,0,-1,-0.01,0,0.009333333333333334,1,0.01,0.01,0.009333333333333334,0,0
749,1.74,0.26,169,125.9,93.8,0.0,0.0,22.68,9.68,9.68,-3.32,9.68,9.68,0,0,13,13,3.32,13,13,0,0,0,-13,-9.68,0,0,-13,-9.68,0,67.78666666666666,13,9.68,0.7449999844779577,67.78666666666666,0,0
750,1.99,0.01,625,618.75,612.56,618.75,321.75,49.75,49.75,37.75,-0.25,-0.25,11.75,625,325,50,38,0.25,0,12,625,325,38,0,0.25,12,169,-12,-11.75,-12,350.1653333333333,25,24.75,0.99,325.1653333333333,25,13
751,1.99,0.01,1,0.99,0.98,0.0,0.99,1.99,0.99,1.99,-0.01,0.99,-0.01,0,1,1,2,0.01,1,0,0,0,1,-1,-0.99,-1,1,0,0.01,1,1.0,1,0.99,0.99,1.0,0,1
752,1.99,0.01,625,618.75,612.56,0.0,618.75,49.75,24.75,49.75,-0.25,24.75,-0.25,0,625,25,50,0.25,25,0,0,0,25,-25,-24.75,-25,625,0,0.25,25,328.106,25,24.75,0.99,328.106,0,25
753,1.99,0.01,1,0.99,0.98,0.0,0.0,1.99,0.99,0.99,-0.01,0.99,0.99,0,0,1,1,0.01,1,1,0,0,0,-1,-0.99,0,0,-1,-0.99,0,0.9913333333333333,1,0.99,0.99,0.9913333333333333,0,0
754,1.99,0.01,144,142.56,141.13,297.0,297.0,23.88,36.88,36.88,-0.12,-13.12,-13.12,300,300,37,37,0.12,-13,-13,625,625,50,13,13.12,0,625,13,13.12,0,105.14733333333334,12,11.88,0.9899999993972133,80.14733333333334,25,25
755,1.99,0.01,4,3.96,3.92,0.0,0.0,3.98,1.98,1.98,-0.02,1.98,1.98,0,0,2,2,0.02,2,2,0,0,0,-2,-1.98,0,0,-2,-1.98,0,2.970666666666667,2,1.98,0.99,2.970666666666667,0,0
756,1.99,0.01,169,167.31,165.64,0.0,321.75,25.87,12.87,37.87,-0.13,12.87,-12.13,0,325,13,38,0.13,13,-12,0,0,25,-13,-12.87,-25,625,12,12.13,25,93.42933333333333,13,12.87,0.99,93.42933333333333,0,25
757,1.01,0.99,1,0.01,0.0,0.0,0.25,1.01,0.01,25.01,-0.99,0.01,-24.99,0,25,1,26,0.99,1,-24,0,0,25,-1,-0.01,-25,625,24,24.99,25,24.76,1,0.01,0.01,24.76,0,25
758,1.01,0.99,625,6.25,0.06,0.0,0.0,25.25,0.25,0.25,-24.75,0.25,0.25,0,0,25,25,24.75,25,25,0,0,0,-25,-0.25,0,0,-25,-0.25,0,3.514,25,0.25,0.01,3.514,0,0
759,1.99,0.01,625,618.75,612.56,618.75,0.0,49.75,49.75,24.75,-0.25,-0.25,24.75,625,0,50,25,0.25,0,25,625,0,25,0,0.25,25,0,-25,-24.75,-25,346.538,25,24.75,0.99,321.538,25,0
760,1.99,0.01,625,618.75,612.56,0.0,0.0,49.75,24.75,24.75,-0.25,24.75,24.75,0,0,25,25,0.25,25,25,0,0,0,-25,-24.75,0,0,-25,-24.75,0,322.034,25,24.75,0.99,322.034,0,0
761,1.01,0.99,169,1.69,0.02,3.25,3.25,13.13,25.13,25.13,-12.87,-24.87,-24.87,325,325,38,38,12.87,-12,-12,625,625,50,12,24.87,0,625,12,24.87,0,347.4153333333333,13,0.13,0.01,322.4153333333333,25,25
762,1.99,0.01,625,618.75,612.56,618.75,0.0,49.75,49.75,24.75,-0.25,-0.25,24.75,625,0,50,25,0.25,0,25,625,0,25,0,0.25,25,0,-25,-24.75,-25,346.692,25,24.75,0.99,321.692,25,0
763,1.01,0.99,625,6.25,0.06,0.0,6.25,25.25,0.25,25.25,-24.75,0.25,-24.75,0,625,25,50,24.75,25,0,0,0,25,-25,-0.25,-25,625,0,24.75,25,621.5613333333333,25,0.25,0.01,621.5613333333333,0,25
764,1.99,0.01,625,618.75,612.56,0.0,0.0,49.75,24.75,24.75,-0.25,24.75,24.75,0,0,25,25,0.25,25,25,0,0,0,-25,-24.75,0,0,-25,-24.75,0,321.77933333333334,25,24.75,0.99,321.77933333333334,0,0
765,1.99,0.01,625,618.75,612.56,618.75,618.75,49.75,49.75,49.75,-0.25,-0.25,-0.25,625,625,50,50,0.25,0,0,625,625,50,0,0.25,0,625,0,0.25,0,352.82,25,24.75,0.99,327.82,25,25
766,1.99,0.01,625,618.75,612.56,618.75,297.0,49.75,49.75,36.75,-0.25,-0.25,12.75,625,300,50,37,0.25,0,13,625,300,37,0,0.25,13,144,-13,-12.75,-13,349.552,25,24.75,0.99,324.552,25,12
767,1.99,0.01,625,618.75,612.56,0.0,618.75,49.75,24.75,49.75,-0.25,24.75,-0.25,0,625,25,50,0.25,25,0,0,0,25,-25,-24.75,-25,625,0,0.25,25,327.94466666666665,25,24.75,0.99,327.94466666666665,0,25
768,1.99,0.01,169,167.31,165.64,0.0,321.75,25.87,12.87,37.87,-0.13,12.87,-12.13,0,325,13,38,0.13,13,-12,0,0,25,-13,-12.87,-25,625,12,12.13,25,93.68733333333333,13,12.87,0.99,93.68733333333333,0,25
769,1.99,0.01,1,0.99,0.98,0.0,0.99,1.99,0.99,1.99,-0.01,0.99,-0.01,0,1,1,2,0.01,1,0,0,0,1,-1,-0.99,-1,1,0,0.01,1,1.0,1,0.99,0.99,1.0,0,1
770,1.99,0.01,1,0.99,0.98,0.0,0.0,1.99,0.99,0.99,-0.01,0.99,0.99,0,0,1,1,0.01,1,1,0,0,0,-1,-0.99,0,0,-1,-0.99,0,0.994,1,0.99,0.99,0.994,0,0
771,1.01,0.99,1,0.01,0.0,0.24,0.25,1.01,24.01,25.01,-0.99,-23.99,-24.99,24,25,25,26,0.99,-23,-24,576,600,49,23,23.99,-1,625,24,24.99,1,48.792,1,0.01,0.01,24.792,24,25
772,1.99,0.01,4,3.96,3.92,0.0,0.0,3.98,1.98,1.98,-0.02,1.98,1.98,0,0,2,2,0.02,2,2,0,0,0,-2,-1.98,0,0,-2,-1.98,0,2.974,2,1.98,0.99,2.974,0,0
773,1.01,0.99,1,0.01,0.0,0.0,0.0,1.01,0.01,0.01,-0.99,0.01,0.01,0,0,1,1,0.99,1,1,0,0,0,-1,-0.01,0,0,-1,-0.01,0,0.014,1,0.01,0.01,0.014,0,0
774,1.01,0.99,169,1.69,0.02,0.0,0.0,13.13,0.13,0.13,-12.87,0.13,0.13,0,0,13,13,12.87,13,13,0,0,0,-13,-0.13,0,0,-13,-0.13,0,0.8026666666666666,13,0.13,0.01,0.8026666666666666,0,0
775,1.99,0.01,1,0.99,0.98,0.0,0.99,1.99,0.99,1.99,-0.01,0.99,-0.01,0,1,1,2,0.01,1,0,0,0,1,-1,-0.99,-1,1,0,0.01,1,1.0,1,0.99,0.99,1.0,0,1
776,1.01,0.99,4,0.04,0.0,0.0,0.0,2.02,0.02,0.02,-1.98,0.02,0.02,0,0,2,2,1.98,2,2,0,0,0,-2,-0.02,0,0,-2,-0.02,0,0.03133333333333333,2,0.02,0.01,0.03133333333333333,0,0
777,1.99,0.01,1,0.99,0.98,0.0,0.0,1.99,0.99,0.99,-0.01,0.99,0.99,0,0,1,1,0.01,1,1,0,0,0,-1,-0.99,0,0,-1,-0.99,0,0.9873333333333333,1,0.99,0.99,0.9873333333333333,0,0
778,1.01,0.99,169,1.69,0.02,0.0,0.0,13.13,0.13,0.13,-12.87,0.13,0.13,0,0,13,13,12.87,13,13,0,0,0,-13,-0.13,0,0,-13,-0.13,0,0.8473333333333334,13,0.13,0.01,0.8473333333333334,0,0
779,1.01,0.99,1,0.01,0.0,0.25,0.25,1.01,25.01,25.01,-0.99,-24.99,-24.99,25,25,26,26,0.99,-24,-24,625,625,50,24,24.99,0,625,24,24.99,0,49.696,1,0.01,0.01,24.695999999999998,25,25
780,1.99,0.01,4,3.96,3.92,0.0,0.0,3.98,1.98,1.98,-0.02,1.98,1.98,0,0,2,2,0.02,2,2,0,0,0,-2,-1.98,0,0,-2,-1.98,0,2.973333333333333,2,1.98,0.99,2.973333333333333,0,0
781,1.01,0.99,1,0.01,0.0,0.0,0.0,1.01,0.01,0.01,-0.99,0.01,0.01,0,0,1,1,0.99,1,1,0,0,0,-1,-0.01,0,0,-1,-0.01,0,0.009333333333333334,1,0.01,0.01,0.009333333333333334,0,0
782,1.74,0.26,169,125.9,93.8,0.0,0.0,22.68,9.68,9.68,-3.32,9.68,9.68,0,0,13,13,3.32,13,13,0,0,0,-13,-9.68,0,0,-13,-9.68,0,67.78666666666666,13,9.68,0.7449999844779577,67.78666666666666,0,0
783,1.99,0.01,625,618.75,612.56,618.75,321.75,49.75,49.75,37.75,-0.25,-0.25,11.75,625,325,50,38,0.25,0,12,625,325,38,0,0.25,12,169,-12,-11.75,-12,350.1653333333333,25,24.75,0.99,325.1653333333333,25,13
784,1.99,0.01,1,0.99,0.98,0.0,0.99,1.99,0.99,1.99,-0.01,0.99,-0.01,0,1,1,2,0.01,1,0,0,0,1,-1,-0.99,-1,1,0,0.01,1,1.0,1,0.99,0.99,1.0,0,1
785,1.99,0.01,625,618.75,612.56,0.0,618.75,49.75,24.75,49.75,-0.25,24.75,-0.25,0,625,25,50,0.25,25,0,0,0,25,-25,-24.75,-25,625,0,0.25,25,328.106,25,24.75,0.99,328.106,0,25
786,1.99,0.01,1,0.99,0.98,0.0,0.0,1.99,0.99,0.99,-0.01,0.99,0.99,0,0,1,1,0.01,1,1,0,0,0,-1,-0.99,0,0,-1,-0.99,0,0.9913333333333333,1,0.99,0.99,0.9913333333333333,0,0
787,1.99,0.01,144,142.56,141.13,297.0,297.0,23.88,36.88,36.88,-0.12,-13.12,-13.12,300,300,37,37,0.12,-13,-13,625,625,50,13,13.12,0,625,13,13.12,0,105.14733333333334,12,11.88,0.9899999993972133,80.14733333333334,25,25
788,1.99,0.01,4,3.96,3.92,0.0,0.0,3.98,1.98,1.98,-0.02,1.98,1.98,0,0,2,2,0.02,2,2,0,0,0,-2,-1.98,0,0,-2,-1.98,0,2.970666666666667,2,1.98,0.99,2.970666666666667,0,0
789,1.99,0.01,169,167.31,165.64,0.0,321.75,25.87,12.87,37.87,-0.13,12.87,-12.13,0,325,13,38,0.13,13,-12,0,0,25,-13,-12.87,-25,625,12,12.13,25,93.42933333333333,13,12.87,0.99,93.42933333333333,0,25
790,1.01,0.99,1,0.01,0.0,0.0,0.25,1.01,0.01,25.01,-0.99,0.01,-24.99,0,25,1,26,0.99,1,-24,0,0,25,-1,-0.01,-25,625,24,24.99,25,24.76,1,0.01,0.01,24.76,0,25
791,1.01,0.99,625,6.25,0.06,0.0,0.0,25.25,0.25,0.25,-24.75,0.25,0.25,0,0,25,25,24.75,25,25,0,0,0,-25,-0.25,0,0,-25,-0.25,0,3.514,25,0.25,0.01,3.514,0,0
792,1.99,0.01,625,618.75,612.56,618.75,0.0,49.75,49.75,24.75,-0.25,-0.25,24.75,625,0,50,25,0.25,0,25,625,0,25,0,0.25,25,0,-25,-24.75,-25,346.538,25,24.75,0.99,321.538,25,0
793,1.99,0.01,625,618.75,612.56,0.0,0.0,49.75,24.75,24.75,-0.25,24.75,24.75,0,0,25,25,0.25,25,25,0,0,0,-25,-24.75,0,0,-25,-24.75,0,322.034,25,24.75,0.99,322.034,0,0
794,1.01,0.99,169,1.69,0.02,3.25,3.25,13.13,25.13,25.13,-12.87,-24.87,-24.87,325,325,38,38,12.87,-12,-12,625,625,50,12,24.87,0,625,12,24.87,0,347.4153333333333,13,0.13,0.01,322.4153333333333,25,25
795,1.99,0.01,625,618.75,612.56,618.75,0.0,49.75,49.75,24.75,-0.25,-0.25,24.75,625,0,50,25,0.25,0,25,625,0,25,0,0.25,25,0,-25,-24.75,-25,346.692,25,24.75,0.99,321.692,25,0
796,1.01,0.99,625,6.25,0.06,0.0,6.25,25.25,0.25,25.25,-24.75,0.25,-24.75,0,625,25,50,24.75,25,0,0,0,25,-25,-0.25,-25,625,0,24.75,25,621.5613333333333,25,0.25,0.01,621.5613333333333,0,25
797,1.99,0.01,625,618.75,612.56,0.0,0.0,49.75,24.75,24.75,-0.25,24.75,24.75,0,0,25,25,0.25,25,25,0,0,0,-25,-24.75,0,0,-25,-24.75,0,321.77933333333334,25,24.75,0.99,321.77933333333334,0,0
798,1.99,0.01,625,618.75,612.56,618.75,618.75,49.75,49.75,49.75,-0.25,-0.25,-0.25,625,625,50,50,0.25,0,0,625,625,50,0,0.25,0,625,0,0.25,0,352.82,25,24.75,0.99,327.82,25,25
799,1.99,0.01,625,618.75,612.56,618.75,297.0,49.75,49.75,36.75,-0.25,-0.25,12.75,625,300,50,37,0.25,0,13,625,300,37,0,0.25,13,144,-13,-12.75,-13,349.552,25,24.75,0.99,324.552,25,12
800,1.99,0.01,625,618.75,612.56,0.0,618.75,49.75,24.75,49.75,-0.25,24.75,-0.25,0,625,25,50,0.25,25,0,0,0,25,-25,-24.75,-25,625,0,0.25,25,327.94466666666665,25,24.75,0.99,327.94466666666665,0,25
801,1.99,0.01,169,167.31,165.64,0.0,321.75,25.87,12.87,37.87,-0.13,12.87,-12.13,0,325,13,38,0.13,13,-12,0,0,25,-13,-12.87,-25,625,12,12.13,25,93.68733333333333,13,12.87,0.99,93.68733333333333,0,25
802,1.99,0.01,1,0.99,0.98,0.0,0.99,1.99,0.99,1.99,-0.01,0.99,-0.01,0,1,1,2,0.01,1,0,0,0,1,-1,-0.99,-1,1,0,0.01,1,1.0,1,0.99,0.99,1.0,0,1
803,1.99,0.01,1,0.99,0.98,0.0,0.0,1.99,0.99,0.99,-0.01,0.99,0.99,0,0,1,1,0.01,1,1,0,0,0,-1,-0.99,0,0,-1,-0.99,0,0.994,1,0.99,0.99,0.994,0,0
804,1.01,0.99,1,0.01,0.0,0.24,0.25,1.01,24.01,25.01,-0.99,-23.99,-24.99,24,25,25,26,0.99,-23,-24,576,600,49,23,23.99,-1,625,24,24.99,1,48.792,1,0.01,0.01,24.792,24,25
805,1.99,0.01,4,3.96,3.92,0.0,0.0,3.98,1.98,1.98,-0.02,1.98,1.98,0,0,2,2,0.02,2,2,0,0,0,-2,-1.98,0,0,-2,-1.98,0,2.974,2,1.98,0.99,2.974,0,0
806,1.01,0.99,1,0.01,0.0,0.0,0.0,1.01,0.01,0.01,-0.99,0.01,0.01,0,0,1,1,0.99,1,1,0,0,0,-1,-0.01,0,0,-1,-0.01,0,0.014,1,0.01,0.01,0.014,0,0
807,1.01,0.99,169,1.69,0.02,0.0,0.0,13.13,0.13,0.13,-12.87,0.13,0.13,0,0,13,13,12.87,13,13,0,0,0,-13,-0.13,0,0,-13,-0.13,0,0.8026666666666666,13,0.13,0.01,0.8026666666666666,0,0
808,1.99,0.01,1,0.99,0.98,0.0,0.99,1.99,0.99,1.99,-0.01,0.99,-0.01,0,1,1,2,0.01,1,0,0,0,1,-1,-0.99,-1,1,0,0.01,1,1.0,1,0.99,0.99,1.0,0,1
809,1.01,0.99,4,0.04,0.0,0.0,0.0,2.02,0.02,0.02,-1.98,0.02,0.02,0,0,2,2,1.98,2,2,0,0,0,-2,-0.02,0,0,-2,-0.02,0,0.03133333333333333,2,0.02,0.01,0.03133333333333333,0,0
810,1.99,0.01,1,0.99,0.98,0.0,0.0,1.99,0.99,0.99,-0.01,0.99,0.99,0,0,1,1,0.01,1,1,0,0,0,-1,-0.99,0,0,-1,-0.99,0,0.9873333333333333,1,0.99,0.99,0.9873333333333333,0,0
811,1.01,0.99,169,1.69,0.02,0.0,0.0,13.13,0.13,0.13,-12.87,0.13,0.13,0,0,13,13,12.87,13,13,0,0,0,-13,-0.13,0,0,-13,-0.13,0,0.8473333333333334,13,0.13,0.01,0.8473333333333334,0,0
812,1.01,0.99,1,0.01,0.0,0.25,0.25,1.01,25.01,25.01,-0.99,-24.99,-24.99,25,25,26,26,0.99,-24,-24,625,625,50,24,24.99,0,625,24,24.99,0,49.696,1,0.01,0.01,24.695999999999998,25,25
813,1.99,0.01,4,3.96,3.92,0.0,0.0,3.98,1.98,1.98,-0.02,1.98,1.98,0,0,2,2,0.02,2,2,0,0,0,-2,-1.98,0,0,-2,-1.98,0,2.973333333333333,2,1.98,0.99,2.973333333333333,0,0
814,1.01,0.99,1,0.01,0.0,0.0,0.0,1.01,0.01,0.01,-0.99,0.01,0.01,0,0,1,1,0.99,1,1,0,0,0,-1,-0.01,0,0,-1,-0.01,0,0.009333333333333334,1,0.01,0.01,0.009333333333333334,0,0
815,1.74,0.26,169,125.9,93.8,0.0,0.0,22.68,9.68,9.68,-3.32,9.68,9.68,0,0,13,13,3.32,13,13,0,0,0,-13,-9.68,0,0,-13,-9.68,0,67.78666666666666,13,9.68,0.7449999844779577,67.78666666666666,0,0
816,1.99,0.01,625,618.75,612.56,618.75,321.75,49.75,49.75,37.75,-0.25,-0.25,11.75,625,325,50,38,0.25,0,12,625,325,38,0,0.25,12,169,-12,-11.75,-12,350.1653333333333,25,24.75,0.99,325.1653333333333,25,13
817,1.99,0.01,1,0.99,0.98,0.0,0.99,1.99,0.99,1.99,-0.01,0.99,-0.01,0,1,1,2,0.01,1,0,0,0,1,-1,-0.99,-1,1,0,0.01,1,1.0,1,0.99,0.99,1.0,0,1
818,1.99,0.01,625,618.75,612.56,0.0,618.75,49.75,24.75,49.75,-0.25,24.75,-0.25,0,625,25,50,0.25,25,0,0,0,25,-25,-24.75,-25,625,0,0.25,25,328.106,25,24.75,0.99,328.106,0,25
819,1.99,0.01,1,0.99,0.98,0.0,0.0,1.99,0.99,0.99,-0.01,0.99,0.99,0,0,1,1,0.01,1,1,0,0,0,-1,-0.99,0,0,-1,-0.99,0,0.9913333333333333,1,0.99,0.99,0.9913333333333333,0,0
820,1.99,0.01,144,142.56,141.13,297.0,297.0,23.88,36.88,36.88,-0.12,-13.12,-13.12,300,300,37,37,0.12,-13,-13,625,625,50,13,13.12,0,625,13,13.12,0,105.14733333333334,12,11.88,0.9899999993972133,80.14733333333334,25,25
821,1.99,0.01,4,3.96,3.92,0.0,0.0,3.98,1.98,1.98,-0.02,1.98,1.98,0,0,2,2,0.02,2,2,0,0,0,-2,-1.98,0,0,-2,-1.98,0,2.970666666666667,2,1.98,0.99,2.970666666666667,0,0
822,1.99,0.01,169,167.31,165.64,0.0,321.75,25.87,12.87,37.87,-0.13,12.87,-12.13,0,325,13,38,0.13,13,-12,0,0,25,-13,-12.87,-25,625,12,12.13,25,93.42933333333333,13,12.87,0.99,93.42933333333333,0,25
823,1.01,0.99,1,0.01,0.0,0.0,0.25,1.01,0.01,25.01,-0.99,0.01,-24.99,0,25,1,26,0.99,1,-24,0,0,25,-1,-0.01,-25,625,24,24.99,25,24.76,1,0.01,0.01,24.76,0,25
824,1.01,0.99,625,6.25,0.06,0.0,0.0,25.25,0.25,0.25,-24.75,0.25,0.25,0,0,25,25,24.75,25,25,0,0,0,-25,-0.25,0,0,-25,-0.25,0,3.514,25,0.25,0.01,3.514,0,0
825,1.99,0.01,625,618.75,612.56,618.75,0.0,49.75,49.75,24.75,-0.25,-0.25,24.75,625,0,50,25,0.25,0,25,625,0,25,0,0.25,25,0,-25,-24.75,-25,346.538,25,24.75,0.99,321.538,25,0
826,1.99,0.01,625,618.75,612.56,0.0,0.0,49.75,24.75,24.75,-0.25,24.75,24.75,0,0,25,25,0.25,25,25,0,0,0,-25,-24.75,0,0,-25,-24.75,0,322.034,25,24.75,0.99,322.034,0,0
827,1.01,0.99,169,1.69,0.02,3.25,3.25,13.13,25.13,25.13,-12.87,-24.87,-24.87,325,325,38,38,12.87,-12,-12,625,625,50,12,24.87,0,625,12,24.87,0,347.4153333333333,13,0.13,0.01,322.4153333333333,25,25
828,1.99,0.01,625,618.75,612.56,618.75,0.0,49.75,49.75,24.75,-0.25,-0.25,24.75,625,0,50,25,0.25,0,25,625,0,25,0,0.25,25,0,-25,-24.75,-25,346.692,25,24.75,0.99,321.692,25,0
829,1.01,0.99,625,6.25,0.06,0.0,6.25,25.25,0.25,25.25,-24.75,0.25,-24.75,0,625,25,50,24.75,25,0,0,0,25,-25,-0.25,-25,625,0,24.75,25,621.5613333333333,25,0.25,0.01,621.5613333333333,0,25
830,1.99,0.01,625,618.75,612.56,0.0,0.0,49.75,24.75,24.75,-0.25,24.75,24.75,0,0,25,25,0.25,25,25,0,0,0,-25,-24.75,0,0,-25,-24.75,0,321.77933333333334,25,24.75,0.99,321.77933333333334,0,0
831,1.99,0.01,625,618.75,612.56,618.75,618.75,49.75,49.75,49.75,-0.25,-0.25,-0.25,625,625,50,50,0.25,0,0,625,625,50,0,0.25,0,625,0,0.25,0,352.82,25,24.75,0.99,327.82,25,25
832,1.99,0.01,625,618.75,612.56,618.75,297.0,49.75,49.75,36.75,-0.25,-0.25,12.75,625,300,50,37,0.25,0,13,625,300,37,0,0.25,13,144,-13,-12.75,-13,349.552,25,24.75,0.99,324.552,25,12
833,1.99,0.01,625,618.75,612.56,0.0,618.75,49.75,24.75,49.75,-0.25,24.75,-0.25,0,625,25,50,0.25,25,0,0,0,25,-25,-24.75,-25,625,0,0.25,25,327.94466666666665,25,24.75,0.99,327.94466666666665,0,25
834,1.99,0.01,169,167.31,165.64,0.0,321.75,25.87,12.87,37.87,-0.13,12.87,-12.13,0,325,13,38,0.13,13,-12,0,0,25,-13,-12.87,-25,625,12,12.13,25,93.68733333333333,13,12.87,0.99,93.68733333333333,0,25
835,1.99,0.01,1,0.99,0.98,0.0,0.99,1.99,0.99,1.99,-0.01,0.99,-0.01,0,1,1,2,0.01,1,0,0,0,1,-1,-0.99,-1,1,0,0.01,1,1.0,1,0.99,0.99,1.0,0,1
836,1.99,0.01,1,0.99,0.98,0.0,0.0,1.99,0.99,0.99,-0.01,0.99,0.99,0,0,1,1,0.01,1,1,0,0,0,-1,-0.99,0,0,-1,-0.99,0,0.994,1,0.99,0.99,0.994,0,0
837,1.01,0.99,1,0.01,0.0,0.24,0.25,1.01,24.01,25.01,-0.99,-23.99,-24.99,24,25,25,26,0.99,-23,-24,576,600,49,23,23.99,-1,625,24,24.99,1,48.792,1,0.01,0.01,24.792,24,25
838,1.99,0.01,4,3.96,3.92,0.0,0.0,3.98,1.98,1.98,-0.02,1.98,1.98,0,0,2,2,0.02,2,2,0,0,0,-2,-1.98,0,0,-2,-1.98,0,2.974,2,1.98,0.99,2.974,0,0
839,1.01,0.99,1,0.01,0.0,0.0,0.0,1.01,0.01,0.01,-0.99,0.01,0.01,0,0,1,1,0.99,1,1,0,0,0,-1,-0.01,0,0,-1,-0.01,0,0.014,1,0.01,0.01,0.014,0,0
840,1.01,0.99,169,1.69,0.02,0.0,0.0,13.13,0.13,0.13,-12.87,0.13,0.13,0,0,13,13,12.87,13,13,0,0,0,-13,-0.13,0,0,-13,-0.13,0,0.8026666666666666,13,0.13,0.01,0.8026666666666666,0,0
841,1.99,0.01,1,0.99,0.98,0.0,0.99,1.99,0.99,1.99,-0.01,0.99,-0.01,0,1,1,2,0.01,1,0,0,0,1,-1,-0.99,-1,1,0,0.01,1,1.0,1,0.99,0.99,1.0,0,1
842,1.01,0.99,4,0.04,0.0,0.0,0.0,2.02,0.02,0.02,-1.98,0.02,0.02,0,0,2,2,1.98,2,2,0,0,0,-2,-0.02,0,0,-2,-0.02,0,0.03133333333333333,2,0.02,0.01,0.03133333333333333,0,0
843,1.99,0.01,1,0.99,0.98,0.0,0.0,1.99,0.99,0.99,-0.01,0.99,0.99,0,0,1,1,0.01,1,1,0,0,0,-1,-0.99,0,0,-1,-0.99,0,0.9873333333333333,1,0.99,0.99,0.9873333333333333,0,0
844,1.01,0.99,169,1.69,0.02,0.0,0.0,13.13,0.13,0.13,-12.87,0.13,0.13,0,0,13,13,12.87,13,13,0,0,0,-13,-0.13,0,0,-13,-0.13,0,0.8473333333333334,13,0.13,0.01,0.8473333333333334,0,0
845,1.01,0.99,1,0.01,0.0,0.25,0.25,1.01,25.01,25.01,-0.99,-24.99,-24.99,25,25,26,26,0.99,-24,-24,625,625,50,24,24.99,0,625,24,24.99,0,49.696,1,0.01,0.01,24.695999999999998,25,25
846,1.99,0.01,4,3.96,3.92,0.0,0.0,3.98,1.98,1.98,-0.02,1.98,1.98,0,0,2,2,0.02,2,2,0,0,0,-2,-1.98,0,0,-2,-1.98,0,2.973333333333333,2,1.98,0.99,2.973333333333333,0,0
847,1.01,0.99,1,0.01,0.0,0.0,0.0,1.01,0.01,0.01,-0.99,0.01,0.01,0,0,1,1,0.99,1,1,0,0,0,-1,-0.01,0,0,-1,-0.01,0,0.009333333333333334,1,0.01,0.01,0.009333333333333334,0,0
848,1.74,0.26,169,125.9,93.8,0.0,0.0,22.68,9.68,9.68,-3.32,9.68,9.68,0,0,13,13,3.32,13,13,0,0,0,-13,-9.68,0,0,-13,-9.68,0,67.78666666666666,13,9.68,0.7449999844779577,67.78666666666666,0,0
849,1.99,0.01,625,618.75,612.56,618.75,321.75,49.75,49.75,37.75,-0.25,-0.25,11.75,625,325,50,38,0.25,0,12,625,325,38,0,0.25,12,169,-12,-11.75,-12,350.1653333333333,25,24.75,0.99,325.1653333333333,25,13
850,1.99,0.01,1,0.99,0.98,0.0,0.99,1.99,0.99,1.99,-0.01,0.99,-0.01,0,1,1,2,0.01,1,0,0,0,1,-1,-0.99,-1,1,0,0.01,1,1.0,1,0.99,0.99,1.0,0,1
851,1.99,0.01,625,618.75,612.56,0.0,618.75,49.75,24.75,49.75,-0.25,24.75,-0.25,0,625,25,50,0.25,25,0,0,0,25,-25,-24.75,-25,625,0,0.25,25,328.106,25,24.75,0.99,328.106,0,25
852,1.99,0.01,1,0.99,0.98,0.0,0.0,1.99,0.99,0.99,-0.01,0.99,0.99,0,0,1,1,0.01,1,1,0,0,0,-1,-0.99,0,0,-1,-0.99,0,0.9913333333333333,1,0.99,0.99,0.9913333333333333,0,0
853,1.99,0.01,144,142.56,141.13,297.0,297.0,23.88,36.88,36.88,-0.12,-13.12,-13.12,300,300,37,37,0.12,-13,-13,625,625,50,13,13.12,0,625,13,13.12,0,105.14733333333334,12,11.88,0.9899999993972133,80.14733333333334,25,25
854,1.99,0.01,4,3.96,3.92,0.0,0.0,3.98,1.98,1.98,-0.02,1.98,1.98,0,0,2,2,0.02,2,2,0,0,0,-2,-1.98,0,0,-2,-1.98,0,2.970666666666667,2,1.98,0.99,2.970666666666667,0,0
855,1.99,0.01,169,167.31,165.64,0.0,321.75,25.87,12.87,37.87,-0.13,12.87,-12.13,0,325,13,38,0.13,13,-12,0,0,25,-13,-12.87,-25,625,12,12.13,25,93.42933333333333,13,12.87,0.99,93.42933333333333,0,25
856,1.01,0.99,1,0.01,0.0,0.0,0.25,1.01,0.01,25.01,-0.99,0.01,-24.99,0,25,1,26,0.99,1,-24,0,0,25,-1,-0.01,-25,625,24,24.99,25,24.76,1,0.01,0.01,24.76,0,25
857,1.01,0.99,625,6.25,0.06,0.0,0.0,25.25,0.25,0.25,-24.75,0.25,0.25,0,0,25,25,24.75,25,25,0,0,0,-25,-0.25,0,0,-25,-0.25,0,3.514,25,0.25,0.01,3.514,0,0
858,1.99,0.01,625,618.75,612.56,618.75,0.0,49.75,49.75,24.75,-0.25,-0.25,24.75,625,0,50,25,0.25,0,25,625,0,25,0,0.25,25,0,-25,-24.75,-25,346.538,25,24.75,0.99,321.538,25,0
859,1.99,0.01,625,618.75,612.56,0.0,0.0,49.75,24.75,24.75,-0.25,24.75,24.75,0,0,25,25,0.25,25,25,0,0,0,-25,-24.75,0,0,-25,-24.75,0,322.034,25,24.75,0.99,322.034,0,0
860,1.01,0.99,169,1.69,0.02,3.25,3.25,13.13,25.13,25.13,-12.87,-24.87,-24.87,325,325,38,38,12.87,-12,-12,625,625,50,12,24.87,0,625,12,24.87,0,347.4153333333333,13,0.13,0.01,322.4153333333333,25,25
861,1.99,0.01,625,618.75,612.56,618.75,0.0,49.75,49.75,24.75,-0.25,-0.25,24.75,625,0,50,25,0.25,0,25,625,0,25,0,0.25,25,0,-25,-24.75,-25,346.692,25,24.75,0.99,321.692,25,0
862,1.01,0.99,625,6.25,0.06,0.0,6.25,25.25,0.25,25.25,-24.75,0.25,-24.75,0,625,25,50,24.75,25,0,0,0,25,-25,-0.25,-25,625,0,24.75,25,621.5613333333333,25,0.25,0.01,621.5613333333333,0,25
863,1.99,0.01,625,618.75,612.56,0.0,0.0,49.75,24.75,24.75,-0.25,24.75,24.75,0,0,25,25,0.25,25,25,0,0,0,-25,-24.75,0,0,-25,-24.75,0,321.77933333333334,25,24.75,0.99,321.77933333333334,0,0
864,1.99,0.01,625,618.75,612.56,618.75,618.75,49.75,49.75,49.75,-0.25,-0.25,-0.25,625,625,50,50,0.25,0,0,625,625,50,0,0.25,0,625,0,0.25,0,352.82,25,24.75,0.99,327.82,25,25
865,1.99,0.01,625,618.75,612.56,618.75,297.0,49.75,49.75,36.75,-0.25,-0.25,12.75,625,300,50,37,0.25,0,13,625,300,37,0,0.25,13,144,-13,-12.75,-13,349.552,25,24.75,0.99,324.552,25,12
866,1.99,0.01,625,618.75,612.56,0.0,618.75,49.75,24.75,49.75,-0.25,24.75,-0.25,0,625,25,50,0.25,25,0,0,0,25,-25,-24.75,-25,625,0,0.25,25,327.94466666666665,25,24.75,0.99,327.94466666666665,0,25
867,1.99,0.01,169,167.31,165.64,0.0,321.75,25.87,12.87,37.87,-0.13,12.87,-12.13,0,325,13,38,0.13,13,-12,0,0,25,-13,-12.87,-25,625,12,12.13,25,93.68733333333333,13,12.87,0.99,93.68733333333333,0,25
868,1.99,0.01,1,0.99,0.98,0.0,0.99,1.99,0.99,1.99,-0.01,0.99,-0.01,0,1,1,2,0.01,1,0,0,0,1,-1,-0.99,-1,1,0,0.01,1,1.0,1,0.99,0.99,1.0,0,1
869,1.99,0.01,1,0.99,0.98,0.0,0.0,1.99,0.99,0.99,-0.01,0.99,0.99,0,0,1,1,0.01,1,1,0,0,0,-1,-0.99,0,0,-1,-0.99,0,0.994,1,0.99,0.99,0.994,0,0
870,1.01,0.99,1,0.01,0.0,0.24,0.25,1.01,24.01,25.01,-0.99,-23.99,-24.99,24,25,25,26,0.99,-23,-24,576,600,49,23,23.99,-1,625,24,24.99,1,48.792,1,0.01,0.01,24.792,24,25
871,1.99,0.01,4,3.96,3.92,0.0,0.0,3.98,1.98,1.98,-0.02,1.98,1.98,0,0,2,2,0.02,2,2,0,0,0,-2,-1.98,0,0,-2,-1.98,0,2.974,2,1.98,0.99,2.974,0,0
872,1.01,0.99,1,0.01,0.0,0.0,0.0,1.01,0.01,0.01,-0.99,0.01,0.01,0,0,1,1,0.99,1,1,0,0,0,-1,-0.01,0,0,-1,-0.01,0,0.014,1,0.01,0.01,0.014,0,0
873,1.01,0.99,169,1.69,0.02,0.0,0.0,13.13,0.13,0.13,-12.87,0.13,0.13,0,0,13,13,12.87,13,13,0,0,0,-13,-0.13,0,0,-13,-0.13,0,0.8026666666666666,13,0.13,0.01,0.8026666666666666,0,0
874,1.99,0.01,1,0.99,0.98,0.0,0.99,1.99,0.99,1.99,-0.01,0.99,-0.01,0,1,1,2,0.01,1,0,0,0,1,-1,-0.99,-1,1,0,0.01,1,1.0,1,0.99,0.99,1.0,0,1
875,1.01,0.99,4,0.04,0.0,0.0,0.0,2.02,0.02,0.02,-1.98,0.02,0.02,0,0,2,2,1.98,2,2,0,0,0,-2,-0.02,0,0,-2,-0.02,0,0.03133333333333333,2,0.02,0.01,0.03133333333333333,0,0
876,1.99,0.01,1,0.99,0.98,0.0,0.0,1.99,0.99,0.99,-0.01,0.99,0.99,0,0,1,1,0.01,1,1,0,0,0,-1,-0.99,0,0,-1,-0.99,0,0.9873333333333333,1,0.99,0.99,0.9873333333333333,0,0
877,1.01,0.99,169,1.69,0.02,0.0,0.0,13.13,0.13,0.13,-12.87,0.13,0.13,0,0,13,13,12.87,13,13,0,0,0,-13,-0.13,0,0,-13,-0.13,0,0.8473333333333334,13,0.13,0.01,0.8473333333333334,0,0
878,1.01,0.99,1,0.01,0.0,0.25,0.25,1.01,25.01,25.01,-0.99,-24.99,-24.99,25,25,26,26,0.99,-24,-24,625,625,50,24,24.99,0,625,24,24.99,0,49.696,1,0.01,0.01,24.695999999999998,25,25
879,1.99,0.01,4,3.96,3.92,0.0,0.0,3.98,1.98,1.98,-0.02,1.98,1.98,0,0,2,2,0.02,2,2,0,0,0,-2,-1.98,0,0,-2,-1.98,0,2.973333333333333,2,1.98,0.99,2.973333333333333,0,0
880,1.01,0.99,1,0.01,0.0,0.0,0.0,1.01,0.01,0.01,-0.99,0.01,0.01,0,0,1,1,0.99,1,1,0,0,0,-1,-0.01,0,0,-1,-0.01,0,0.009333333333333334,1,0.01,0.01,0.009333333333333334,0,0
881,1.74,0.26,169,125.9,93.8,0.0,0.0,22.68,9.68,9.68,-3.32,9.68,9.68,0,0,13,13,3.32,13,13,0,0,0,-13,-9.68,0,0,-13,-9.68,0,67.78666666666666,13,9.68,0.7449999844779577,67.78666666666666,0,0
882,1.99,0.01,625,618.75,612.56,618.75,321.75,49.75,49.75,37.75,-0.25,-0.25,11.75,625,325,50,38,0.25,0,12,625,325,38,0,0.25,12,169,-12,-11.75,-12,350.1653333333333,25,24.75,0.99,325.1653333333333,25,13
883,1.99,0.01,1,0.99,0.98,0.0,0.99,1.99,0.99,1.99,-0.01,0.99,-0.01,0,1,1,2,0.01,1,0,0,0,1,-1,-0.99,-1,1,0,0.01,1,1.0,1,0.99,0.99,1.0,0,1
884,1.99,0.01,625,618.75,612.56,0.0,618.75,49.75,24.75,49.75,-0.25,24.75,-0.25,0,625,25,50,0.25,25,0,0,0,25,-25,-24.75,-25,625,0,0.25,25,328.106,25,24.75,0.99,328.106,0,25
885,1.99,0.01,1,0.99,0.98,0.0,0.0,1.99,0.99,0.99,-0.01,0.99,0.99,0,0,1,1,0.01,1,1,0,0,0,-1,-0.99,0,0,-1,-0.99,0,0.9913333333333333,1,0.99,0.99,0.9913333333333333,0,0
886,1.99,0.01,144,142.56,141.13,297.0,297.0,23.88,36.88,36.88,-0.12,-13.12,-13.12,300,300,37,37,0.12,-13,-13,625,625,50,13,13.12,0,625,13,13.12,0,105.14733333333334,12,11.88,0.9899999993972133,80.14733333333334,25,25
887,1.99,0.01,4,3.96,3.92,0.0,0.0,3.98,1.98,1.98,-0.02,1.98,1.98,0,0,2,2,0.02,2,2,0,0,0,-2,-1.98,0,0,-2,-1.98,0,2.970666666666667,2,1.98,0.99,2.970666666666667,0,0
888,1.99,0.01,169,167.31,165.64,0.0,321.75,25.87,12.87,37.87,-0.13,12.87,-12.13,0,325,13,38,0.13,13,-12,0,0,25,-13,-12.87,-25,625,12,12.13,25,93.42933333333333,13,12.87,0.99,93.42933333333333,0,25
889,1.01,0.99,1,0.01,0.0,0.0,0.25,1.01,0.01,25.01,-0.99,0.01,-24.99,0,25,1,26,0.99,1,-24,0,0,25,-1,-0.01,-25,625,24,24.99,25,24.76,1,0.01,0.01,24.76,0,25
890,1.01,0.99,625,6.25,0.06,0.0,0.0,25.25,0.25,0.25,-24.75,0.25,0.25,0,0,25,25,24.75,25,25,0,0,0,-25,-0.25,0,0,-25,-0.25,0,3.514,25,0.25,0.01,3.514,0,0
891,1.99,0.01,625,618.75,612.56,618.75,0.0,49.75,49.75,24.75,-0.25,-0.25,24.75,625,0,50,25,0.25,0,25,625,0,25,0,0.25,25,0,-25,-24.75,-25,346.538,25,24.75,0.99,321.538,25,0
892,1.99,0.01,625,618.75,612.56,0.0,0.0,49.75,24.75,24.75,-0.25,24.75,24.75,0,0,25,25,0.25,25,25,0,0,0,-25,-24.75,0,0,-25,-24.75,0,322.034,25,24.75,0.99,322.034,0,0
893,1.01,0.99,169,1.69,0.02,3.25,3.25,13.13,25.13,25.13,-12.87,-24.87,-24.87,325,325,38,38,12.87,-12,-12,625,625,50,12,24.87,0,625,12,24.87,0,347.4153333333333,13,0.13,0.01,322.4153333333333,25,25
894,1.99,0.01,625,618.75,612.56,618.75,0.0,49.75,49.75,24.75,-0.25,-0.25,24.75,625,0,50,25,0.25,0,25,625,0,25,0,0.25,25,0,-25,-24.75,-25,346.692,25,24.75,0.99,321.692,25,0
895,1.01,0.99,625,6.25,0.06,0.0,6.25,25.25,0.25,25.25,-24.75,0.25,-24.75,0,625,25,50,24.75,25,0,0,0,25,-25,-0.25,-25,625,0,24.75,25,621.5613333333333,25,0.25,0.01,621.5613333333333,0,25
896,1.99,0.01,625,618.75,612.56,0.0,0.0,49.75,24.75,24.75,-0.25,24.75,24.75,0,0,25,25,0.25,25,25,0,0,0,-25,-24.75,0,0,-25,-24.75,0,321.77933333333334,25,24.75,0.99,321.77933333333334,0,0
897,1.99,0.01,625,618.75,612.56,618.75,618.75,49.75,49.75,49.75,-0.25,-0.25,-0.25,625,625,50,50,0.25,0,0,625,625,50,0,0.25,0,625,0,0.25,0,352.82,25,24.75,0.99,327.82,25,25
898,1.99,0.01,625,618.75,612.56,618.75,297.0,49.75,49.75,36.75,-0.25,-0.25,12.75,625,300,50,37,0.25,0,13,625,300,37,0,0.25,13,144,-13,-12.75,-13,349.552,25,24.75,0.99,324.552,25,12
899,1.99,0.01,625,618.75,612.56,0.0,618.75,49.75,24.75,49.75,-0.25,24.75,-0.25,0,625,25,50,0.25,25,0,0,0,25,-25,-24.75,-25,625,0,0.25,25,327.94466666666665,25,24.75,0.99,327.94466666666665,0,25
900,1.99,0.01,169,167.31,165.64,0.0,321.75,25.87,12.87,37.87,-0.13,12.87,-12.13,0,325,13,38,0.13,13,-12,0,0,25,-13,-12.87,-25,625,12,12.13,25,93.68733333333333,13,12.87,0.99,93.68733333333333,0,25
901,1.99,0.01,1,0.99,0.98,0.0,0.99,1.99,0.99,1.99,-0.01,0.99,-0.01,0,1,1,2,0.01,1,0,0,0,1,-1,-0.99,-1,1,0,0.01,1,1.0,1,0.99,0.99,1.0,0,1
902,1.99,0.01,1,0.99,0.98,0.0,0.0,1.99,0.99,0.99,-0.01,0.99,0.99,0,0,1,1,0.01,1,1,0,0,0,-1,-0.99,0,0,-1,-0.99,0,0.994,1,0.99,0.99,0.994,0,0
903,1.01,0.99,1,0.01,0.0,0.24,0.25,1.01,24.01,25.01,-0.99,-23.99,-24.99,24,25,25,26,0.99,-23,-24,576,600,49,23,23.99,-1,625,24,24.99,1,48.792,1,0.01,0.01,24.792,24,25
904,1.99,0.01,4,3.96,3.92,0.0,0.0,3.98,1.98,1.98,-0.02,1.98,1.98,0,0,2,2,0.02,2,2,0,0,0,-2,-1.98,0,0,-2,-1.98,0,2.974,2,1.98,0.99,2.974,0,0
905,1.01,0.99,1,0.01,0.0,0.0,0.0,1.01,0.01,0.01,-0.99,0.01,0.01,0,0,1,1,0.99,1,1,0,0,0,-1,-0.01,0,0,-1,-0.01,0,0.014,1,0.01,0.01,0.014,0,0
906,1.01,0.99,169,1.69,0.02,0.0,0.0,13.13,0.13,0.13,-12.87,0.13,0.13,0,0,13,13,12.87,13,13,0,0,0,-13,-0.13,0,0,-13,-0.13,0,0.8026666666666666,13,0.13,0.01,0.8026666666666666,0,0
907,1.99,0.01,1,0.99,0.98,0.0,0.99,1.99,0.99,1.99,-0.01,0.99,-0.01,0,1,1,2,0.01,1,0,0,0,1,-1,-0.99,-1,1,0,0.01,1,1.0,1,0.99,0.99,1.0,0,1
908,1.01,0.99,4,0.04,0.0,0.0,0.0,2.02,0.02,0.02,-1.98,0.02,0.02,0,0,2,2,1.98,2,2,0,0,0,-2,-0.02,0,0,-2,-0.02,0,0.03133333333333333,2,0.02,0.01,0.03133333333333333,0,0
909,1.99,0.01,1,0.99,0.98,0.0,0.0,1.99,0.99,0.99,-0.01,0.99,0.99,0,0,1,1,0.01,1,1,0,0,0,-1,-0.99,0,0,-1,-0.99,0,0.9873333333333333,1,0.99,0.99,0.9873333333333333,0,0
910,1.01,0.99,169,1.69,0.02,0.0,0.0,13.13,0.13,0.13,-12.87,0.13,0.13,0,0,13,13,12.87,13,13,0,0,0,-13,-0.13,0,0,-13,-0.13,0,0.8473333333333334,13,0.13,0.01,0.8473333333333334,0,0
911,1.01,0.99,1,0.01,0.0,0.25,0.25,1.01,25.01,25.01,-0.99,-24.99,-24.99,25,25,26,26,0.99,-24,-24,625,625,50,24,24.99,0,625,24,24.99,0,49.696,1,0.01,0.01,24.695999999999998,25,25
912,1.99,0.01,4,3.96,3.92,0.0,0.0,3.98,1.98,1.98,-0.02,1.98,1.98,0,0,2,2,0.02,2,2,0,0,0,-2,-1.98,0,0,-2,-1.98,0,2.973333333333333,2,1.98,0.99,2.973333333333333,0,0
913,1.01,0.99,1,0.01,0.0,0.0,0.0,1.01,0.01,0.01,-0.99,0.01,0.01,0,0,1,1,0.99,1,1,0,0,0,-1,-0.01,0,0,-1,-0.01,0,0.009333333333333334,1,0.01,0.01,0.009333333333333334,0,0
914,1.74,0.26,169,125.9,93.8,0.0,0.0,22.68,9.68,9.68,-3.32,9.68,9.68,0,0,13,13,3.32,13,13,0,0,0,-13,-9.68,0,0,-13,-9.68,0,67.78666666666666,13,9.68,0.7449999844779577,67.78666666666666,0,0
915,1.99,0.01,625,618.75,612.56,618.75,321.75,49.75,49.75,37.75,-0.25,-0.25,11.75,625,325,50,38,0.25,0,12,625,325,38,0,0.25,12,169,-12,-11.75,-12,350.1653333333333,25,24.75,0.99,325.1653333333333,25,13
916,1.99,0.01,1,0.99,0.98,0.0,0.99,1.99,0.99,1.99,-0.01,0.99,-0.01,0,1,1,2,0.01,1,0,0,0,1,-1,-0.99,-1,1,0,0.01,1,1.0,1,0.99,0.99,1.0,0,1
917,1.99,0.01,625,618.75,612.56,0.0,618.75,49.75,24.75,49.75,-0.25,24.75,-0.25,0,625,25,50,0.25,25,0,0,0,25,-25,-24.75,-25,625,0,0.25,25,328.106,25,24.75,0.99,328.106,0,25
918,1.99,0.01,1,0.99,0.98,0.0,0.0,1.99,0.99,0.99,-0.01,0.99,0.99,0,0,1,1,0.01,1,1,0,0,0,-1,-0.99,0,0,-1,-0.99,0,0.9913333333333333,1,0.99,0.99,0.9913333333333333,0,0
919,1.99,0.01,144,142.56,141.13,297.0,297.0,23.88,36.88,36.88,-0.12,-13.12,-13.12,300,300,37,37,0.12,-13,-13,625,625,50,13,13.12,0,625,13,13.12,0,105.14733333333334,12,11.88,0.9899999993972133,80.14733333333334,25,25
920,1.99,0.01,4,3.96,3.92,0.0,0.0,3.98,1.98,1.98,-0.02,1.98,1.98,0,0,2,2,0.02,2,2,0,0,0,-2,-1.98,0,0,-2,-1.98,0,2.970666666666667,2,1.98,0.99,2.970666666666667,0,0
921,1.99,0.01,169,167.31,165.64,0.0,321.75,25.87,12.87,37.87,-0.13,12.87,-12.13,0,325,13,38,0.13,13,-12,0,0,25,-13,-12.87,-25,625,12,12.13,25,93.42933333333333,13,12.87,0.99,93.42933333333333,0,25
922,1.01,0.99,1,0.01,0.0,0.0,0.25,1.01,0.01,25.01,-0.99,0.01,-24.99,0,25,1,26,0.99,1,-24,0,0,25,-1,-0.01,-25,625,24,24.99,25,24.76,1,0.01,0.01,24.76,0,25
923,1.01,0.99,625,6.25,0.06,0.0,0.0,25.25,0.25,0.25,-24.75,0.25,0.25,0,0,25,25,24.75,25,25,0,0,0,-25,-0.25,0,0,-25,-0.25,0,3.514,25,0.25,0.01,3.514,0,0
924,1.99,0.01,625,618.75,612.56,618.75,0.0,49.75,49.75,24.75,-0.25,-0.25,24.75,625,0,50,25,0.25,0,25,625,0,25,0,0.25,25,0,-25,-24.75,-25,346.538,25,24.75,0.99,321.538,25,0
925,1.99,0.01,625,618.75,612.56,0.0,0.0,49.75,24.75,24.75,-0.25,24.75,24.75,0,0,25,25,0.25,25,25,0,0,0,-25,-24.75,0,0,-25,-24.75,0,322.034,25,24.75,0.99,322.034,0,0
926,1.01,0.99,169,1.69,0.02,3.25,3.25,13.13,25.13,25.13,-12.87,-24.87,-24.87,325,325,38,38,12.87,-12,-12,625,625,50,12,24.87,0,625,12,24.87,0,347.4153333333333,13,0.13,0.01,322.4153333333333,25,25
927,1.99,0.01,625,618.75,612.56,618.75,0.0,49.75,49.75,24.75,-0.25,-0.25,24.75,625,0,50,25,0.25,0,25,625,0,25,0,0.25,25,0,-25,-24.75,-25,346.692,25,24.75,0.99,321.692,25,0
928,1.01,0.99,625,6.25,0.06,0.0,6.25,25.25,0.25,25.25,-24.75,0.25,-24.75,0,625,25,50,24.75,25,0,0,0,25,-25,-0.25,-25,625,0,24.75,25,621.5613333333333,25,0.25,0.01,621.5613333333333,0,25
929,1.99,0.01,625,618.75,612.56,0.0,0.0,49.75,24.75,24.75,-0.25,24.75,24.75,0,0,25,25,0.25,25,25,0,0,0,-25,-24.75,0,0,-25,-24.75,0,321.77933333333334,25,24.75,0.99,321.77933333333334,0,0
930,1.99,0.01,625,618.75,612.56,618.75,618.75,49.75,49.75,49.75,-0.25,-0.25,-0.25,625,625,50,50,0.25,0,0,625,625,50,0,0.25,0,625,0,0.25,0,352.82,25,24.75,0.99,327.82,25,25
931,1.99,0.01,625,618.75,612.56,618.75,297.0,49.75,49.75,36.75,-0.25,-0.25,12.75,625,300,50,37,0.25,0,13,625,300,37,0,0.25,13,144,-13,-12.75,-13,349.552,25,24.75,0.99,324.552,25,12
932,1.99,0.01,625,618.75,612.56,0.0,618.75,49.75,24.75,49.75,-0.25,24.75,-0.25,0,625,25,50,0.25,25,0,0,0,25,-25,-24.75,-25,625,0,0.25,25,327.94466666666665,25,24.75,0.99,327.94466666666665,0,25
933,1.99,0.01,169,167.31,165.64,0.0,321.75,25.87,12.87,37.87,-0.13,12.87,-12.13,0,325,13,38,0.13,13,-12,0,0,25,-13,-12.87,-25,625,12,12.13,25,93.68733333333333,13,12.87,0.99,93.68733333333333,0,25
934,1.99,0.01,1,0.99,0.98,0.0,0.99,1.99,0.99,1.99,-0.01,0.99,-0.01,0,1,1,2,0.01,1,0,0,0,1,-1,-0.99,-1,1,0,0.01,1,1.0,1,0.99,0.99,1.0,0,1
935,1.99,0.01,1,0.99,0.98,0.0,0.0,1.99,0.99,0.99,-0.01,0.99,0.99,0,0,1,1,0.01,1,1,0,0,0,-1,-0.99,0,0,-1,-0.99,0,0.994,1,0.99,0.99,0.994,0,0
936,1.01,0.99,1,0.01,0.0,0.24,0.25,1.01,24.01,25.01,-0.99,-23.99,-24.99,24,25,25,26,0.99,-23,-24,576,600,49,23,23.99,-1,625,24,24.99,1,48.792,1,0.01,0.01,24.792,24,25
937,1.99,0.01,4,3.96,3.92,0.0,0.0,3.98,1.98,1.98,-0.02,1.98,1.98,0,0,2,2,0.02,2,2,0,0,0,-2,-1.98,0,0,-2,-1.98,0,2.974,2,1.98,0.99,2.974,0,0
938,1.01,0.99,1,0.01,0.0,0.0,0.0,1.01,0.01,0.01,-0.99,0.01,0.01,0,0,1,1,0.99,1,1,0,0,0,-1,-0.01,0,0,-1,-0.01,0,0.014,1,0.01,0.01,0.014,0,0
939,1.01,0.99,169,1.69,0.02,0.0,0.0,13.13,0.13,0.13,-12.87,0.13,0.13,0,0,13,13,12.87,13,13,0,0,0,-13,-0.13,0,0,-13,-0.13,0,0.8026666666666666,13,0.13,0.01,0.8026666666666666,0,0
940,1.99,0.01,1,0.99,0.98,0.0,0.99,1.99,0.99,1.99,-0.01,0.99,-0.01,0,1,1,2,0.01,1,0,0,0,1,-1,-0.99,-1,1,0,0.01,1,1.0,1,0.99,0.99,1.0,0,1
941,1.01,0.99,4,0.04,0.0,0.0,0.0,2.02,0.02,0.02,-1.98,0.02,0.02,0,0,2,2,1.98,2,2,0,0,0,-2,-0.02,0,0,-2,-0.02,0,0.03133333333333333,2,0.02,0.01,0.03133333333333333,0,0
942,1.99,0.01,1,0.99,0.98,0.0,0.0,1.99,0.99,0.99,-0.01,0.99,0.99,0,0,1,1,0.01,1,1,0,0,0,-1,-0.99,0,0,-1,-0.99,0,0.9873333333333333,1,0.99,0.99,0.9873333333333333,0,0
943,1.01,0.99,169,1.69,0.02,0.0,0.0,13.13,0.13,0.13,-12.87,0.13,0.13,0,0,13,13,12.87,13,13,0,0,0,-13,-0.13,0,0,-13,-0.13,0,0.8473333333333334,13,0.13,0.01,0.8473333333333334,0,0
944,1.01,0.99,1,0.01,0.0,0.25,0.25,1.01,25.01,25.01,-0.99,-24.99,-24.99,25,25,26,26,0.99,-24,-24,625,625,50,24,24.99,0,625,24,24.99,0,49.696,1,0.01,0.01,24.695999999999998,25,25
945,1.99,0.01,4,3.96,3.92,0.0,0.0,3.98,1.98,1.98,-0.02,1.98,1.98,0,0,2,2,0.02,2,2,0,0,0,-2,-1.98,0,0,-2,-1.98,0,2.973333333333333,2,1.98,0.99,2.973333333333333,0,0
946,1.01,0.99,1,0.01,0.0,0.0,0.0,1.01,0.01,0.01,-0.99,0.01,0.01,0,0,1,1,0.99,1,1,0,0,0,-1,-0.01,0,0,-1,-0.01,0,0.009333333333333334,1,0.01,0.01,0.009333333333333334,0,0
947,1.74,0.26,169,125.9,93.8,0.0,0.0,22.68,9.68,9.68,-3.32,9.68,9.68,0,0,13,13,3.32,13,13,0,0,0,-13,-9.68,0,0,-13,-9.68,0,67.78666666666666,13,9.68,0.7449999844779577,67.78666666666666,0,0
948,1.99,0.01,625,618.75,612.56,618.75,321.75,49.75,49.75,37.75,-0.25,-0.25,11.75,625,325,50,38,0.25,0,12,625,325,38,0,0.25,12,169,-12,-11.75,-12,350.1653333333333,25,24.75,0.99,325.1653333333333,25,13
949,1.99,0.01,1,0.99,0.98,0.0,0.99,1.99,0.99,1.99,-0.01,0.99,-0.01,0,1,1,2,0.01,1,0,0,0,1,-1,-0.99,-1,1,0,0.01,1,1.0,1,0.99,0.99,1.0,0,1
950,1.99,0.01,625,618.75,612.56,0.0,618.75,49.75,24.75,49.75,-0.25,24.75,-0.25,0,625,25,50,0.25,25,0,0,0,25,-25,-24.75,-25,625,0,0.25,25,328.106,25,24.75,0.99,328.106,0,25
951,1.99,0.01,1,0.99,0.98,0.0,0.0,1.99,0.99,0.99,-0.01,0.99,0.99,0,0,1,1,0.01,1,1,0,0,0,-1,-0.99,0,0,-1,-0.99,0,0.9913333333333333,1,0.99,0.99,0.9913333333333333,0,0
952,1.99,0.01,144,142.56,141.13,297.0,297.0,23.88,36.88,36.88,-0.12,-13.12,-13.12,300,300,37,37,0.12,-13,-13,625,625,50,13,13.12,0,625,13,13.12,0,105.14733333333334,12,11.88,0.9899999993972133,80.14733333333334,25,25
953,1.99,0.01,4,3.96,3.92,0.0,0.0,3.98,1.98,1.98,-0.02,1.98,1.98,0,0,2,2,0.02,2,2,0,0,0,-2,-1.98,0,0,-2,-1.98,0,2.970666666666667,2,1.98,0.99,2.970666666666667,0,0
954,1.99,0.01,169,167.31,165.64,0.0,321.75,25.87,12.87,37.87,-0.13,12.87,-12.13,0,325,13,38,0.13,13,-12,0,0,25,-13,-12.87,-25,625,12,12.13,25,93.42933333333333,13,12.87,0.99,93.42933333333333,0,25
955,1.01,0.99,1,0.01,0.0,0.0,0.25,1.01,0.01,25.01,-0.99,0.01,-24.99,0,25,1,26,0.99,1,-24,0,0,25,-1,-0.01,-25,625,24,24.99,25,24.76,1,0.01,0.01,24.76,0,25
956,1.01,0.99,625,6.25,0.06,0.0,0.0,25.25,0.25,0.25,-24.75,0.25,0.25,0,0,25,25,24.75,25,25,0,0,0,-25,-0.25,0,0,-25,-0.25,0,3.514,25,0.25,0.01,3.514,0,0
957,1.99,0.01,625,618.75,612.56,618.75,0.0,49.75,49.75,24.75,-0.25,-0.25,24.75,625,0,50,25,0.25,0,25,625,0,25,0,0.25,25,0,-25,-24.75,-25,346.538,25,24.75,0.99,321.538,25,0
958,1.99,0.01,625,618.75,612.56,0.0,0.0,49.75,24.75,24.75,-0.25,24.75,24.75,0,0,25,25,0.25,25,25,0,0,0,-25,-24.75,0,0,-25,-24.75,0,322.034,25,24.75,0.99,322.034,0,0
959,1.01,0.99,169,1.69,0.02,3.25,3.25,13.13,25.13,25.13,-12.87,-24.87,-24.87,325,325,38,38,12.87,-12,-12,625,625,50,12,24.87,0,625,12,24.87,0,347.4153333333333,13,0.13,0.01,322.4153333333333,25,25
960,1.99,0.01,625,618.75,612.56,618.75,0.0,49.75,49.75,24.75,-0.25,-0.25,24.75,625,0,50,25,0.25,0,25,625,0,25,0,0.25,25,0,-25,-24.75,-25,346.692,25,24.75,0.99,321.692,25,0
961,1.01,0.99,625,6.25,0.06,0.0,6.25,25.25,0.25,25.25,-24.75,0.25,-24.75,0,625,25,50,24.75,25,0,0,0,25,-25,-0.25,-25,625,0,24.75,25,621.5613333333333,25,0.25,0.01,621.5613333333333,0,25
962,1.99,0.01,625,618.75,612.56,0.0,0.0,49.75,24.75,24.75,-0.25,24.75,24.75,0,0,25,25,0.25,25,25,0,0,0,-25,-24.75,0,0,-25,-24.75,0,321.77933333333334,25,24.75,0.99,321.77933333333334,0,0
963,1.99,0.01,625,618.75,612.56,618.75,618.75,49.75,49.75,49.75,-0.25,-0.25,-0.25,625,625,50,50,0.25,0,0,625,625,50,0,0.25,0,625,0,0.25,0,352.82,25,24.75,0.99,327.82,25,25
964,1.99,0.01,625,618.75,612.56,618.75,297.0,49.75,49.75,36.75,-0.25,-0.25,12.75,625,300,50,37,0.25,0,13,625,300,37,0,0.25,13,144,-13,-12.75,-13,349.552,25,24.75,0.99,324.552,25,12
965,1.99,0.01,625,618.75,612.56,0.0,618.75,49.75,24.75,49.75,-0.25,24.75,-0.25,0,625,25,50,0.25,25,0,0,0,25,-25,-24.75,-25,625,0,0.25,25,327.94466666666665,25,24.75,0.99,327.94466666666665,0,25
966,1.99,0.01,169,167.31,165.64,0.0,321.75,25.87,12.87,37.87,-0.13,12.87,-12.13,0,325,13,38,0.13,13,-12,0,0,25,-13,-12.87,-25,625,12,12.13,25,93.68733333333333,13,12.87,0.99,93.68733333333333,0,25
967,1.99,0.01,1,0.99,0.98,0.0,0.99,1.99,0.99,1.99,-0.01,0.99,-0.01,0,1,1,2,0.01,1,0,0,0,1,-1,-0.99,-1,1,0,0.01,1,1.0,1,0.99,0.99,1.0,0,1
968,1.99,0.01,1,0.99,0.98,0.0,0.0,1.99,0.99,0.99,-0.01,0.99,0.99,0,0,1,1,0.01,1,1,0,0,0,-1,-0.99,0,0,-1,-0.99,0,0.994,1,0.99,0.99,0.994,0,0
969,1.01,0.99,1,0.01,0.0,0.24,0.25,1.01,24.01,25.01,-0.99,-23.99,-24.99,24,25,25,26,0.99,-23,-24,576,600,49,23,23.99,-1,625,24,24.99,1,48.792,1,0.01,0.01,24.792,24,25
970,1.99,0.01,4,3.96,3.92,0.0,0.0,3.98,1.98,1.98,-0.02,1.98,1.98,0,0,2,2,0.02,2,2,0,0,0,-2,-1.98,0,0,-2,-1.98,0,2.974,2,1.98,0.99,2.974,0,0
971,1.01,0.99,1,0.01,0.0,0.0,0.0,1.01,0.01,0.01,-0.99,0.01,0.01,0,0,1,1,0.99,1,1,0,0,0,-1,-0.01,0,0,-1,-0.01,0,0.014,1,0.01,0.01,0.014,0,0
972,1.01,0.99,169,1.69,0.02,0.0,0.0,13.13,0.13,0.13,-12.87,0.13,0.13,0,0,13,13,12.87,13,13,0,0,0,-13,-0.13,0,0,-13,-0.13,0,0.8026666666666666,13,0.13,0.01,0.8026666666666666,0,0
973,1.99,0.01,1,0.99,0.98,0.0,0.99,1.99,0.99,1.99,-0.01,0.99,-0.01,0,1,1,2,0.01,1,0,0,0,1,-1,-0.99,-1,1,0,0.01,1,1.0,1,0.99,0.99,1.0,0,1
974,1.01,0.99,4,0.04,0.0,0.0,0.0,2.02,0.02,0.02,-1.98,0.02,0.02,0,0,2,2,1.98,2,2,0,0,0,-2,-0.02,0,0,-2,-0.02,0,0.03133333333333333,2,0.02,0.01,0.03133333333333333,0,0
975,1.99,0.01,1,0.99,0.98,0.0,0.0,1.99,0.99,0.99,-0.01,0.99,0.99,0,0,1,1,0.01,1,1,0,0,0,-1,-0.99,0,0,-1,-0.99,0,0.9873333333333333,1,0.99,0.99,0.9873333333333333,0,0
976,1.01,0.99,169,1.69,0.02,0.0,0.0,13.13,0.13,0.13,-12.87,0.13,0.13,0,0,13,13,12.87,13,13,0,0,0,-13,-0.13,0,0,-13,-0.13,0,0.8473333333333334,13,0.13,0.01,0.8473333333333334,0,0
977,1.01,0.99,1,0.01,0.0,0.25,0.25,1.01,25.01,25.01,-0.99,-24.99,-24.99,25,25,26,26,0.99,-24,-24,625,625,50,24,24.99,0,625,24,24.99,0,49.696,1,0.01,0.01,24.695999999999998,25,25
978,1.99,0.01,4,3.96,3.92,0.0,0.0,3.98,1.98,1.98,-0.02,1.98,1.98,0,0,2,2,0.02,2,2,0,0,0,-2,-1.98,0,0,-2,-1.98,0,2.973333333333333,2,1.98,0.99,2.973333333333333,0,0
979,1.01,0.99,1,0.01,0.0,0.0,0.0,1.01,0.01,0.01,-0.99,0.01,0.01,0,0,1,1,0.99,1,1,0,0,0,-1,-0.01,0,0,-1,-0.01,0,0.009333333333333334,1,0.01,0.01,0.009333333333333334,0,0
980,1.74,0.26,169,125.9,93.8,0.0,0.0,22.68,9.68,9.68,-3.32,9.68,9.68,0,0,13,13,3.32,13,13,0,0,0,-13,-9.68,0,0,-13,-9.68,0,67.78666666666666,13,9.68,0.7449999844779577,67.78666666666666,0,0
981,1.99,0.01,625,618.75,612.56,618.75,321.75,49.75,49.75,37.75,-0.25,-0.25,11.75,625,325,50,38,0.25,0,12,625,325,38,0,0.25,12,169,-12,-11.75,-12,350.1653333333333,25,24.75,0.99,325.1653333333333,25,13
982,1.99,0.01,1,0.99,0.98,0.0,0.99,1.99,0.99,1.99,-0.01,0.99,-0.01,0,1,1,2,0.01,1,0,0,0,1,-1,-0.99,-1,1,0,0.01,1,1.0,1,0.99,0.99,1.0,0,1
983,1.99,0.01,625,618.75,612.56,0.0,618.75,49.75,24.75,49.75,-0.25,24.75,-0.25,0,625,25,50,0.25,25,0,0,0,25,-25,-24.75,-25,625,0,0.25,25,328.106,25,24.75,0.99,328.106,0,25
984,1.99,0.01,1,0.99,0.98,0.0,0.0,1.99,0.99,0.99,-0.01,0.99,0.99,0,0,1,1,0.01,1,1,0,0,0,-1,-0.99,0,0,-1,-0.99,0,0.9913333333333333,1,0.99,0.99,0.9913333333333333,0,0
985,1.99,0.01,144,142.56,141.13,297.0,297.0,23.88,36.88,36.88,-0.12,-13.12,-13.12,300,300,37,37,0.12,-13,-13,625,625,50,13,13.12,0,625,13,13.12,0,105.14733333333334,12,11.88,0.9899999993972133,80.14733333333334,25,25
986,1.99,0.01,4,3.96,3.92,0.0,0.0,3.98,1.98,1.98,-0.02,1.98,1.98,0,0,2,2,0.02,2,2,0,0,0,-2,-1.98,0,0,-2,-1.98,0,2.970666666666667,2,1.98,0.99,2.970666666666667,0,0
987,1.99,0.01,169,167.31,165.64,0.0,321.75,25.87,12.87,37.87,-0.13,12.87,-12.13,0,325,13,38,0.13,13,-12,0,0,25,-13,-12.87,-25,625,12,12.13,25,93.42933333333333,13,12.87,0.99,93.42933333333333,0,25
988,1.01,0.99,1,0.01,0.0,0.0,0.25,1.01,0.01,25.01,-0.99,0.01,-24.99,0,25,1,26,0.99,1,-24,0,0,25,-1,-0.01,-25,625,24,24.99,25,24.76,1,0.01,0.01,24.76,0,25
989,1.01,0.99,625,6.25,0.06,0.0,0.0,25.25,0.25,0.25,-24.75,0.25,0.25,0,0,25,25,24.75,25,25,0,0,0,-25,-0.25,0,0,-25,-0.25,0,3.514,25,0.25,0.01,3.514,0,0
0,1.11,0.89,25,2.75,0.3,7.7,9.35,5.55,14.55,17.55,-4.45,-13.45,-16.45,70,85,19,22,4.45,-9,-12,196,238,31,9,13.45,-3,289,12,16.45,3,91.17,5,0.55,0.11,77.17,14,17
1,1.88,0.12,1,0.88,0.77,15.84,6.16,1.88,18.88,7.88,-0.12,-17.12,-6.12,18,7,19,8,0.12,-17,-6,324,126,25,17,17.12,11,49,6,6.12,-11,19.804,1,0.88,0.88,1.8039999999999985,18,7
2,1.72,0.28,25,18.0,12.96,21.6,64.8,8.6,9.6,21.6,-1.4,-2.4,-14.4,30,90,11,23,1.4,-1,-13,36,108,24,1,2.4,-12,324,13,14.4,12,42.084,5,3.6,0.72,36.084,6,18
3,1.37,0.63,49,18.13,6.71,33.67,28.49,9.59,15.59,13.59,-4.41,-10.41,-8.41,91,77,20,18,4.41,-6,-4,169,143,24,6,10.41,2,121,4,8.41,-2,72.176,7,2.59,0.37,59.176,13,11
4,1.39,0.61,144,56.16,21.9,14.04,23.4,16.68,7.68,9.68,-7.32,1.68,-0.32,36,60,15,17,7.32,9,7,9,15,8,-9,-1.68,-2,25,-7,0.32,2,70.504,12,4.68,0.39,67.504,3,5
5,1.27,0.73,196,52.92,14.29,49.14,71.82,17.78,16.78,22.78,-10.22,-9.22,-15.22,182,266,27,33,10.22,1,-5,169,247,32,-1,9.22,-6,361,5,15.22,6,233.782,14,3.78,0.27,220.782,13,19
6,1.69,0.31,196,135.24,93.32,86.94,86.94,23.66,18.66,18.66,-4.34,0.66,0.66,126,126,23,23,4.34,5,5,81,81,18,-5,-0.66,0,81,-5,-0.66,0,120.544,14,9.66,0.69,111.544,9,9
7,1.71,0.29,169,119.99,85.19,101.53,64.61,22.23,20.23,16.23,-3.77,-1.77,2.23,143,91,24,20,3.77,2,6,121,77,18,-2,1.77,4,49,-6,-2.23,-4,101.884,13,9.23,0.71,90.884,11,7
8,1.83,0.17,225,186.75,155.0,149.4,174.3,27.45,24.45,26.45,-2.55,0.45,-1.55,180,210,27,29,2.55,3,1,144,168,26,-3,-0.45,-2,196,-1,1.55,2,146.904,15,12.45,0.83,134.904,12,14
9,1.15,0.85,361,54.15,8.12,57.0,25.65,21.85,22.85,11.85,-16.15,-17.15,-6.15,380,171,39,28,16.15,-1,10,400,180,29,1,17.15,11,81,-10,6.15,-11,193.708,19,2.85,0.15,173.708,20,9
10,1.71,0.29,36,25.56,18.15,63.9,42.6,10.26,19.26,14.26,-1.74,-10.74,-5.74,90,60,21,16,1.74,-9,-4,225,150,25,9,10.74,5,100,4,5.74,-5,47.406,6,4.26,0.71,32.406,15,10
11,1.53,0.47,225,119.25,63.2,135.15,111.3,22.95,24.95,21.95,-7.05,-9.05,-6.05,255,210,32,29,7.05,-2,1,289,238,31,2,9.05,3,196,-1,6.05,-3,178.732,15,7.95,0.53,161.732,17,14
12,1.71,0.29,81,57.51,40.83,108.63,25.56,15.39,23.39,10.39,-2.61,-10.61,2.39,153,36,26,13,2.61,-8,5,289,68,21,8,10.61,13,16,-5,-2.39,-13,59.74,9,6.39,0.71,42.74,17,4
13,1.71,0.29,25,17.75,12.6,39.05,3.55,8.55,14.55,4.55,-1.45,-7.45,2.55,55,5,16,6,1.45,-6,4,121,11,12,6,7.45,10,1,-4,-2.55,-10,23.116,5,3.55,0.71,12.116,11,1
14,1.62,0.38,9,5.58,3.46,13.02,35.34,4.86,8.86,20.86,-1.14,-5.14,-17.14,21,57,10,22,1.14,-4,-16,49,133,26,4,5.14,-12,361,16,17.14,12,31.746,3,1.86,0.62,24.746,7,19
15,1.68,0.32,4,2.72,1.85,12.24,17.68,3.36,10.36,14.36,-0.64,-7.64,-11.64,18,26,11,15,0.64,-7,-11,81,117,22,7,7.64,-4,169,11,11.64,4,19.364,2,1.36,0.68,10.364,9,13
16,1.2,0.8,4,0.8,0.16,5.2,6.0,2.4,13.4,15.4,-1.6,-12.6,-14.6,26,30,15,17,1.6,-11,-13,169,195,28,11,12.6,-2,225,13,14.6,2,38.228,2,0.4,0.2,25.228,13,15
17,1.89,0.11,144,128.16,114.06,128.16,213.6,22.68,22.68,30.68,-1.32,-1.32,-9.32,144,240,24,32,1.32,0,-8,144,240,32,0,1.32,-8,400,8,9.32,8,108.658,12,10.68,0.89,96.658,12,20
18,1.48,0.52,400,192.0,92.16,124.8,76.8,29.6,22.6,17.6,-10.4,-3.4,1.6,260,160,33,28,10.4,7,12,169,104,21,-7,3.4,5,64,-12,-1.6,-5,196.814,20,9.6,0.48,183.814,13,8
19,1.25,0.75,196,49.0,12.25,21.0,0.0,17.5,9.5,3.5,-10.5,-2.5,3.5,84,0,20,14,10.5,8,14,36,0,6,-8,2.5,6,0,-14,-3.5,-6,33.164,14,3.5,0.25,27.164,6,0
20,1.91,0.09,169,153.79,139.95,141.96,0.0,24.83,23.83,11.83,-1.17,-0.17,11.83,156,0,25,13,1.17,1,13,144,0,12,-1,0.17,12,0,-13,-11.83,-12,94.692,13,11.83,0.91,82.692,12,0
21,1.16,0.84,25,4.0,0.64,16.0,13.6,5.8,20.8,17.8,-4.2,-19.2,-16.2,100,85,25,22,4.2,-15,-12,400,340,37,15,19.2,3,289,12,16.2,-3,93.224,5,0.8,0.16,73.224,20,17
22,1.3,0.7,361,108.3,32.49,102.6,11.4,24.7,23.7,7.7,-13.3,-12.3,3.7,342,38,37,21,13.3,1,17,324,36,20,-1,12.3,16,4,-17,-3.7,-16,101.606,19,5.7,0.3,83.606,18,2
23,1.66,0.34,225,148.5,98.01,148.5,158.4,24.9,24.9,25.9,-5.1,-5.1,-6.1,225,240,30,31,5.1,0,-1,225,240,31,0,5.1,-1,256,1,6.1,1,176.626,15,9.9,0.66,161.626,15,16
24,1.09,0.91,100,9.0,0.81,0.0,8.1,10.9,0.9,9.9,-9.1,0.9,-8.1,0,90,10,19,9.1,10,1,0,0,9,-10,-0.9,-9,81,-1,8.1,9,86.806,10,0.9,0.09,86.806,0,9
25,1.77,0.23,16,12.32,9.49,43.12,55.44,7.08,17.08,21.08,-0.92,-10.92,-14.92,56,72,18,22,0.92,-10,-14,196,252,32,10,10.92,-4,324,14,14.92,4,38.138,4,3.08,0.77,24.137999999999998,14,18
26,1.45,0.55,324,145.8,65.61,113.4,40.5,26.1,22.1,13.1,-9.9,-5.9,3.1,252,90,32,23,9.9,4,13,196,70,19,-4,5.9,9,25,-13,-3.1,-9,139.998,18,8.1,0.45,125.99799999999999,14,5
27,1.54,0.46,25,13.5,7.29,29.7,5.4,7.7,13.7,4.7,-2.3,-8.3,0.7,55,10,16,7,2.3,-6,3,121,22,13,6,8.3,9,4,-3,-0.7,-9,23.866,5,2.7,0.54,12.866,11,2
28,1.45,0.55,289,130.05,58.52,122.4,91.8,24.65,23.65,19.65,-9.35,-8.35,-4.35,272,204,33,29,9.35,1,5,256,192,28,-1,8.35,4,144,-5,4.35,-4,197.358,17,7.65,0.45,181.358,16,12
29,1.92,0.08,361,332.12,305.55,244.72,297.16,36.48,31.48,34.48,-1.52,3.48,0.48,266,323,33,36,1.52,5,2,196,238,31,-5,-3.48,-3,289,-2,-0.48,3,214.84,19,17.48,0.92,200.84,14,17
30,1.29,0.71,289,83.81,24.3,24.65,59.16,21.93,9.93,16.93,-12.07,-0.07,-7.07,85,204,22,29,12.07,12,5,25,60,17,-12,0.07,-7,144,-5,7.07,7,193.484,17,4.93,0.29,188.484,5,12
31,1.75,0.25,144,108.0,81.0,63.0,99.0,21.0,16.0,20.0,-3.0,2.0,-2.0,84,132,19,23,3.0,5,1,49,77,18,-5,-2.0,-4,121,-1,2.0,4,98.882,12,9.0,0.75,91.882,7,11
32,1.6,0.4,4,2.4,1.44,9.6,4.8,3.2,9.2,5.2,-0.8,-6.8,-2.8,16,8,10,6,0.8,-6,-2,64,32,12,6,6.8,4,16,2,2.8,-4,13.052,2,1.2,0.6,5.052,8,4
33,1.59,0.41,400,236.0,139.24,35.4,11.8,31.8,14.8,12.8,-8.2,8.8,10.8,60,20,23,21,8.2,17,19,9,3,4,-17,-8.8,2,1,-19,-10.8,-2,134.064,20,11.8,0.59,131.064,3,1
34,1.23,0.77,121,27.83,6.4,27.83,0.0,13.53,13.53,2.53,-8.47,-8.47,2.53,121,0,22,11,8.47,0,11,121,0,11,0,8.47,11,0,-11,-2.53,-11,26.2,11,2.53,0.23,15.2,11,0
35,1.37,0.63,225,83.25,30.8,88.8,72.15,20.55,21.55,18.55,-9.45,-10.45,-7.45,240,195,31,28,9.45,-1,2,256,208,29,1,10.45,3,169,-2,7.45,-3,183.468,15,5.55,0.37,167.468,16,13
36,1.87,0.13,81,70.47,61.31,31.32,7.83,16.83,11.83,8.83,-1.17,3.83,6.83,36,9,13,10,1.17,5,8,16,4,5,-5,-3.83,3,1,-8,-6.83,-3,44.262,9,7.83,0.87,40.262,4,1
37,1.46,0.54,289,132.94,61.15,54.74,140.76,24.82,14.82,25.82,-9.18,0.82,-10.18,119,306,24,35,9.18,10,-1,49,126,25,-10,-0.82,-11,324,1,10.18,11,240.876,17,7.82,0.46,233.876,7,18
38,1.46,0.54,121,55.66,25.6,55.66,25.3,16.06,16.06,10.06,-5.94,-5.94,0.06,121,55,22,16,5.94,0,6,121,55,16,0,5.94,6,25,-6,-0.06,-6,71.166,11,5.06,0.46,60.166,11,5
39,1.36,0.64,4,1.44,0.52,7.2,3.6,2.72,10.72,5.72,-1.28,-9.28,-4.28,20,10,12,7,1.28,-8,-3,100,50,15,8,9.28,5,25,3,4.28,-5,17.438,2,0.72,0.36,7.437999999999999,10,5
40,1.22,0.78,289,63.58,13.99,14.96,29.92,20.74,7.74,11.74,-13.26,-0.26,-4.26,68,136,21,25,13.26,13,9,16,32,12,-13,0.26,-4,64,-9,4.26,4,143.224,17,3.74,0.22,139.224,4,8
41,1.69,0.31,25,17.25,11.9,58.65,31.05,8.45,20.45,12.45,-1.55,-13.55,-5.55,85,45,22,14,1.55,-12,-4,289,153,26,12,13.55,8,81,4,5.55,-8,41.124,5,3.45,0.69,24.124000000000002,17,9
0,1.99,0.01,625,618.75,612.56,618.75,0.0,49.75,49.75,24.75,-0.25,-0.25,24.75,625,0,50,25,0.25,0,25,625,0,25,0,0.25,25,0,-25,-24.75,-25,347.0106666666667,25,24.75,0.99,322.0106666666667,25,0
1,1.99,0.01,625,618.75,612.56,0.0,0.0,49.75,24.75,24.75,-0.25,24.75,24.75,0,0,25,25,0.25,25,25,0,0,0,-25,-24.75,0,0,-25,-24.75,0,321.75866666666667,25,24.75,0.99,321.75866666666667,0,0
2,1.99,0.01,625,618.75,612.56,618.75,618.75,49.75,49.75,49.75,-0.25,-0.25,-0.25,625,625,50,50,0.25,0,0,625,625,50,0,0.25,0,625,0,0.25,0,353.192,25,24.75,0.99,328.192,25,25
3,1.99,0.01,625,618.75,612.56,0.0,321.75,49.75,24.75,37.75,-0.25,24.75,11.75,0,325,25,38,0.25,25,12,0,0,13,-25,-24.75,-13,169,-12,-11.75,13,325.006,25,24.75,0.99,325.006,0,13
4,1.99,0.01,625,618.75,612.56,0.0,618.75,49.75,24.75,49.75,-0.25,24.75,-0.25,0,625,25,50,0.25,25,0,0,0,25,-25,-24.75,-25,625,0,0.25,25,328.1073333333333,25,24.75,0.99,328.1073333333333,0,25
5,1.99,0.01,625,618.75,612.56,0.0,321.75,49.75,24.75,37.75,-0.25,24.75,11.75,0,325,25,38,0.25,25,12,0,0,13,-25,-24.75,-13,169,-12,-11.75,13,325.0713333333333,25,24.75,0.99,325.0713333333333,0,13
6,1.01,0.99,169,1.69,0.02,3.25,3.25,13.13,25.13,25.13,-12.87,-24.87,-24.87,325,325,38,38,12.87,-12,-12,625,625,50,12,24.87,0,625,12,24.87,0,347.3813333333333,13,0.13,0.010000006329579965,322.3813333333333,25,25
7,1.99,0.01,625,618.75,612.56,618.75,321.75,49.75,49.75,37.75,-0.25,-0.25,11.75,625,325,50,38,0.25,0,12,625,325,38,0,0.25,12,169,-12,-11.75,-12,349.872,25,24.75,0.99,324.872,25,13
8,1.01,0.99,625,6.25,0.06,0.0,3.25,25.25,0.25,13.25,-24.75,0.25,-12.75,0,325,25,38,24.75,25,12,0,0,13,-25,-0.25,-13,169,-12,12.75,13,325.03133333333335,25,0.25,0.01,325.03133333333335,0,13
9,1.99,0.01,625,618.75,612.56,0.0,0.0,49.75,24.75,24.75,-0.25,24.75,24.75,0,0,25,25,0.25,25,25,0,0,0,-25,-24.75,0,0,-25,-24.75,0,321.80266666666665,25,24.75,0.99,321.80266666666665,0,0
10,1.99,0.01,1,0.99,0.98,0.0,0.99,1.99,0.99,1.99,-0.01,0.99,-0.01,0,1,1,2,0.01,1,0,0,0,1,-1,-0.99,-1,1,0,0.01,1,1.0,1,0.99,0.99,1.0,0,1
11,1.99,0.01,1,0.99,0.98,0.0,0.0,1.99,0.99,0.99,-0.01,0.99,0.99,0,0,1,1,0.01,1,1,0,0,0,-1,-0.99,0,0,-1,-0.99,0,0.99,1,0.99,0.99,0.99,0,0
12,1.01,0.99,1,0.01,0.0,0.0,0.25,1.01,0.01,25.01,-0.99,0.01,-24.99,0,25,1,26,0.99,1,-24,0,0,25,-1,-0.01,-25,625,24,24.99,25,24.792,1,0.01,0.01,24.792,0,25
13,1.99,0.01,625,618.75,612.56,0.0,618.75,49.75,24.75,49.75,-0.25,24.75,-0.25,0,625,25,50,0.25,25,0,0,0,25,-25,-24.75,-25,625,0,0.25,25,327.902,25,24.75,0.99,327.902,0,25
14,1.99,0.01,1,0.99,0.98,0.0,24.75,1.99,0.99,25.99,-0.01,0.99,-24.01,0,25,1,26,0.01,1,-24,0,0,25,-1,-0.99,-25,625,24,24.01,25,1.144,1,0.99,0.99,1.144,0,25
15,1.99,0.01,625,618.75,612.56,0.0,0.0,49.75,24.75,24.75,-0.25,24.75,24.75,0,0,25,25,0.25,25,25,0,0,0,-25,-24.75,0,0,-25,-24.75,0,322.046,25,24.75,0.99,322.046,0,0
16,1.99,0.01,1,0.99,0.98,24.75,0.0,1.99,25.99,0.99,-0.01,-24.01,0.99,25,0,26,1,0.01,-24,1,625,0,25,24,24.01,25,0,-1,-0.99,-25,25.989333333333335,1,0.99,0.99,0.9893333333333345,25,0
17,1.01,0.99,4,0.04,0.0,0.5,0.0,2.02,25.02,0.02,-1.98,-24.98,0.02,50,0,27,2,1.98,-23,2,625,0,25,23,24.98,25,0,-2,-0.02,-25,25.032,2,0.02,0.01,0.03200000000000003,25,0
18,1.99,0.01,1,0.99,0.98,0.0,0.0,1.99,0.99,0.99,-0.01,0.99,0.99,0,0,1,1,0.01,1,1,0,0,0,-1,-0.99,0,0,-1,-0.99,0,0.9886666666666667,1,0.99,0.99,0.9886666666666667,0,0
19,1.01,0.99,625,6.25,0.06,0.0,0.0,25.25,0.25,0.25,-24.75,0.25,0.25,0,0,25,25,24.75,25,25,0,0,0,-25,-0.25,0,0,-25,-0.25,0,2.9966666666666666,25,0.25,0.01,2.9966666666666666,0,0
20,1.01,0.99,196,1.96,0.02,3.5,3.5,14.14,25.14,25.14,-13.86,-24.86,-24.86,350,350,39,39,13.86,-11,-11,625,625,50,11,24.86,0,625,11,24.86,0,372.34133333333335,14,0.14,0.01,347.34133333333335,25,25
21,1.99,0.01,625,618.75,612.56,618.75,321.75,49.75,49.75,37.75,-0.25,-0.25,11.75,625,325,50,38,0.25,0,12,625,325,38,0,0.25,12,169,-12,-11.75,-12,350.08666666666664,25,24.75,0.99,325.08666666666664,25,13
22,1.01,0.99,225,2.25,0.02,3.75,3.45,15.15,25.15,23.15,-14.85,-24.85,-22.85,375,345,40,38,14.85,-10,-8,625,575,48,10,24.85,2,529,8,22.85,-2,367.71733333333333,15,0.15,0.01,342.71733333333333,25,23
23,1.99,0.01,625,618.75,612.56,618.75,321.75,49.75,49.75,37.75,-0.25,-0.25,11.75,625,325,50,38,0.25,0,12,625,325,38,0,0.25,12,169,-12,-11.75,-12,350.04133333333334,25,24.75,0.99,325.04133333333334,25,13
24,1.99,0.01,625,618.75,612.56,0.0,618.75,49.75,24.75,49.75,-0.25,24.75,-0.25,0,625,25,50,0.25,25,0,0,0,25,-25,-24.75,-25,625,0,0.25,25,328.048,25,24.75,0.99,328.048,0,25
25,1.99,0.01,196,194.04,192.1,0.0,346.5,27.86,13.86,38.86,-0.14,13.86,-11.14,0,350,14,39,0.14,14,-11,0,0,25,-14,-13.86,-25,625,11,11.14,25,107.39866666666667,14,13.86,0.99,107.39866666666667,0,25
26,1.99,0.01,625,618.75,612.56,0.0,618.75,49.75,24.75,49.75,-0.25,24.75,-0.25,0,625,25,50,0.25,25,0,0,0,25,-25,-24.75,-25,625,0,0.25,25,328.16266666666667,25,24.75,0.99,328.16266666666667,0,25
27,1.99,0.01,169,167.31,165.64,0.0,321.75,25.87,12.87,37.87,-0.13,12.87,-12.13,0,325,13,38,0.13,13,-12,0,0,25,-13,-12.87,-25,625,12,12.13,25,93.372,13,12.87,0.99,93.372,0,25
28,1.99,0.01,625,618.75,612.56,618.75,0.0,49.75,49.75,24.75,-0.25,-0.25,24.75,625,0,50,25,0.25,0,25,625,0,25,0,0.25,25,0,-25,-24.75,-25,347.0106666666667,25,24.75,0.99,322.0106666666667,25,0
29,1.99,0.01,625,618.75,612.56,0.0,0.0,49.75,24.75,24.75,-0.25,24.75,24.75,0,0,25,25,0.25,25,25,0,0,0,-25,-24.75,0,0,-25,-24.75,0,321.75866666666667,25,24.75,0.99,321.75866666666667,0,0
30,1.99,0.01,625,618.75,612.56,618.75,618.75,49.75,49.75,49.75,-0.25,-0.25,-0.25,625,625,50,50,0.25,0,0,625,625,50,0,0.25,0,625,0,0.25,0,353.192,25,24.75,0.99,328.192,25,25
31,1.99,0.01,625,618.75,612.56,0.0,321.75,49.75,24.75,37.75,-0.25,24.75,11.75,0,325,25,38,0.25,25,12,0,0,13,-25,-24.75,-13,169,-12,-11.75,13,325.006,25,24.75,0.99,325.006,0,13
32,1.99,0.01,625,618.75,612.56,0.0,618.75,49.75,24.75,49.75,-0.25,24.75,-0.25,0,625,25,50,0.25,25,0,0,0,25,-25,-24.75,-25,625,0,0.25,25,328.1073333333333,25,24.75,0.99,328.1073333333333,0,25
33,1.99,0.01,625,618.75,612.56,0.0,321.75,49.75,24.75,37.75,-0.25,24.75,11.75,0,325,25,38,0.25,25,12,0,0,13,-25,-24.75,-13,169,-12,-11.75,13,325.0713333333333,25,24.75,0.99,325.0713333333333,0,13
34,1.01,0.99,169,1.69,0.02,3.25,3.25,13.13,25.13,25.13,-12.87,-24.87,-24.87,325,325,38,38,12.87,-12,-12,625,625,50,12,24.87,0,625,12,24.87,0,347.3813333333333,13,0.13,0.010000006329579965,322.3813333333333,25,25
35,1.99,0.01,625,618.75,612.56,618.75,321.75,49.75,49.75,37.75,-0.25,-0.25,11.75,625,325,50,38,0.25,0,12,625,325,38,0,0.25,12,169,-12,-11.75,-12,349.872,25,24.75,0.99,324.872,25,13
36,1.01,0.99,625,6.25,0.06,0.0,3.25,25.25,0.25,13.25,-24.75,0.25,-12.75,0,325,25,38,24.75,25,12,0,0,13,-25,-0.25,-13,169,-12,12.75,13,325.03133333333335,25,0.25,0.01,325.03133333333335,0,13
37,1.99,0.01,625,618.75,612.56,0.0,0.0,49.75,24.75,24.75,-0.25,24.75,24.75,0,0,25,25,0.25,25,25,0,0,0,-25,-24.75,0,0,-25,-24.75,0,321.80266666666665,25,24.75,0.99,321.80266666666665,0,0
38,1.99,0.01,1,0.99,0.98,0.0,0.99,1.99,0.99,1.99,-0.01,0.99,-0.01,0,1,1,2,0.01,1,0,0,0,1,-1,-0.99,-1,1,0,0.01,1,1.0,1,0.99,0.99,1.0,0,1
39,1.99,0.01,1,0.99,0.98,0.0,0.0,1.99,0.99,0.99,-0.01,0.99,0.99,0,0,1,1,0.01,1,1,0,0,0,-1,-0.99,0,0,-1,-0.99,0,0.99,1,0.99,0.99,0.99,0,0
40,1.01,0.99,1,0.01,0.0,0.0,0.25,1.01,0.01,25.01,-0.99,0.01,-24.99,0,25,1,26,0.99,1,-24,0,0,25,-1,-0.01,-25,625,24,24.99,25,24.792,1,0.01,0.01,24.792,0,25
41,1.99,0.01,625,618.75,612.56,0.0,618.75,49.75,24.75,49.75,-0.25,24.75,-0.25,0,625,25,50,0.25,25,0,0,0,25,-25,-24.75,-25,625,0,0.25,25,327.902,25,24.75,0.99,327.902,0,25
42,1.99,0.01,1,0.99,0.98,0.0,24.75,1.99,0.99,25.99,-0.01,0.99,-24.01,0,25,1,26,0.01,1,-24,0,0,25,-1,-0.99,-25,625,24,24.01,25,1.144,1,0.99,0.99,1.144,0,25
43,1.99,0.01,625,618.75,612.56,0.0,0.0,49.75,24.75,24.75,-0.25,24.75,24.75,0,0,25,25,0.25,25,25,0,0,0,-25,-24.75,0,0,-25,-24.75,0,322.046,25,24.75,0.99,322.046,0,0
44,1.99,0.01,1,0.99,0.98,24.75,0.0,1.99,25.99,0.99,-0.01,-24.01,0.99,25,0,26,1,0.01,-24,1,625,0,25,24,24.01,25,0,-1,-0.99,-25,25.989333333333335,1,0.99,0.99,0.9893333333333345,25,0
45,1.01,0.99,4,0.04,0.0,0.5,0.0,2.02,25.02,0.02,-1.98,-24.98,0.02,50,0,27,2,1.98,-23,2,625,0,25,23,24.98,25,0,-2,-0.02,-25,25.032,2,0.02,0.01,0.03200000000000003,25,0
46,1.99,0.01,1,0.99,0.98,0.0,0.0,1.99,0.99,0.99,-0.01,0.99,0.99,0,0,1,1,0.01,1,1,0,0,0,-1,-0.99,0,0,-1,-0.99,0,0.9886666666666667,1,0.99,0.99,0.9886666666666667,0,0
47,1.01,0.99,625,6.25,0.06,0.0,0.0,25.25,0.25,0.25,-24.75,0.25,0.25,0,0,25,25,24.75,25,25,0,0,0,-25,-0.25,0,0,-25,-0.25,0,2.9966666666666666,25,0.25,0.01,2.9966666666666666,0,0
48,1.01,0.99,196,1.96,0.02,3.5,3.5,14.14,25.14,25.14,-13.86,-24.86,-24.86,350,350,39,39,13.86,-11,-11,625,625,50,11,24.86,0,625,11,24.86,0,372.34133333333335,14,0.14,0.01,347.34133333333335,25,25
49,1.99,0.01,625,618.75,612.56,618.75,321.75,49.75,49.75,37.75,-0.25,-0.25,11.75,625,325,50,38,0.25,0,12,625,325,38,0,0.25,12,169,-12,-11.75,-12,350.08666666666664,25,24.75,0.99,325.08666666666664,25,13
50,1.01,0.99,225,2.25,0.02,3.75,3.45,15.15,25.15,23.15,-14.85,-24.85,-22.85,375,345,40,38,14.85,-10,-8,625,575,48,10,24.85,2,529,8,22.85,-2,367.71733333333333,15,0.15,0.01,342.71733333333333,25,23
51,1.99,0.01,625,618.75,612.56,618.75,321.75,49.75,49.75,37.75,-0.25,-0.25,11.75,625,325,50,38,0.25,0,12,625,325,38,0,0.25,12,169,-12,-11.75,-12,350.04133333333334,25,24.75,0.99,325.04133333333334,25,13
52,1.99,0.01,625,618.75,612.56,0.0,618.75,49.75,24.75,49.75,-0.25,24.75,-0.25,0,625,25,50,0.25,25,0,0,0,25,-25,-24.75,-25,625,0,0.25,25,328.048,25,24.75,0.99,328.048,0,25
53,1.99,0.01,196,194.04,192.1,0.0,346.5,27.86,13.86,38.86,-0.14,13.86,-11.14,0,350,14,39,0.14,14,-11,0,0,25,-14,-13.86,-25,625,11,11.14,25,107.39866666666667,14,13.86,0.99,107.39866666666667,0,25
54,1.99,0.01,625,618.75,612.56,0.0,618.75,49.75,24.75,49.75,-0.25,24.75,-0.25,0,625,25,50,0.25,25,0,0,0,25,-25,-24.75,-25,625,0,0.25,25,328.16266666666667,25,24.75,0.99,328.16266666666667,0,25
55,1.99,0.01,169,167.31,165.64,0.0,321.75,25.87,12.87,37.87,-0.13,12.87,-12.13,0,325,13,38,0.13,13,-12,0,0,25,-13,-12.87,-25,625,12,12.13,25,93.372,13,12.87,0.99,93.372,0,25
56,1.99,0.01,625,618.75,612.56,618.75,0.0,49.75,49.75,24.75,-0.25,-0.25,24.75,625,0,50,25,0.25,0,25,625,0,25,0,0.25,25,0,-25,-24.75,-25,347.0106666666667,25,24.75,0.99,322.0106666666667,25,0
57,1.99,0.01,625,618.75,612.56,0.0,0.0,49.75,24.75,24.75,-0.25,24.75,24.75,0,0,25,25,0.25,25,25,0,0,0,-25,-24.75,0,0,-25,-24.75,0,321.75866666666667,25,24.75,0.99,321.75866666666667,0,0
58,1.99,0.01,625,618.75,612.56,618.75,618.75,49.75,49.75,49.75,-0.25,-0.25,-0.25,625,625,50,50,0.25,0,0,625,625,50,0,0.25,0,625,0,0.25,0,353.192,25,24.75,0.99,328.192,25,25
59,1.99,0.01,625,618.75,612.56,0.0,321.75,49.75,24.75,37.75,-0.25,24.75,11.75,0,325,25,38,0.25,25,12,0,0,13,-25,-24.75,-13,169,-12,-11.75,13,325.006,25,24.75,0.99,325.006,0,13
60,1.99,0.01,625,618.75,612.56,0.0,618.75,49.75,24.75,49.75,-0.25,24.75,-0.25,0,625,25,50,0.25,25,0,0,0,25,-25,-24.75,-25,625,0,0.25,25,328.1073333333333,25,24.75,0.99,328.1073333333333,0,25
61,1.99,0.01,625,618.75,612.56,0.0,321.75,49.75,24.75,37.75,-0.25,24.75,11.75,0,325,25,38,0.25,25,12,0,0,13,-25,-24.75,-13,169,-12,-11.75,13,325.0713333333333,25,24.75,0.99,325.0713333333333,0,13
62,1.01,0.99,169,1.69,0.02,3.25,3.25,13.13,25.13,25.13,-12.87,-24.87,-24.87,325,325,38,38,12.87,-12,-12,625,625,50,12,24.87,0,625,12,24.87,0,347.3813333333333,13,0.13,0.010000006329579965,322.3813333333333,25,25
63,1.99,0.01,625,618.75,612.56,618.75,321.75,49.75,49.75,37.75,-0.25,-0.25,11.75,625,325,50,38,0.25,0,12,625,325,38,0,0.25,12,169,-12,-11.75,-12,349.872,25,24.75,0.99,324.872,25,13
64,1.01,0.99,625,6.25,0.06,0.0,3.25,25.25,0.25,13.25,-24.75,0.25,-12.75,0,325,25,38,24.75,25,12,0,0,13,-25,-0.25,-13,169,-12,12.75,13,325.03133333333335,25,0.25,0.01,325.03133333333335,0,13
65,1.99,0.01,625,618.75,612.56,0.0,0.0,49.75,24.75,24.75,-0.25,24.75,24.75,0,0,25,25,0.25,25,25,0,0,0,-25,-24.75,0,0,-25,-24.75,0,321.80266666666665,25,24.75,0.99,321.80266666666665,0,0
66,1.99,0.01,1,0.99,0.98,0.0,0.99,1.99,0.99,1.99,-0.01,0.99,-0.01,0,1,1,2,0.01,1,0,0,0,1,-1,-0.99,-1,1,0,0.01,1,1.0,1,0.99,0.99,1.0,0,1
67,1.99,0.01,1,0.99,0.98,0.0,0.0,1.99,0.99,0.99,-0.01,0.99,0.99,0,0,1,1,0.01,1,1,0,0,0,-1,-0.99,0,0,-1,-0.99,0,0.99,1,0.99,0.99,0.99,0,0
68,1.01,0.99,1,0.01,0.0,0.0,0.25,1.01,0.01,25.01,-0.99,0.01,-24.99,0,25,1,26,0.99,1,-24,0,0,25,-1,-0.01,-25,625,24,24.99,25,24.792,1,0.01,0.01,24.792,0,25
69,1.99,0.01,625,618.75,612.56,0.0,618.75,49.75,24.75,49.75,-0.25,24.75,-0.25,0,625,25,50,0.25,25,0,0,0,25,-25,-24.75,-25,625,0,0.25,25,327.902,25,24.75,0.99,327.902,0,25
70,1.99,0.01,1,0.99,0.98,0.0,24.75,1.99,0.99,25.99,-0.01,0.99,-24.01,0,25,1,26,0.01,1,-24,0,0,25,-1,-0.99,-25,625,24,24.01,25,1.144,1,0.99,0.99,1.144,0,25
71,1.99,0.01,625,618.75,612.56,0.0,0.0,49.75,24.75,24.75,-0.25,24.75,24.75,0,0,25,25,0.25,25,25,0,0,0,-25,-24.75,0,0,-25,-24.75,0,322.046,25,24.75,0.99,322.046,0,0
72,1.99,0.01,1,0.99,0.98,24.75,0.0,1.99,25.99,0.99,-0.01,-24.01,0.99,25,0,26,1,0.01,-24,1,625,0,25,24,24.01,25,0,-1,-0.99,-25,25.989333333333335,1,0.99,0.99,0.9893333333333345,25,0
73,1.01,0.99,4,0.04,0.0,0.5,0.0,2.02,25.02,0.02,-1.98,-24.98,0.02,50,0,27,2,1.98,-23,2,625,0,25,23,24.98,25,0,-2,-0.02,-25,25.032,2,0.02,0.01,0.03200000000000003,25,0
74,1.99,0.01,1,0.99,0.98,0.0,0.0,1.99,0.99,0.99,-0.01,0.99,0.99,0,0,1,1,0.01,1,1,0,0,0,-1,-0.99,0,0,-1,-0.99,0,0.9886666666666667,1,0.99,0.99,0.9886666666666667,0,0
75,1.01,0.99,625,6.25,0.06,0.0,0.0,25.25,0.25,0.25,-24.75,0.25,0.25,0,0,25,25,24.75,25,25,0,0,0,-25,-0.25,0,0,-25,-0.25,0,2.9966666666666666,25,0.25,0.01,2.9966666666666666,0,0
76,1.01,0.99,196,1.96,0.02,3.5,3.5,14.14,25.14,25.14,-13.86,-24.86,-24.86,350,350,39,39,13.86,-11,-11,625,625,50,11,24.86,0,625,11,24.86,0,372.34133333333335,14,0.14,0.01,347.34133333333335,25,25
77,1.99,0.01,625,618.75,612.56,618.75,321.75,49.75,49.75,37.75,-0.25,-0.25,11.75,625,325,50,38,0.25,0,12,625,325,38,0,0.25,12,169,-12,-11.75,-12,350.08666666666664,25,24.75,0.99,325.08666666666664,25,13
78,1.01,0.99,225,2.25,0.02,3.75,3.45,15.15,25.15,23.15,-14.85,-24.85,-22.85,375,345,40,38,14.85,-10,-8,625,575,48,10,24.85,2,529,8,22.85,-2,367.71733333333333,15,0.15,0.01,342.71733333333333,25,23
79,1.99,0.01,625,618.75,612.56,618.75,321.75,49.75,49.75,37.75,-0.25,-0.25,11.75,625,325,50,38,0.25,0,12,625,325,38,0,0.25,12,169,-12,-11.75,-12,350.04133333333334,25,24.75,0.99,325.04133333333334,25,13
80,1.99,0.01,625,618.75,612.56,0.0,618.75,49.75,24.75,49.75,-0.25,24.75,-0.25,0,625,25,50,0.25,25,0,0,0,25,-25,-24.75,-25,625,0,0.25,25,328.048,25,24.75,0.99,328.048,0,25
81,1.99,0.01,196,194.04,192.1,0.0,346.5,27.86,13.86,38.86,-0.14,13.86,-11.14,0,350,14,39,0.14,14,-11,0,0,25,-14,-13.86,-25,625,11,11.14,25,107.39866666666667,14,13.86,0.99,107.39866666666667,0,25
82,1.99,0.01,625,618.75,612.56,0.0,618.75,49.75,24.75,49.75,-0.25,24.75,-0.25,0,625,25,50,0.25,25,0,0,0,25,-25,-24.75,-25,625,0,0.25,25,328.16266666666667,25,24.75,0.99,328.16266666666667,0,25
83,1.99,0.01,169,167.31,165.64,0.0,321.75,25.87,12.87,37.87,-0.13,12.87,-12.13,0,325,13,38,0.13,13,-12,0,0,25,-13,-12.87,-25,625,12,12.13,25,93.372,13,12.87,0.99,93.372,0,25
84,1.99,0.01,625,618.75,612.56,618.75,0.0,49.75,49.75,24.75,-0.25,-0.25,24.75,625,0,50,25,0.25,0,25,625,0,25,0,0.25,25,0,-25,-24.75,-25,347.0106666666667,25,24.75,0.99,322.0106666666667,25,0
85,1.99,0.01,625,618.75,612.56,0.0,0.0,49.75,24.75,24.75,-0.25,24.75,24.75,0,0,25,25,0.25,25,25,0,0,0,-25,-24.75,0,0,-25,-24.75,0,321.75866666666667,25,24.75,0.99,321.75866666666667,0,0
86,1.99,0.01,625,618.75,612.56,618.75,618.75,49.75,49.75,49.75,-0.25,-0.25,-0.25,625,625,50,50,0.25,0,0,625,625,50,0,0.25,0,625,0,0.25,0,353.192,25,24.75,0.99,328.192,25,25
87,1.99,0.01,625,618.75,612.56,0.0,321.75,49.75,24.75,37.75,-0.25,24.75,11.75,0,325,25,38,0.25,25,12,0,0,13,-25,-24.75,-13,169,-12,-11.75,13,325.006,25,24.75,0.99,325.006,0,13
88,1.99,0.01,625,618.75,612.56,0.0,618.75,49.75,24.75,49.75,-0.25,24.75,-0.25,0,625,25,50,0.25,25,0,0,0,25,-25,-24.75,-25,625,0,0.25,25,328.1073333333333,25,24.75,0.99,328.1073333333333,0,25
89,1.99,0.01,625,618.75,612.56,0.0,321.75,49.75,24.75,37.75,-0.25,24.75,11.75,0,325,25,38,0.25,25,12,0,0,13,-25,-24.75,-13,169,-12,-11.75,13,325.0713333333333,25,24.75,0.99,325.0713333333333,0,13
90,1.01,0.99,169,1.69,0.02,3.25,3.25,13.13,25.13,25.13,-12.87,-24.87,-24.87,325,325,38,38,12.87,-12,-12,625,625,50,12,24.87,0,625,12,24.87,0,347.3813333333333,13,0.13,0.010000006329579965,322.3813333333333,25,25
91,1.99,0.01,625,618.75,612.56,618.75,321.75,49.75,49.75,37.75,-0.25,-0.25,11.75,625,325,50,38,0.25,0,12,625,325,38,0,0.25,12,169,-12,-11.75,-12,349.872,25,24.75,0.99,324.872,25,13
92,1.01,0.99,625,6.25,0.06,0.0,3.25,25.25,0.25,13.25,-24.75,0.25,-12.75,0,325,25,38,24.75,25,12,0,0,13,-25,-0.25,-13,169,-12,12.75,13,325.03133333333335,25,0.25,0.01,325.03133333333335,0,13
93,1.99,0.01,625,618.75,612.56,0.0,0.0,49.75,24.75,24.75,-0.25,24.75,24.75,0,0,25,25,0.25,25,25,0,0,0,-25,-24.75,0,0,-25,-24.75,0,321.80266666666665,25,24.75,0.99,321.80266666666665,0,0
94,1.99,0.01,1,0.99,0.98,0.0,0.99,1.99,0.99,1.99,-0.01,0.99,-0.01,0,1,1,2,0.01,1,0,0,0,1,-1,-0.99,-1,1,0,0.01,1,1.0,1,0.99,0.99,1.0,0,1
95,1.99,0.01,1,0.99,0.98,0.0,0.0,1.99,0.99,0.99,-0.01,0.99,0.99,0,0,1,1,0.01,1,1,0,0,0,-1,-0.99,0,0,-1,-0.99,0,0.99,1,0.99,0.99,0.99,0,0
96,1.01,0.99,1,0.01,0.0,0.0,0.25,1.01,0.01,25.01,-0.99,0.01,-24.99,0,25,1,26,0.99,1,-24,0,0,25,-1,-0.01,-25,625,24,24.99,25,24.792,1,0.01,0.01,24.792,0,25
97,1.99,0.01,625,618.75,612.56,0.0,618.75,49.75,24.75,49.75,-0.25,24.75,-0.25,0,625,25,50,0.25,25,0,0,0,25,-25,-24.75,-25,625,0,0.25,25,327.902,25,24.75,0.99,327.902,0,25
98,1.99,0.01,1,0.99,0.98,0.0,24.75,1.99,0.99,25.99,-0.01,0.99,-24.01,0,25,1,26,0.01,1,-24,0,0,25,-1,-0.99,-25,625,24,24.01,25,1.144,1,0.99,0.99,1.144,0,25
99,1.99,0.01,625,618.75,612.56,0.0,0.0,49.75,24.75,24.75,-0.25,24.75,24.75,0,0,25,25,0.25,25,25,0,0,0,-25,-24.75,0,0,-25,-24.75,0,322.046,25,24.75,0.99,322.046,0,0
100,1.99,0.01,1,0.99,0.98,24.75,0.0,1.99,25.99,0.99,-0.01,-24.01,0.99,25,0,26,1,0.01,-24,1,625,0,25,24,24.01,25,0,-1,-0.99,-25,25.989333333333335,1,0.99,0.99,0.9893333333333345,25,0
101,1.01,0.99,4,0.04,0.0,0.5,0.0,2.02,25.02,0.02,-1.98,-24.98,0.02,50,0,27,2,1.98,-23,2,625,0,25,23,24.98,25,0,-2,-0.02,-25,25.032,2,0.02,0.01,0.03200000000000003,25,0
102,1.99,0.01,1,0.99,0.98,0.0,0.0,1.99,0.99,0.99,-0.01,0.99,0.99,0,0,1,1,0.01,1,1,0,0,0,-1,-0.99,0,0,-1,-0.99,0,0.9886666666666667,1,0.99,0.99,0.9886666666666667,0,0
103,1.01,0.99,625,6.25,0.06,0.0,0.0,25.25,0.25,0.25,-24.75,0.25,0.25,0,0,25,25,24.75,25,25,0,0,0,-25,-0.25,0,0,-25,-0.25,0,2.9966666666666666,25,0.25,0.01,2.9966666666666666,0,0
104,1.01,0.99,196,1.96,0.02,3.5,3.5,14.14,25.14,25.14,-13.86,-24.86,-24.86,350,350,39,39,13.86,-11,-11,625,625,50,11,24.86,0,625,11,24.86,0,372.34133333333335,14,0.14,0.01,347.34133333333335,25,25
105,1.99,0.01,625,618.75,612.56,618.75,321.75,49.75,49.75,37.75,-0.25,-0.25,11.75,625,325,50,38,0.25,0,12,625,325,38,0,0.25,12,169,-12,-11.75,-12,350.08666666666664,25,24.75,0.99,325.08666666666664,25,13
106,1.01,0.99,225,2.25,0.02,3.75,3.45,15.15,25.15,23.15,-14.85,-24.85,-22.85,375,345,40,38,14.85,-10,-8,625,575,48,10,24.85,2,529,8,22.85,-2,367.71733333333333,15,0.15,0.01,342.71733333333333,25,23
107,1.99,0.01,625,618.75,612.56,618.75,321.75,49.75,49.75,37.75,-0.25,-0.25,11.75,625,325,50,38,0.25,0,12,625,325,38,0,0.25,12,169,-12,-11.75,-12,350.04133333333334,25,24.75,0.99,325.04133333333334,25,13
108,1.99,0.01,625,618.75,612.56,0.0,618.75,49.75,24.75,49.75,-0.25,24.75,-0.25,0,625,25,50,0.25,25,0,0,0,25,-25,-24.75,-25,625,0,0.25,25,328.048,25,24.75,0.99,328.048,0,25
109,1.99,0.01,196,194.04,192.1,0.0,346.5,27.86,13.86,38.86,-0.14,13.86,-11.14,0,350,14,39,0.14,14,-11,0,0,25,-14,-13.86,-25,625,11,11.14,25,107.39866666666667,14,13.86,0.99,107.39866666666667,0,25
110,1.99,0.01,625,618.75,612.56,0.0,618.75,49.75,24.75,49.75,-0.25,24.75,-0.25,0,625,25,50,0.25,25,0,0,0,25,-25,-24.75,-25,625,0,0.25,25,328.16266666666667,25,24.75,0.99,328.16266666666667,0,25
111,1.99,0.01,169,167.31,165.64,0.0,321.75,25.87,12.87,37.87,-0.13,12.87,-12.13,0,325,13,38,0.13,13,-12,0,0,25,-13,-12.87,-25,625,12,12.13,25,93.372,13,12.87,0.99,93.372,0,25
112,1.99,0.01,625,618.75,612.56,618.75,0.0,49.75,49.75,24.75,-0.25,-0.25,24.75,625,0,50,25,0.25,0,25,625,0,25,0,0.25,25,0,-25,-24.75,-25,347.0106666666667,25,24.75,0.99,322.0106666666667,25,0
113,1.99,0.01,625,618.75,612.56,0.0,0.0,49.75,24.75,24.75,-0.25,24.75,24.75,0,0,25,25,0.25,25,25,0,0,0,-25,-24.75,0,0,-25,-24.75,0,321.75866666666667,25,24.75,0.99,321.75866666666667,0,0
114,1.99,0.01,625,618.75,612.56,618.75,618.75,49.75,49.75,49.75,-0.25,-0.25,-0.25,625,625,50,50,0.25,0,0,625,625,50,0,0.25,0,625,0,0.25,0,353.192,25,24.75,0.99,328.192,25,25
115,1.99,0.01,625,618.75,612.56,0.0,321.75,49.75,24.75,37.75,-0.25,24.75,11.75,0,325,25,38,0.25,25,12,0,0,13,-25,-24.75,-13,169,-12,-11.75,13,325.006,25,24.75,0.99,325.006,0,13
116,1.99,0.01,625,618.75,612.56,0.0,618.75,49.75,24.75,49.75,-0.25,24.75,-0.25,0,625,25,50,0.25,25,0,0,0,25,-25,-24.75,-25,625,0,0.25,25,328.1073333333333,25,24.75,0.99,328.1073333333333,0,25
117,1.99,0.01,625,618.75,612.56,0.0,321.75,49.75,24.75,37.75,-0.25,24.75,11.75,0,325,25,38,0.25,25,12,0,0,13,-25,-24.75,-13,169,-12,-11.75,13,325.0713333333333,25,24.75,0.99,325.0713333333333,0,13
118,1.01,0.99,169,1.69,0.02,3.25,3.25,13.13,25.13,25.13,-12.87,-24.87,-24.87,325,325,38,38,12.87,-12,-12,625,625,50,12,24.87,0,625,12,24.87,0,347.3813333333333,13,0.13,0.010000006329579965,322.3813333333333,25,25
119,1.99,0.01,625,618.75,612.56,618.75,321.75,49.75,49.75,37.75,-0.25,-0.25,11.75,625,325,50,38,0.25,0,12,625,325,38,0,0.25,12,169,-12,-11.75,-12,349.872,25,24.75,0.99,324.872,25,13
120,1.01,0.99,625,6.25,0.06,0.0,3.25,25.25,0.25,13.25,-24.75,0.25,-12.75,0,325,25,38,24.75,25,12,0,0,13,-25,-0.25,-13,169,-12,12.75,13,325.03133333333335,25,0.25,0.01,325.03133333333335,0,13
121,1.99,0.01,625,618.75,612.56,0.0,0.0,49.75,24.75,24.75,-0.25,24.75,24.75,0,0,25,25,0.25,25,25,0,0,0,-25,-24.75,0,0,-25,-24.75,0,321.80266666666665,25,24.75,0.99,321.80266666666665,0,0
122,1.99,0.01,1,0.99,0.98,0.0,0.99,1.99,0.99,1.99,-0.01,0.99,-0.01,0,1,1,2,0.01,1,0,0,0,1,-1,-0.99,-1,1,0,0.01,1,1.0,1,0.99,0.99,1.0,0,1
123,1.99,0.01,1,0.99,0.98,0.0,0.0,1.99,0.99,0.99,-0.01,0.99,0.99,0,0,1,1,0.01,1,1,0,0,0,-1,-0.99,0,0,-1,-0.99,0,0.99,1,0.99,0.99,0.99,0,0
124,1.01,0.99,1,0.01,0.0,0.0,0.25,1.01,0.01,25.01,-0.99,0.01,-24.99,0,25,1,26,0.99,1,-24,0,0,25,-1,-0.01,-25,625,24,24.99,25,24.792,1,0.01,0.01,24.792,0,25
125,1.99,0.01,625,618.75,612.56,0.0,618.75,49.75,24.75,49.75,-0.25,24.75,-0.25,0,625,25,50,0.25,25,0,0,0,25,-25,-24.75,-25,625,0,0.25,25,327.902,25,24.75,0.99,327.902,0,25
126,1.99,0.01,1,0.99,0.98,0.0,24.75,1.99,0.99,25.99,-0.01,0.99,-24.01,0,25,1,26,0.01,1,-24,0,0,25,-1,-0.99,-25,625,24,24.01,25,1.144,1,0.99,0.99,1.144,0,25
127,1.99,0.01,625,618.75,612.56,0.0,0.0,49.75,24.75,24.75,-0.25,24.75,24.75,0,0,25,25,0.25,25,25,0,0,0,-25,-24.75,0,0,-25,-24.75,0,322.046,25,24.75,0.99,322.046,0,0
128,1.99,0.01,1,0.99,0.98,24.75,0.0,1.99,25.99,0.99,-0.01,-24.01,0.99,25,0,26,1,0.01,-24,1,625,0,25,24,24.01,25,0,-1,-0.99,-25,25.989333333333335,1,0.99,0.99,0.9893333333333345,25,0
129,1.01,0.99,4,0.04,0.0,0.5,0.0,2.02,25.02,0.02,-1.98,-24.98,0.02,50,0,27,2,1.98,-23,2,625,0,25,23,24.98,25,0,-2,-0.02,-25,25.032,2,0.02,0.01,0.03200000000000003,25,0
130,1.99,0.01,1,0.99,0.98,0.0,0.0,1.99,0.99,0.99,-0.01,0.99,0.99,0,0,1,1,0.01,1,1,0,0,0,-1,-0.99,0,0,-1,-0.99,0,0.9886666666666667,1,0.99,0.99,0.9886666666666667,0,0
131,1.01,0.99,625,6.25,0.06,0.0,0.0,25.25,0.25,0.25,-24.75,0.25,0.25,0,0,25,25,24.75,25,25,0,0,0,-25,-0.25,0,0,-25,-0.25,0,2.9966666666666666,25,0.25,0.01,2.9966666666666666,0,0
132,1.01,0.99,196,1.96,0.02,3.5,3.5,14.14,25.14,25.14,-13.86,-24.86,-24.86,350,350,39,39,13.86,-11,-11,625,625,50,11,24.86,0,625,11,24.86,0,372.34133333333335,14,0.14,0.01,347.34133333333335,25,25
133,1.99,0.01,625,618.75,612.56,618.75,321.75,49.75,49.75,37.75,-0.25,-0.25,11.75,625,325,50,38,0.25,0,12,625,325,38,0,0.25,12,169,-12,-11.75,-12,350.08666666666664,25,24.75,0.99,325.08666666666664,25,13
134,1.01,0.99,225,2.25,0.02,3.75,3.45,15.15,25.15,23.15,-14.85,-24.85,-22.85,375,345,40,38,14.85,-10,-8,625,575,48,10,24.85,2,529,8,22.85,-2,367.71733333333333,15,0.15,0.01,342.71733333333333,25,23
135,1.99,0.01,625,618.75,612.56,618.75,321.75,49.75,49.75,37.75,-0.25,-0.25,11.75,625,325,50,38,0.25,0,12,625,325,38,0,0.25,12,169,-12,-11.75,-12,350.04133333333334,25,24.75,0.99,325.04133333333334,25,13
136,1.99,0.01,625,618.75,612.56,0.0,618.75,49.75,24.75,49.75,-0.25,24.75,-0.25,0,625,25,50,0.25,25,0,0,0,25,-25,-24.75,-25,625,0,0.25,25,328.048,25,24.75,0.99,328.048,0,25
137,1.99,0.01,196,194.04,192.1,0.0,346.5,27.86,13.86,38.86,-0.14,13.86,-11.14,0,350,14,39,0.14,14,-11,0,0,25,-14,-13.86,-25,625,11,11.14,25,107.39866666666667,14,13.86,0.99,107.39866666666667,0,25
138,1.99,0.01,625,618.75,612.56,0.0,618.75,49.75,24.75,49.75,-0.25,24.75,-0.25,0,625,25,50,0.25,25,0,0,0,25,-25,-24.75,-25,625,0,0.25,25,328.16266666666667,25,24.75,0.99,328.16266666666667,0,25
139,1.99,0.01,169,167.31,165.64,0.0,321.75,25.87,12.87,37.87,-0.13,12.87,-12.13,0,325,13,38,0.13,13,-12,0,0,25,-13,-12.87,-25,625,12,12.13,25,93.372,13,12.87,0.99,93.372,0,25
140,1.99,0.01,625,618.75,612.56,618.75,0.0,49.75,49.75,24.75,-0.25,-0.25,24.75,625,0,50,25,0.25,0,25,625,0,25,0,0.25,25,0,-25,-24.75,-25,347.0106666666667,25,24.75,0.99,322.0106666666667,25,0
141,1.99,0.01,625,618.75,612.56,0.0,0.0,49.75,24.75,24.75,-0.25,24.75,24.75,0,0,25,25,0.25,25,25,0,0,0,-25,-24.75,0,0,-25,-24.75,0,321.75866666666667,25,24.75,0.99,321.75866666666667,0,0
142,1.99,0.01,625,618.75,612.56,618.75,618.75,49.75,49.75,49.75,-0.25,-0.25,-0.25,625,625,50,50,0.25,0,0,625,625,50,0,0.25,0,625,0,0.25,0,353.192,25,24.75,0.99,328.192,25,25
143,1.99,0.01,625,618.75,612.56,0.0,321.75,49.75,24.75,37.75,-0.25,24.75,11.75,0,325,25,38,0.25,25,12,0,0,13,-25,-24.75,-13,169,-12,-11.75,13,325.006,25,24.75,0.99,325.006,0,13
144,1.99,0.01,625,618.75,612.56,0.0,618.75,49.75,24.75,49.75,-0.25,24.75,-0.25,0,625,25,50,0.25,25,0,0,0,25,-25,-24.75,-25,625,0,0.25,25,328.1073333333333,25,24.75,0.99,328.1073333333333,0,25
145,1.99,0.01,625,618.75,612.56,0.0,321.75,49.75,24.75,37.75,-0.25,24.75,11.75,0,325,25,38,0.25,25,12,0,0,13,-25,-24.75,-13,169,-12,-11.75,13,325.0713333333333,25,24.75,0.99,325.0713333333333,0,13
146,1.01,0.99,169,1.69,0.02,3.25,3.25,13.13,25.13,25.13,-12.87,-24.87,-24.87,325,325,38,38,12.87,-12,-12,625,625,50,12,24.87,0,625,12,24.87,0,347.3813333333333,13,0.13,0.010000006329579965,322.3813333333333,25,25
147,1.99,0.01,625,618.75,612.56,618.75,321.75,49.75,49.75,37.75,-0.25,-0.25,11.75,625,325,50,38,0.25,0,12,625,325,38,0,0.25,12,169,-12,-11.75,-12,349.872,25,24.75,0.99,324.872,25,13
148,1.01,0.99,625,6.25,0.06,0.0,3.25,25.25,0.25,13.25,-24.75,0.25,-12.75,0,325,25,38,24.75,25,12,0,0,13,-25,-0.25,-13,169,-12,12.75,13,325.03133333333335,25,0.25,0.01,325.03133333333335,0,13
149,1.99,0.01,625,618.75,612.56,0.0,0.0,49.75,24.75,24.75,-0.25,24.75,24.75,0,0,25,25,0.25,25,25,0,0,0,-25,-24.75,0,0,-25,-24.75,0,321.80266666666665,25,24.75,0.99,321.80266666666665,0,0
150,1.99,0.01,1,0.99,0.98,0.0,0.99,1.99,0.99,1.99,-0.01,0.99,-0.01,0,1,1,2,0.01,1,0,0,0,1,-1,-0.99,-1,1,0,0.01,1,1.0,1,0.99,0.99,1.0,0,1
151,1.99,0.01,1,0.99,0.98,0.0,0.0,1.99,0.99,0.99,-0.01,0.99,0.99,0,0,1,1,0.01,1,1,0,0,0,-1,-0.99,0,0,-1,-0.99,0,0.99,1,0.99,0.99,0.99,0,0
152,1.01,0.99,1,0.01,0.0,0.0,0.25,1.01,0.01,25.01,-0.99,0.01,-24.99,0,25,1,26,0.99,1,-24,0,0,25,-1,-0.01,-25,625,24,24.99,25,24.792,1,0.01,0.01,24.792,0,25
153,1.99,0.01,625,618.75,612.56,0.0,618.75,49.75,24.75,49.75,-0.25,24.75,-0.25,0,625,25,50,0.25,25,0,0,0,25,-25,-24.75,-25,625,0,0.25,25,327.902,25,24.75,0.99,327.902,0,25
154,1.99,0.01,1,0.99,0.98,0.0,24.75,1.99,0.99,25.99,-0.01,0.99,-24.01,0,25,1,26,0.01,1,-24,0,0,25,-1,-0.99,-25,625,24,24.01,25,1.144,1,0.99,0.99,1.144,0,25
155,1.99,0.01,625,618.75,612.56,0.0,0.0,49.75,24.75,24.75,-0.25,24.75,24.75,0,0,25,25,0.25,25,25,0,0,0,-25,-24.75,0,0,-25,-24.75,0,322.046,25,24.75,0.99,322.046,0,0
156,1.99,0.01,1,0.99,0.98,24.75,0.0,1.99,25.99,0.99,-0.01,-24.01,0.99,25,0,26,1,0.01,-24,1,625,0,25,24,24.01,25,0,-1,-0.99,-25,25.989333333333335,1,0.99,0.99,0.9893333333333345,25,0
157,1.01,0.99,4,0.04,0.0,0.5,0.0,2.02,25.02,0.02,-1.98,-24.98,0.02,50,0,27,2,1.98,-23,2,625,0,25,23,24.98,25,0,-2,-0.02,-25,25.032,2,0.02,0.01,0.03200000000000003,25,0
158,1.99,0.01,1,0.99,0.98,0.0,0.0,1.99,0.99,0.99,-0.01,0.99,0.99,0,0,1,1,0.01,1,1,0,0,0,-1,-0.99,0,0,-1,-0.99,0,0.9886666666666667,1,0.99,0.99,0.9886666666666667,0,0
159,1.01,0.99,625,6.25,0.06,0.0,0.0,25.25,0.25,0.25,-24.75,0.25,0.25,0,0,25,25,24.75,25,25,0,0,0,-25,-0.25,0,0,-25,-0.25,0,2.9966666666666666,25,0.25,0.01,2.9966666666666666,0,0
160,1.01,0.99,196,1.96,0.02,3.5,3.5,14.14,25.14,25.14,-13.86,-24.86,-24.86,350,350,39,39,13.86,-11,-11,625,625,50,11,24.86,0,625,11,24.86,0,372.34133333333335,14,0.14,0.01,347.34133333333335,25,25
161,1.99,0.01,625,618.75,612.56,618.75,321.75,49.75,49.75,37.75,-0.25,-0.25,11.75,625,325,50,38,0.25,0,12,625,325,38,0,0.25,12,169,-12,-11.75,-12,350.08666666666664,25,24.75,0.99,325.08666666666664,25,13
162,1.01,0.99,225,2.25,0.02,3.75,3.45,15.15,25.15,23.15,-14.85,-24.85,-22.85,375,345,40,38,14.85,-10,-8,625,575,48,10,24.85,2,529,8,22.85,-2,367.71733333333333,15,0.15,0.01,342.71733333333333,25,23
163,1.99,0.01,625,618.75,612.56,618.75,321.75,49.75,49.75,37.75,-0.25,-0.25,11.75,625,325,50,38,0.25,0,12,625,325,38,0,0.25,12,169,-12,-11.75,-12,350.04133333333334,25,24.75,0.99,325.04133333333334,25,13
164,1.99,0.01,625,618.75,612.56,0.0,618.75,49.75,24.75,49.75,-0.25,24.75,-0.25,0,625,25,50,0.25,25,0,0,0,25,-25,-24.75,-25,625,0,0.25,25,328.048,25,24.75,0.99,328.048,0,25
165,1.99,0.01,196,194.04,192.1,0.0,346.5,27.86,13.86,38.86,-0.14,13.86,-11.14,0,350,14,39,0.14,14,-11,0,0,25,-14,-13.86,-25,625,11,11.14,25,107.39866666666667,14,13.86,0.99,107.39866666666667,0,25
166,1.99,0.01,625,618.75,612.56,0.0,618.75,49.75,24.75,49.75,-0.25,24.75,-0.25,0,625,25,50,0.25,25,0,0,0,25,-25,-24.75,-25,625,0,0.25,25,328.16266666666667,25,24.75,0.99,328.16266666666667,0,25
167,1.99,0.01,169,167.31,165.64,0.0,321.75,25.87,12.87,37.87,-0.13,12.87,-12.13,0,325,13,38,0.13,13,-12,0,0,25,-13,-12.87,-25,625,12,12.13,25,93.372,13,12.87,0.99,93.372,0,25
168,1.99,0.01,625,618.75,612.56,618.75,0.0,49.75,49.75,24.75,-0.25,-0.25,24.75,625,0,50,25,0.25,0,25,625,0,25,0,0.25,25,0,-25,-24.75,-25,347.0106666666667,25,24.75,0.99,322.0106666666667,25,0
169,1.99,0.01,625,618.75,612.56,0.0,0.0,49.75,24.75,24.75,-0.25,24.75,24.75,0,0,25,25,0.25,25,25,0,0,0,-25,-24.75,0,0,-25,-24.75,0,321.75866666666667,25,24.75,0.99,321.75866666666667,0,0
170,1.99,0.01,625,618.75,612.56,618.75,618.75,49.75,49.75,49.75,-0.25,-0.25,-0.25,625,625,50,50,0.25,0,0,625,625,50,0,0.25,0,625,0,0.25,0,353.192,25,24.75,0.99,328.192,25,25
171,1.99,0.01,625,618.75,612.56,0.0,321.75,49.75,24.75,37.75,-0.25,24.75,11.75,0,325,25,38,0.25,25,12,0,0,13,-25,-24.75,-13,169,-12,-11.75,13,325.006,25,24.75,0.99,325.006,0,13
172,1.99,0.01,625,618.75,612.56,0.0,618.75,49.75,24.75,49.75,-0.25,24.75,-0.25,0,625,25,50,0.25,25,0,0,0,25,-25,-24.75,-25,625,0,0.25,25,328.1073333333333,25,24.75,0.99,328.1073333333333,0,25
173,1.99,0.01,625,618.75,612.56,0.0,321.75,49.75,24.75,37.75,-0.25,24.75,11.75,0,325,25,38,0.25,25,12,0,0,13,-25,-24.75,-13,169,-12,-11.75,13,325.0713333333333,25,24.75,0.99,325.0713333333333,0,13
174,1.01,0.99,169,1.69,0.02,3.25,3.25,13.13,25.13,25.13,-12.87,-24.87,-24.87,325,325,38,38,12.87,-12,-12,625,625,50,12,24.87,0,625,12,24.87,0,347.3813333333333,13,0.13,0.010000006329579965,322.3813333333333,25,25
175,1.99,0.01,625,618.75,612.56,618.75,321.75,49.75,49.75,37.75,-0.25,-0.25,11.75,625,325,50,38,0.25,0,12,625,325,38,0,0.25,12,169,-12,-11.75,-12,349.872,25,24.75,0.99,324.872,25,13
176,1.01,0.99,625,6.25,0.06,0.0,3.25,25.25,0.25,13.25,-24.75,0.25,-12.75,0,325,25,38,24.75,25,12,0,0,13,-25,-0.25,-13,169,-12,12.75,13,325.03133333333335,25,0.25,0.01,325.03133333333335,0,13
177,1.99,0.01,625,618.75,612.56,0.0,0.0,49.75,24.75,24.75,-0.25,24.75,24.75,0,0,25,25,0.25,25,25,0,0,0,-25,-24.75,0,0,-25,-24.75,0,321.80266666666665,25,24.75,0.99,321.80266666666665,0,0
178,1.99,0.01,1,0.99,0.98,0.0,0.99,1.99,0.99,1.99,-0.01,0.99,-0.01,0,1,1,2,0.01,1,0,0,0,1,-1,-0.99,-1,1,0,0.01,1,1.0,1,0.99,0.99,1.0,0,1
179,1.99,0.01,1,0.99,0.98,0.0,0.0,1.99,0.99,0.99,-0.01,0.99,0.99,0,0,1,1,0.01,1,1,0,0,0,-1,-0.99,0,0,-1,-0.99,0,0.99,1,0.99,0.99,0.99,0,0
180,1.01,0.99,1,0.01,0.0,0.0,0.25,1.01,0.01,25.01,-0.99,0.01,-24.99,0,25,1,26,0.99,1,-24,0,0,25,-1,-0.01,-25,625,24,24.99,25,24.792,1,0.01,0.01,24.792,0,25
181,1.99,0.01,625,618.75,612.56,0.0,618.75,49.75,24.75,49.75,-0.25,24.75,-0.25,0,625,25,50,0.25,25,0,0,0,25,-25,-24.75,-25,625,0,0.25,25,327.902,25,24.75,0.99,327.902,0,25
182,1.99,0.01,1,0.99,0.98,0.0,24.75,1.99,0.99,25.99,-0.01,0.99,-24.01,0,25,1,26,0.01,1,-24,0,0,25,-1,-0.99,-25,625,24,24.01,25,1.144,1,0.99,0.99,1.144,0,25
183,1.99,0.01,625,618.75,612.56,0.0,0.0,49.75,24.75,24.75,-0.25,24.75,24.75,0,0,25,25,0.25,25,25,0,0,0,-25,-24.75,0,0,-25,-24.75,0,322.046,25,24.75,0.99,322.046,0,0
184,1.99,0.01,1,0.99,0.98,24.75,0.0,1.99,25.99,0.99,-0.01,-24.01,0.99,25,0,26,1,0.01,-24,1,625,0,25,24,24.01,25,0,-1,-0.99,-25,25.989333333333335,1,0.99,0.99,0.9893333333333345,25,0
185,1.01,0.99,4,0.04,0.0,0.5,0.0,2.02,25.02,0.02,-1.98,-24.98,0.02,50,0,27,2,1.98,-23,2,625,0,25,23,24.98,25,0,-2,-0.02,-25,25.032,2,0.02,0.01,0.03200000000000003,25,0
186,1.99,0.01,1,0.99,0.98,0.0,0.0,1.99,0.99,0.99,-0.01,0.99,0.99,0,0,1,1,0.01,1,1,0,0,0,-1,-0.99,0,0,-1,-0.99,0,0.9886666666666667,1,0.99,0.99,0.9886666666666667,0,0
187,1.01,0.99,625,6.25,0.06,0.0,0.0,25.25,0.25,0.25,-24.75,0.25,0.25,0,0,25,25,24.75,25,25,0,0,0,-25,-0.25,0,0,-25,-0.25,0,2.9966666666666666,25,0.25,0.01,2.9966666666666666,0,0
188,1.01,0.99,196,1.96,0.02,3.5,3.5,14.14,25.14,25.14,-13.86,-24.86,-24.86,350,350,39,39,13.86,-11,-11,625,625,50,11,24.86,0,625,11,24.86,0,372.34133333333335,14,0.14,0.01,347.34133333333335,25,25
189,1.99,0.01,625,618.75,612.56,618.75,321.75,49.75,49.75,37.75,-0.25,-0.25,11.75,625,325,50,38,0.25,0,12,625,325,38,0,0.25,12,169,-12,-11.75,-12,350.08666666666664,25,24.75,0.99,325.08666666666664,25,13
190,1.01,0.99,225,2.25,0.02,3.75,3.45,15.15,25.15,23.15,-14.85,-24.85,-22.85,375,345,40,38,14.85,-10,-8,625,575,48,10,24.85,2,529,8,22.85,-2,367.71733333333333,15,0.15,0.01,342.71733333333333,25,23
191,1.99,0.01,625,618.75,612.56,618.75,321.75,49.75,49.75,37.75,-0.25,-0.25,11.75,625,325,50,38,0.25,0,12,625,325,38,0,0.25,12,169,-12,-11.75,-12,350.04133333333334,25,24.75,0.99,325.04133333333334,25,13
192,1.99,0.01,625,618.75,612.56,0.0,618.75,49.75,24.75,49.75,-0.25,24.75,-0.25,0,625,25,50,0.25,25,0,0,0,25,-25,-24.75,-25,625,0,0.25,25,328.048,25,24.75,0.99,328.048,0,25
193,1.99,0.01,196,194.04,192.1,0.0,346.5,27.86,13.86,38.86,-0.14,13.86,-11.14,0,350,14,39,0.14,14,-11,0,0,25,-14,-13.86,-25,625,11,11.14,25,107.39866666666667,14,13.86,0.99,107.39866666666667,0,25
194,1.99,0.01,625,618.75,612.56,0.0,618.75,49.75,24.75,49.75,-0.25,24.75,-0.25,0,625,25,50,0.25,25,0,0,0,25,-25,-24.75,-25,625,0,0.25,25,328.16266666666667,25,24.75,0.99,328.16266666666667,0,25
195,1.99,0.01,169,167.31,165.64,0.0,321.75,25.87,12.87,37.87,-0.13,12.87,-12.13,0,325,13,38,0.13,13,-12,0,0,25,-13,-12.87,-25,625,12,12.13,25,93.372,13,12.87,0.99,93.372,0,25
196,1.99,0.01,625,618.75,612.56,618.75,0.0,49.75,49.75,24.75,-0.25,-0.25,24.75,625,0,50,25,0.25,0,25,625,0,25,0,0.25,25,0,-25,-24.75,-25,347.0106666666667,25,24.75,0.99,322.0106666666667,25,0
197,1.99,0.01,625,618.75,612.56,0.0,0.0,49.75,24.75,24.75,-0.25,24.75,24.75,0,0,25,25,0.25,25,25,0,0,0,-25,-24.75,0,0,-25,-24.75,0,321.75866666666667,25,24.75,0.99,321.75866666666667,0,0
198,1.99,0.01,625,618.75,612.56,618.75,618.75,49.75,49.75,49.75,-0.25,-0.25,-0.25,625,625,50,50,0.25,0,0,625,625,50,0,0.25,0,625,0,0.25,0,353.192,25,24.75,0.99,328.192,25,25
199,1.99,0.01,625,618.75,612.56,0.0,321.75,49.75,24.75,37.75,-0.25,24.75,11.75,0,325,25,38,0.25,25,12,0,0,13,-25,-24.75,-13,169,-12,-11.75,13,325.006,25,24.75,0.99,325.006,0,13
200,1.99,0.01,625,618.75,612.56,0.0,618.75,49.75,24.75,49.75,-0.25,24.75,-0.25,0,625,25,50,0.25,25,0,0,0,25,-25,-24.75,-25,625,0,0.25,25,328.1073333333333,25,24.75,0.99,328.1073333333333,0,25
201,1.99,0.01,625,618.75,612.56,0.0,321.75,49.75,24.75,37.75,-0.25,24.75,11.75,0,325,25,38,0.25,25,12,0,0,13,-25,-24.75,-13,169,-12,-11.75,13,325.0713333333333,25,24.75,0.99,325.0713333333333,0,13
202,1.01,0.99,169,1.69,0.02,3.25,3.25,13.13,25.13,25.13,-12.87,-24.87,-24.87,325,325,38,38,12.87,-12,-12,625,625,50,12,24.87,0,625,12,24.87,0,347.3813333333333,13,0.13,0.010000006329579965,322.3813333333333,25,25
203,1.99,0.01,625,618.75,612.56,618.75,321.75,49.75,49.75,37.75,-0.25,-0.25,11.75,625,325,50,38,0.25,0,12,625,325,38,0,0.25,12,169,-12,-11.75,-12,349.872,25,24.75,0.99,324.872,25,13
204,1.01,0.99,625,6.25,0.06,0.0,3.25,25.25,0.25,13.25,-24.75,0.25,-12.75,0,325,25,38,24.75,25,12,0,0,13,-25,-0.25,-13,169,-12,12.75,13,325.03133333333335,25,0.25,0.01,325.03133333333335,0,13
205,1.99,0.01,625,618.75,612.56,0.0,0.0,49.75,24.75,24.75,-0.25,24.75,24.75,0,0,25,25,0.25,25,25,0,0,0,-25,-24.75,0,0,-25,-24.75,0,321.80266666666665,25,24.75,0.99,321.80266666666665,0,0
206,1.99,0.01,1,0.99,0.98,0.0,0.99,1.99,0.99,1.99,-0.01,0.99,-0.01,0,1,1,2,0.01,1,0,0,0,1,-1,-0.99,-1,1,0,0.01,1,1.0,1,0.99,0.99,1.0,0,1
207,1.99,0.01,1,0.99,0.98,0.0,0.0,1.99,0.99,0.99,-0.01,0.99,0.99,0,0,1,1,0.01,1,1,0,0,0,-1,-0.99,0,0,-1,-0.99,0,0.99,1,0.99,0.99,0.99,0,0
208,1.01,0.99,1,0.01,0.0,0.0,0.25,1.01,0.01,25.01,-0.99,0.01,-24.99,0,25,1,26,0.99,1,-24,0,0,25,-1,-0.01,-25,625,24,24.99,25,24.792,1,0.01,0.01,24.792,0,25
209,1.99,0.01,625,618.75,612.56,0.0,618.75,49.75,24.75,49.75,-0.25,24.75,-0.25,0,625,25,50,0.25,25,0,0,0,25,-25,-24.75,-25,625,0,0.25,25,327.902,25,24.75,0.99,327.902,0,25
210,1.99,0.01,1,0.99,0.98,0.0,24.75,1.99,0.99,25.99,-0.01,0.99,-24.01,0,25,1,26,0.01,1,-24,0,0,25,-1,-0.99,-25,625,24,24.01,25,1.144,1,0.99,0.99,1.144,0,25
211,1.99,0.01,625,618.75,612.56,0.0,0.0,49.75,24.75,24.75,-0.25,24.75,24.75,0,0,25,25,0.25,25,25,0,0,0,-25,-24.75,0,0,-25,-24.75,0,322.046,25,24.75,0.99,322.046,0,0
212,1.99,0.01,1,0.99,0.98,24.75,0.0,1.99,25.99,0.99,-0.01,-24.01,0.99,25,0,26,1,0.01,-24,1,625,0,25,24,24.01,25,0,-1,-0.99,-25,25.989333333333335,1,0.99,0.99,0.9893333333333345,25,0
213,1.01,0.99,4,0.04,0.0,0.5,0.0,2.02,25.02,0.02,-1.98,-24.98,0.02,50,0,27,2,1.98,-23,2,625,0,25,23,24.98,25,0,-2,-0.02,-25,25.032,2,0.02,0.01,0.03200000000000003,25,0
214,1.99,0.01,1,0.99,0.98,0.0,0.0,1.99,0.99,0.99,-0.01,0.99,0.99,0,0,1,1,0.01,1,1,0,0,0,-1,-0.99,0,0,-1,-0.99,0,0.9886666666666667,1,0.99,0.99,0.9886666666666667,0,0
215,1.01,0.99,625,6.25,0.06,0.0,0.0,25.25,0.25,0.25,-24.75,0.25,0.25,0,0,25,25,24.75,25,25,0,0,0,-25,-0.25,0,0,-25,-0.25,0,2.9966666666666666,25,0.25,0.01,2.9966666666666666,0,0
216,1.01,0.99,196,1.96,0.02,3.5,3.5,14.14,25.14,25.14,-13.86,-24.86,-24.86,350,350,39,39,13.86,-11,-11,625,625,50,11,24.86,0,625,11,24.86,0,372.34133333333335,14,0.14,0.01,347.34133333333335,25,25
217,1.99,0.01,625,618.75,612.56,618.75,321.75,49.75,49.75,37.75,-0.25,-0.25,11.75,625,325,50,38,0.25,0,12,625,325,38,0,0.25,12,169,-12,-11.75,-12,350.08666666666664,25,24.75,0.99,325.08666666666664,25,13
218,1.01,0.99,225,2.25,0.02,3.75,3.45,15.15,25.15,23.15,-14.85,-24.85,-22.85,375,345,40,38,14.85,-10,-8,625,575,48,10,24.85,2,529,8,22.85,-2,367.71733333333333,15,0.15,0.01,342.71733333333333,25,23
219,1.99,0.01,625,618.75,612.56,618.75,321.75,49.75,49.75,37.75,-0.25,-0.25,11.75,625,325,50,38,0.25,0,12,625,325,38,0,0.25,12,169,-12,-11.75,-12,350.04133333333334,25,24.75,0.99,325.04133333333334,25,13
220,1.99,0.01,625,618.75,612.56,0.0,618.75,49.75,24.75,49.75,-0.25,24.75,-0.25,0,625,25,50,0.25,25,0,0,0,25,-25,-24.75,-25,625,0,0.25,25,328.048,25,24.75,0.99,328.048,0,25
221,1.99,0.01,196,194.04,192.1,0.0,346.5,27.86,13.86,38.86,-0.14,13.86,-11.14,0,350,14,39,0.14,14,-11,0,0,25,-14,-13.86,-25,625,11,11.14,25,107.39866666666667,14,13.86,0.99,107.39866666666667,0,25
222,1.99,0.01,625,618.75,612.56,0.0,618.75,49.75,24.75,49.75,-0.25,24.75,-0.25,0,625,25,50,0.25,25,0,0,0,25,-25,-24.75,-25,625,0,0.25,25,328.16266666666667,25,24.75,0.99,328.16266666666667,0,25
223,1.99,0.01,169,167.31,165.64,0.0,321.75,25.87,12.87,37.87,-0.13,12.87,-12.13,0,325,13,38,0.13,13,-12,0,0,25,-13,-12.87,-25,625,12,12.13,25,93.372,13,12.87,0.99,93.372,0,25
224,1.99,0.01,625,618.75,612.56,618.75,0.0,49.75,49.75,24.75,-0.25,-0.25,24.75,625,0,50,25,0.25,0,25,625,0,25,0,0.25,25,0,-25,-24.75,-25,347.0106666666667,25,24.75,0.99,322.0106666666667,25,0
225,1.99,0.01,625,618.75,612.56,0.0,0.0,49.75,24.75,24.75,-0.25,24.75,24.75,0,0,25,25,0.25,25,25,0,0,0,-25,-24.75,0,0,-25,-24.75,0,321.75866666666667,25,24.75,0.99,321.75866666666667,0,0
226,1.99,0.01,625,618.75,612.56,618.75,618.75,49.75,49.75,49.75,-0.25,-0.25,-0.25,625,625,50,50,0.25,0,0,625,625,50,0,0.25,0,625,0,0.25,0,353.192,25,24.75,0.99,328.192,25,25
227,1.99,0.01,625,618.75,612.56,0.0,321.75,49.75,24.75,37.75,-0.25,24.75,11.75,0,325,25,38,0.25,25,12,0,0,13,-25,-24.75,-13,169,-12,-11.75,13,325.006,25,24.75,0.99,325.006,0,13
228,1.99,0.01,625,618.75,612.56,0.0,618.75,49.75,24.75,49.75,-0.25,24.75,-0.25,0,625,25,50,0.25,25,0,0,0,25,-25,-24.75,-25,625,0,0.25,25,328.1073333333333,25,24.75,0.99,328.1073333333333,0,25
229,1.99,0.01,625,618.75,612.56,0.0,321.75,49.75,24.75,37.75,-0.25,24.75,11.75,0,325,25,38,0.25,25,12,0,0,13,-25,-24.75,-13,169,-12,-11.75,13,325.0713333333333,25,24.75,0.99,325.0713333333333,0,13
230,1.01,0.99,169,1.69,0.02,3.25,3.25,13.13,25.13,25.13,-12.87,-24.87,-24.87,325,325,38,38,12.87,-12,-12,625,625,50,12,24.87,0,625,12,24.87,0,347.3813333333333,13,0.13,0.010000006329579965,322.3813333333333,25,25
231,1.99,0.01,625,618.75,612.56,618.75,321.75,49.75,49.75,37.75,-0.25,-0.25,11.75,625,325,50,38,0.25,0,12,625,325,38,0,0.25,12,169,-12,-11.75,-12,349.872,25,24.75,0.99,324.872,25,13
232,1.01,0.99,625,6.25,0.06,0.0,3.25,25.25,0.25,13.25,-24.75,0.25,-12.75,0,325,25,38,24.75,25,12,0,0,13,-25,-0.25,-13,169,-12,12.75,13,325.03133333333335,25,0.25,0.01,325.03133333333335,0,13
233,1.99,0.01,625,618.75,612.56,0.0,0.0,49.75,24.75,24.75,-0.25,24.75,24.75,0,0,25,25,0.25,25,25,0,0,0,-25,-24.75,0,0,-25,-24.75,0,321.80266666666665,25,24.75,0.99,321.80266666666665,0,0
234,1.99,0.01,1,0.99,0.98,0.0,0.99,1.99,0.99,1.99,-0.01,0.99,-0.01,0,1,1,2,0.01,1,0,0,0,1,-1,-0.99,-1,1,0,0.01,1,1.0,1,0.99,0.99,1.0,0,1
235,1.99,0.01,1,0.99,0.98,0.0,0.0,1.99,0.99,0.99,-0.01,0.99,0.99,0,0,1,1,0.01,1,1,0,0,0,-1,-0.99,0,0,-1,-0.99,0,0.99,1,0.99,0.99,0.99,0,0
236,1.01,0.99,1,0.01,0.0,0.0,0.25,1.01,0.01,25.01,-0.99,0.01,-24.99,0,25,1,26,0.99,1,-24,0,0,25,-1,-0.01,-25,625,24,24.99,25,24.792,1,0.01,0.01,24.792,0,25
237,1.99,0.01,625,618.75,612.56,0.0,618.75,49.75,24.75,49.75,-0.25,24.75,-0.25,0,625,25,50,0.25,25,0,0,0,25,-25,-24.75,-25,625,0,0.25,25,327.902,25,24.75,0.99,327.902,0,25
238,1.99,0.01,1,0.99,0.98,0.0,24.75,1.99,0.99,25.99,-0.01,0.99,-24.01,0,25,1,26,0.01,1,-24,0,0,25,-1,-0.99,-25,625,24,24.01,25,1.144,1,0.99,0.99,1.144,0,25
239,1.99,0.01,625,618.75,612.56,0.0,0.0,49.75,24.75,24.75,-0.25,24.75,24.75,0,0,25,25,0.25,25,25,0,0,0,-25,-24.75,0,0,-25,-24.75,0,322.046,25,24.75,0.99,322.046,0,0
240,1.99,0.01,1,0.99,0.98,24.75,0.0,1.99,25.99,0.99,-0.01,-24.01,0.99,25,0,26,1,0.01,-24,1,625,0,25,24,24.01,25,0,-1,-0.99,-25,25.989333333333335,1,0.99,0.99,0.9893333333333345,25,0
241,1.01,0.99,4,0.04,0.0,0.5,0.0,2.02,25.02,0.02,-1.98,-24.98,0.02,50,0,27,2,1.98,-23,2,625,0,25,23,24.98,25,0,-2,-0.02,-25,25.032,2,0.02,0.01,0.03200000000000003,25,0
242,1.99,0.01,1,0.99,0.98,0.0,0.0,1.99,0.99,0.99,-0.01,0.99,0.99,0,0,1,1,0.01,1,1,0,0,0,-1,-0.99,0,0,-1,-0.99,0,0.9886666666666667,1,0.99,0.99,0.9886666666666667,0,0
243,1.01,0.99,625,6.25,0.06,0.0,0.0,25.25,0.25,0.25,-24.75,0.25,0.25,0,0,25,25,24.75,25,25,0,0,0,-25,-0.25,0,0,-25,-0.25,0,2.9966666666666666,25,0.25,0.01,2.9966666666666666,0,0
244,1.01,0.99,196,1.96,0.02,3.5,3.5,14.14,25.14,25.14,-13.86,-24.86,-24.86,350,350,39,39,13.86,-11,-11,625,625,50,11,24.86,0,625,11,24.86,0,372.34133333333335,14,0.14,0.01,347.34133333333335,25,25
245,1.99,0.01,625,618.75,612.56,618.75,321.75,49.75,49.75,37.75,-0.25,-0.25,11.75,625,325,50,38,0.25,0,12,625,325,38,0,0.25,12,169,-12,-11.75,-12,350.08666666666664,25,24.75,0.99,325.08666666666664,25,13
246,1.01,0.99,225,2.25,0.02,3.75,3.45,15.15,25.15,23.15,-14.85,-24.85,-22.85,375,345,40,38,14.85,-10,-8,625,575,48,10,24.85,2,529,8,22.85,-2,367.71733333333333,15,0.15,0.01,342.71733333333333,25,23
247,1.99,0.01,625,618.75,612.56,618.75,321.75,49.75,49.75,37.75,-0.25,-0.25,11.75,625,325,50,38,0.25,0,12,625,325,38,0,0.25,12,169,-12,-11.75,-12,350.04133333333334,25,24.75,0.99,325.04133333333334,25,13
248,1.99,0.01,625,618.75,612.56,0.0,618.75,49.75,24.75,49.75,-0.25,24.75,-0.25,0,625,25,50,0.25,25,0,0,0,25,-25,-24.75,-25,625,0,0.25,25,328.048,25,24.75,0.99,328.048,0,25
249,1.99,0.01,196,194.04,192.1,0.0,346.5,27.86,13.86,38.86,-0.14,13.86,-11.14,0,350,14,39,0.14,14,-11,0,0,25,-14,-13.86,-25,625,11,11.14,25,107.39866666666667,14,13.86,0.99,107.39866666666667,0,25
250,1.99,0.01,625,618.75,612.56,0.0,618.75,49.75,24.75,49.75,-0.25,24.75,-0.25,0,625,25,50,0.25,25,0,0,0,25,-25,-24.75,-25,625,0,0.25,25,328.16266666666667,25,24.75,0.99,328.16266666666667,0,25
251,1.99,0.01,169,167.31,165.64,0.0,321.75,25.87,12.87,37.87,-0.13,12.87,-12.13,0,325,13,38,0.13,13,-12,0,0,25,-13,-12.87,-25,625,12,12.13,25,93.372,13,12.87,0.99,93.372,0,25
252,1.99,0.01,625,618.75,612.56,618.75,0.0,49.75,49.75,24.75,-0.25,-0.25,24.75,625,0,50,25,0.25,0,25,625,0,25,0,0.25,25,0,-25,-24.75,-25,347.0106666666667,25,24.75,0.99,322.0106666666667,25,0
253,1.99,0.01,625,618.75,612.56,0.0,0.0,49.75,24.75,24.75,-0.25,24.75,24.75,0,0,25,25,0.25,25,25,0,0,0,-25,-24.75,0,0,-25,-24.75,0,321.75866666666667,25,24.75,0.99,321.75866666666667,0,0
254,1.99,0.01,625,618.75,612.56,618.75,618.75,49.75,49.75,49.75,-0.25,-0.25,-0.25,625,625,50,50,0.25,0,0,625,625,50,0,0.25,0,625,0,0.25,0,353.192,25,24.75,0.99,328.192,25,25
255,1.99,0.01,625,618.75,612.56,0.0,321.75,49.75,24.75,37.75,-0.25,24.75,11.75,0,325,25,38,0.25,25,12,0,0,13,-25,-24.75,-13,169,-12,-11.75,13,325.006,25,24.75,0.99,325.006,0,13
256,1.99,0.01,625,618.75,612.56,0.0,618.75,49.75,24.75,49.75,-0.25,24.75,-0.25,0,625,25,50,0.25,25,0,0,0,25,-25,-24.75,-25,625,0,0.25,25,328.1073333333333,25,24.75,0.99,328.1073333333333,0,25
257,1.99,0.01,625,618.75,612.56,0.0,321.75,49.75,24.75,37.75,-0.25,24.75,11.75,0,325,25,38,0.25,25,12,0,0,13,-25,-24.75,-13,169,-12,-11.75,13,325.0713333333333,25,24.75,0.99,325.0713333333333,0,13
258,1.01,0.99,169,1.69,0.02,3.25,3.25,13.13,25.13,25.13,-12.87,-24.87,-24.87,325,325,38,38,12.87,-12,-12,625,625,50,12,24.87,0,625,12,24.87,0,347.3813333333333,13,0.13,0.010000006329579965,322.3813333333333,25,25
259,1.99,0.01,625,618.75,612.56,618.75,321.75,49.75,49.75,37.75,-0.25,-0.25,11.75,625,325,50,38,0.25,0,12,625,325,38,0,0.25,12,169,-12,-11.75,-12,349.872,25,24.75,0.99,324.872,25,13
260,1.01,0.99,625,6.25,0.06,0.0,3.25,25.25,0.25,13.25,-24.75,0.25,-12.75,0,325,25,38,24.75,25,12,0,0,13,-25,-0.25,-13,169,-12,12.75,13,325.03133333333335,25,0.25,0.01,325.03133333333335,0,13
261,1.99,0.01,625,618.75,612.56,0.0,0.0,49.75,24.75,24.75,-0.25,24.75,24.75,0,0,25,25,0.25,25,25,0,0,0,-25,-24.75,0,0,-25,-24.75,0,321.80266666666665,25,24.75,0.99,321.80266666666665,0,0
262,1.99,0.01,1,0.99,0.98,0.0,0.99,1.99,0.99,1.99,-0.01,0.99,-0.01,0,1,1,2,0.01,1,0,0,0,1,-1,-0.99,-1,1,0,0.01,1,1.0,1,0.99,0.99,1.0,0,1
263,1.99,0.01,1,0.99,0.98,0.0,0.0,1.99,0.99,0.99,-0.01,0.99,0.99,0,0,1,1,0.01,1,1,0,0,0,-1,-0.99,0,0,-1,-0.99,0,0.99,1,0.99,0.99,0.99,0,0
264,1.01,0.99,1,0.01,0.0,0.0,0.25,1.01,0.01,25.01,-0.99,0.01,-24.99,0,25,1,26,0.99,1,-24,0,0,25,-1,-0.01,-25,625,24,24.99,25,24.792,1,0.01,0.01,24.792,0,25
265,1.99,0.01,625,618.75,612.56,0.0,618.75,49.75,24.75,49.75,-0.25,24.75,-0.25,0,625,25,50,0.25,25,0,0,0,25,-25,-24.75,-25,625,0,0.25,25,327.902,25,24.75,0.99,327.902,0,25
266,1.99,0.01,1,0.99,0.98,0.0,24.75,1.99,0.99,25.99,-0.01,0.99,-24.01,0,25,1,26,0.01,1,-24,0,0,25,-1,-0.99,-25,625,24,24.01,25,1.144,1,0.99,0.99,1.144,0,25
267,1.99,0.01,625,618.75,612.56,0.0,0.0,49.75,24.75,24.75,-0.25,24.75,24.75,0,0,25,25,0.25,25,25,0,0,0,-25,-24.75,0,0,-25,-24.75,0,322.046,25,24.75,0.99,322.046,0,0
268,1.99,0.01,1,0.99,0.98,24.75,0.0,1.99,25.99,0.99,-0.01,-24.01,0.99,25,0,26,1,0.01,-24,1,625,0,25,24,24.01,25,0,-1,-0.99,-25,25.989333333333335,1,0.99,0.99,0.9893333333333345,25,0
269,1.01,0.99,4,0.04,0.0,0.5,0.0,2.02,25.02,0.02,-1.98,-24.98,0.02,50,0,27,2,1.98,-23,2,625,0,25,23,24.98,25,0,-2,-0.02,-25,25.032,2,0.02,0.01,0.03200000000000003,25,0
270,1.99,0.01,1,0.99,0.98,0.0,0.0,1.99,0.99,0.99,-0.01,0.99,0.99,0,0,1,1,0.01,1,1,0,0,0,-1,-0.99,0,0,-1,-0.99,0,0.9886666666666667,1,0.99,0.99,0.9886666666666667,0,0
271,1.01,0.99,625,6.25,0.06,0.0,0.0,25.25,0.25,0.25,-24.75,0.25,0.25,0,0,25,25,24.75,25,25,0,0,0,-25,-0.25,0,0,-25,-0.25,0,2.9966666666666666,25,0.25,0.01,2.9966666666666666,0,0
272,1.01,0.99,196,1.96,0.02,3.5,3.5,14.14,25.14,25.14,-13.86,-24.86,-24.86,350,350,39,39,13.86,-11,-11,625,625,50,11,24.86,0,625,11,24.86,0,372.34133333333335,14,0.14,0.01,347.34133333333335,25,25
273,1.99,0.01,625,618.75,612.56,618.75,321.75,49.75,49.75,37.75,-0.25,-0.25,11.75,625,325,50,38,0.25,0,12,625,325,38,0,0.25,12,169,-12,-11.75,-12,350.08666666666664,25,24.75,0.99,325.08666666666664,25,13
274,1.01,0.99,225,2.25,0.02,3.75,3.45,15.15,25.15,23.15,-14.85,-24.85,-22.85,375,345,40,38,14.85,-10,-8,625,575,48,10,24.85,2,529,8,22.85,-2,367.71733333333333,15,0.15,0.01,342.71733333333333,25,23
275,1.99,0.01,625,618.75,612.56,618.75,321.75,49.75,49.75,37.75,-0.25,-0.25,11.75,625,325,50,38,0.25,0,12,625,325,38,0,0.25,12,169,-12,-11.75,-12,350.04133333333334,25,24.75,0.99,325.04133333333334,25,13
276,1.99,0.01,625,618.75,612.56,0.0,618.75,49.75,24.75,49.75,-0.25,24.75,-0.25,0,625,25,50,0.25,25,0,0,0,25,-25,-24.75,-25,625,0,0.25,25,328.048,25,24.75,0.99,328.048,0,25
277,1.99,0.01,196,194.04,192.1,0.0,346.5,27.86,13.86,38.86,-0.14,13.86,-11.14,0,350,14,39,0.14,14,-11,0,0,25,-14,-13.86,-25,625,11,11.14,25,107.39866666666667,14,13.86,0.99,107.39866666666667,0,25
278,1.99,0.01,625,618.75,612.56,0.0,618.75,49.75,24.75,49.75,-0.25,24.75,-0.25,0,625,25,50,0.25,25,0,0,0,25,-25,-24.75,-25,625,0,0.25,25,328.16266666666667,25,24.75,0.99,328.16266666666667,0,25
279,1.99,0.01,169,167.31,165.64,0.0,321.75,25.87,12.87,37.87,-0.13,12.87,-12.13,0,325,13,38,0.13,13,-12,0,0,25,-13,-12.87,-25,625,12,12.13,25,93.372,13,12.87,0.99,93.372,0,25
280,1.99,0.01,625,618.75,612.56,618.75,0.0,49.75,49.75,24.75,-0.25,-0.25,24.75,625,0,50,25,0.25,0,25,625,0,25,0,0.25,25,0,-25,-24.75,-25,347.0106666666667,25,24.75,0.99,322.0106666666667,25,0
281,1.99,0.01,625,618.75,612.56,0.0,0.0,49.75,24.75,24.75,-0.25,24.75,24.75,0,0,25,25,0.25,25,25,0,0,0,-25,-24.75,0,0,-25,-24.75,0,321.75866666666667,25,24.75,0.99,321.75866666666667,0,0
282,1.99,0.01,625,618.75,612.56,618.75,618.75,49.75,49.75,49.75,-0.25,-0.25,-0.25,625,625,50,50,0.25,0,0,625,625,50,0,0.25,0,625,0,0.25,0,353.192,25,24.75,0.99,328.192,25,25
283,1.99,0.01,625,618.75,612.56,0.0,321.75,49.75,24.75,37.75,-0.25,24.75,11.75,0,325,25,38,0.25,25,12,0,0,13,-25,-24.75,-13,169,-12,-11.75,13,325.006,25,24.75,0.99,325.006,0,13
284,1.99,0.01,625,618.75,612.56,0.0,618.75,49.75,24.75,49.75,-0.25,24.75,-0.25,0,625,25,50,0.25,25,0,0,0,25,-25,-24.75,-25,625,0,0.25,25,328.1073333333333,25,24.75,0.99,328.1073333333333,0,25
285,1.99,0.01,625,618.75,612.56,0.0,321.75,49.75,24.75,37.75,-0.25,24.75,11.75,0,325,25,38,0.25,25,12,0,0,13,-25,-24.75,-13,169,-12,-11.75,13,325.0713333333333,25,24.75,0.99,325.0713333333333,0,13
286,1.01,0.99,169,1.69,0.02,3.25,3.25,13.13,25.13,25.13,-12.87,-24.87,-24.87,325,325,38,38,12.87,-12,-12,625,625,50,12,24.87,0,625,12,24.87,0,347.3813333333333,13,0.13,0.010000006329579965,322.3813333333333,25,25
287,1.99,0.01,625,618.75,612.56,618.75,321.75,49.75,49.75,37.75,-0.25,-0.25,11.75,625,325,50,38,0.25,0,12,625,325,38,0,0.25,12,169,-12,-11.75,-12,349.872,25,24.75,0.99,324.872,25,13
288,1.01,0.99,625,6.25,0.06,0.0,3.25,25.25,0.25,13.25,-24.75,0.25,-12.75,0,325,25,38,24.75,25,12,0,0,13,-25,-0.25,-13,169,-12,12.75,13,325.03133333333335,25,0.25,0.01,325.03133333333335,0,13
289,1.99,0.01,625,618.75,612.56,0.0,0.0,49.75,24.75,24.75,-0.25,24.75,24.75,0,0,25,25,0.25,25,25,0,0,0,-25,-24.75,0,0,-25,-24.75,0,321.80266666666665,25,24.75,0.99,321.80266666666665,0,0
290,1.99,0.01,1,0.99,0.98,0.0,0.99,1.99,0.99,1.99,-0.01,0.99,-0.01,0,1,1,2,0.01,1,0,0,0,1,-1,-0.99,-1,1,0,0.01,1,1.0,1,0.99,0.99,1.0,0,1
291,1.99,0.01,1,0.99,0.98,0.0,0.0,1.99,0.99,0.99,-0.01,0.99,0.99,0,0,1,1,0.01,1,1,0,0,0,-1,-0.99,0,0,-1,-0.99,0,0.99,1,0.99,0.99,0.99,0,0
292,1.01,0.99,1,0.01,0.0,0.0,0.25,1.01,0.01,25.01,-0.99,0.01,-24.99,0,25,1,26,0.99,1,-24,0,0,25,-1,-0.01,-25,625,24,24.99,25,24.792,1,0.01,0.01,24.792,0,25
293,1.99,0.01,625,618.75,612.56,0.0,618.75,49.75,24.75,49.75,-0.25,24.75,-0.25,0,625,25,50,0.25,25,0,0,0,25,-25,-24.75,-25,625,0,0.25,25,327.902,25,24.75,0.99,327.902,0,25
294,1.99,0.01,1,0.99,0.98,0.0,24.75,1.99,0.99,25.99,-0.01,0.99,-24.01,0,25,1,26,0.01,1,-24,0,0,25,-1,-0.99,-25,625,24,24.01,25,1.144,1,0.99,0.99,1.144,0,25
295,1.99,0.01,625,618.75,612.56,0.0,0.0,49.75,24.75,24.75,-0.25,24.75,24.75,0,0,25,25,0.25,25,25,0,0,0,-25,-24.75,0,0,-25,-24.75,0,322.046,25,24.75,0.99,322.046,0,0
296,1.99,0.01,1,0.99,0.98,24.75,0.0,1.99,25.99,0.99,-0.01,-24.01,0.99,25,0,26,1,0.01,-24,1,625,0,25,24,24.01,25,0,-1,-0.99,-25,25.989333333333335,1,0.99,0.99,0.9893333333333345,25,0
297,1.01,0.99,4,0.04,0.0,0.5,0.0,2.02,25.02,0.02,-1.98,-24.98,0.02,50,0,27,2,1.98,-23,2,625,0,25,23,24.98,25,0,-2,-0.02,-25,25.032,2,0.02,0.01,0.03200000000000003,25,0
298,1.99,0.01,1,0.99,0.98,0.0,0.0,1.99,0.99,0.99,-0.01,0.99,0.99,0,0,1,1,0.01,1,1,0,0,0,-1,-0.99,0,0,-1,-0.99,0,0.9886666666666667,1,0.99,0.99,0.9886666666666667,0,0
299,1.01,0.99,625,6.25,0.06,0.0,0.0,25.25,0.25,0.25,-24.75,0.25,0.25,0,0,25,25,24.75,25,25,0,0,0,-25,-0.25,0,0,-25,-0.25,0,2.9966666666666666,25,0.25,0.01,2.9966666666666666,0,0
300,1.01,0.99,196,1.96,0.02,3.5,3.5,14.14,25.14,25.14,-13.86,-24.86,-24.86,350,350,39,39,13.86,-11,-11,625,625,50,11,24.86,0,625,11,24.86,0,372.34133333333335,14,0.14,0.01,347.34133333333335,25,25
301,1.99,0.01,625,618.75,612.56,618.75,321.75,49.75,49.75,37.75,-0.25,-0.25,11.75,625,325,50,38,0.25,0,12,625,325,38,0,0.25,12,169,-12,-11.75,-12,350.08666666666664,25,24.75,0.99,325.08666666666664,25,13
302,1.01,0.99,225,2.25,0.02,3.75,3.45,15.15,25.15,23.15,-14.85,-24.85,-22.85,375,345,40,38,14.85,-10,-8,625,575,48,10,24.85,2,529,8,22.85,-2,367.71733333333333,15,0.15,0.01,342.71733333333333,25,23
303,1.99,0.01,625,618.75,612.56,618.75,321.75,49.75,49.75,37.75,-0.25,-0.25,11.75,625,325,50,38,0.25,0,12,625,325,38,0,0.25,12,169,-12,-11.75,-12,350.04133333333334,25,24.75,0.99,325.04133333333334,25,13
304,1.99,0.01,625,618.75,612.56,0.0,618.75,49.75,24.75,49.75,-0.25,24.75,-0.25,0,625,25,50,0.25,25,0,0,0,25,-25,-24.75,-25,625,0,0.25,25,328.048,25,24.75,0.99,328.048,0,25
305,1.99,0.01,196,194.04,192.1,0.0,346.5,27.86,13.86,38.86,-0.14,13.86,-11.14,0,350,14,39,0.14,14,-11,0,0,25,-14,-13.86,-25,625,11,11.14,25,107.39866666666667,14,13.86,0.99,107.39866666666667,0,25
306,1.99,0.01,625,618.75,612.56,0.0,618.75,49.75,24.75,49.75,-0.25,24.75,-0.25,0,625,25,50,0.25,25,0,0,0,25,-25,-24.75,-25,625,0,0.25,25,328.16266666666667,25,24.75,0.99,328.16266666666667,0,25
307,1.99,0.01,169,167.31,165.64,0.0,321.75,25.87,12.87,37.87,-0.13,12.87,-12.13,0,325,13,38,0.13,13,-12,0,0,25,-13,-12.87,-25,625,12,12.13,25,93.372,13,12.87,0.99,93.372,0,25
308,1.99,0.01,625,618.75,612.56,618.75,0.0,49.75,49.75,24.75,-0.25,-0.25,24.75,625,0,50,25,0.25,0,25,625,0,25,0,0.25,25,0,-25,-24.75,-25,347.0106666666667,25,24.75,0.99,322.0106666666667,25,0
309,1.99,0.01,625,618.75,612.56,0.0,0.0,49.75,24.75,24.75,-0.25,24.75,24.75,0,0,25,25,0.25,25,25,0,0,0,-25,-24.75,0,0,-25,-24.75,0,321.75866666666667,25,24.75,0.99,321.75866666666667,0,0
310,1.99,0.01,625,618.75,612.56,618.75,618.75,49.75,49.75,49.75,-0.25,-0.25,-0.25,625,625,50,50,0.25,0,0,625,625,50,0,0.25,0,625,0,0.25,0,353.192,25,24.75,0.99,328.192,25,25
311,1.99,0.01,625,618.75,612.56,0.0,321.75,49.75,24.75,37.75,-0.25,24.75,11.75,0,325,25,38,0.25,25,12,0,0,13,-25,-24.75,-13,169,-12,-11.75,13,325.006,25,24.75,0.99,325.006,0,13
312,1.99,0.01,625,618.75,612.56,0.0,618.75,49.75,24.75,49.75,-0.25,24.75,-0.25,0,625,25,50,0.25,25,0,0,0,25,-25,-24.75,-25,625,0,0.25,25,328.1073333333333,25,24.75,0.99,328.1073333333333,0,25
313,1.99,0.01,625,618.75,612.56,0.0,321.75,49.75,24.75,37.75,-0.25,24.75,11.75,0,325,25,38,0.25,25,12,0,0,13,-25,-24.75,-13,169,-12,-11.75,13,325.0713333333333,25,24.75,0.99,325.0713333333333,0,13
314,1.01,0.99,169,1.69,0.02,3.25,3.25,13.13,25.13,25.13,-12.87,-24.87,-24.87,325,325,38,38,12.87,-12,-12,625,625,50,12,24.87,0,625,12,24.87,0,347.3813333333333,13,0.13,0.010000006329579965,322.3813333333333,25,25
315,1.99,0.01,625,618.75,612.56,618.75,321.75,49.75,49.75,37.75,-0.25,-0.25,11.75,625,325,50,38,0.25,0,12,625,325,38,0,0.25,12,169,-12,-11.75,-12,349.872,25,24.75,0.99,324.872,25,13
316,1.01,0.99,625,6.25,0.06,0.0,3.25,25.25,0.25,13.25,-24.75,0.25,-12.75,0,325,25,38,24.75,25,12,0,0,13,-25,-0.25,-13,169,-12,12.75,13,325.03133333333335,25,0.25,0.01,325.03133333333335,0,13
317,1.99,0.01,625,618.75,612.56,0.0,0.0,49.75,24.75,24.75,-0.25,24.75,24.75,0,0,25,25,0.25,25,25,0,0,0,-25,-24.75,0,0,-25,-24.75,0,321.80266666666665,25,24.75,0.99,321.80266666666665,0,0
318,1.99,0.01,1,0.99,0.98,0.0,0.99,1.99,0.99,1.99,-0.01,0.99,-0.01,0,1,1,2,0.01,1,0,0,0,1,-1,-0.99,-1,1,0,0.01,1,1.0,1,0.99,0.99,1.0,0,1
319,1.99,0.01,1,0.99,0.98,0.0,0.0,1.99,0.99,0.99,-0.01,0.99,0.99,0,0,1,1,0.01,1,1,0,0,0,-1,-0.99,0,0,-1,-0.99,0,0.99,1,0.99,0.99,0.99,0,0
320,1.01,0.99,1,0.01,0.0,0.0,0.25,1.01,0.01,25.01,-0.99,0.01,-24.99,0,25,1,26,0.99,1,-24,0,0,25,-1,-0.01,-25,625,24,24.99,25,24.792,1,0.01,0.01,24.792,0,25
321,1.99,0.01,625,618.75,612.56,0.0,618.75,49.75,24.75,49.75,-0.25,24.75,-0.25,0,625,25,50,0.25,25,0,0,0,25,-25,-24.75,-25,625,0,0.25,25,327.902,25,24.75,0.99,327.902,0,25
322,1.99,0.01,1,0.99,0.98,0.0,24.75,1.99,0.99,25.99,-0.01,0.99,-24.01,0,25,1,26,0.01,1,-24,0,0,25,-1,-0.99,-25,625,24,24.01,25,1.144,1,0.99,0.99,1.144,0,25
323,1.99,0.01,625,618.75,612.56,0.0,0.0,49.75,24.75,24.75,-0.25,24.75,24.75,0,0,25,25,0.25,25,25,0,0,0,-25,-24.75,0,0,-25,-24.75,0,322.046,25,24.75,0.99,322.046,0,0
324,1.99,0.01,1,0.99,0.98,24.75,0.0,1.99,25.99,0.99,-0.01,-24.01,0.99,25,0,26,1,0.01,-24,1,625,0,25,24,24.01,25,0,-1,-0.99,-25,25.989333333333335,1,0.99,0.99,0.9893333333333345,25,0
325,1.01,0.99,4,0.04,0.0,0.5,0.0,2.02,25.02,0.02,-1.98,-24.98,0.02,50,0,27,2,1.98,-23,2,625,0,25,23,24.98,25,0,-2,-0.02,-25,25.032,2,0.02,0.01,0.03200000000000003,25,0
326,1.99,0.01,1,0.99,0.98,0.0,0.0,1.99,0.99,0.99,-0.01,0.99,0.99,0,0,1,1,0.01,1,1,0,0,0,-1,-0.99,0,0,-1,-0.99,0,0.9886666666666667,1,0.99,0.99,0.9886666666666667,0,0
327,1.01,0.99,625,6.25,0.06,0.0,0.0,25.25,0.25,0.25,-24.75,0.25,0.25,0,0,25,25,24.75,25,25,0,0,0,-25,-0.25,0,0,-25,-0.25,0,2.9966666666666666,25,0.25,0.01,2.9966666666666666,0,0
328,1.01,0.99,196,1.96,0.02,3.5,3.5,14.14,25.14,25.14,-13.86,-24.86,-24.86,350,350,39,39,13.86,-11,-11,625,625,50,11,24.86,0,625,11,24.86,0,372.34133333333335,14,0.14,0.01,347.34133333333335,25,25
329,1.99,0.01,625,618.75,612.56,618.75,321.75,49.75,49.75,37.75,-0.25,-0.25,11.75,625,325,50,38,0.25,0,12,625,325,38,0,0.25,12,169,-12,-11.75,-12,350.08666666666664,25,24.75,0.99,325.08666666666664,25,13
330,1.01,0.99,225,2.25,0.02,3.75,3.45,15.15,25.15,23.15,-14.85,-24.85,-22.85,375,345,40,38,14.85,-10,-8,625,575,48,10,24.85,2,529,8,22.85,-2,367.71733333333333,15,0.15,0.01,342.71733333333333,25,23
331,1.99,0.01,625,618.75,612.56,618.75,321.75,49.75,49.75,37.75,-0.25,-0.25,11.75,625,325,50,38,0.25,0,12,625,325,38,0,0.25,12,169,-12,-11.75,-12,350.04133333333334,25,24.75,0.99,325.04133333333334,25,13
332,1.99,0.01,625,618.75,612.56,0.0,618.75,49.75,24.75,49.75,-0.25,24.75,-0.25,0,625,25,50,0.25,25,0,0,0,25,-25,-24.75,-25,625,0,0.25,25,328.048,25,24.75,0.99,328.048,0,25
333,1.99,0.01,196,194.04,192.1,0.0,346.5,27.86,13.86,38.86,-0.14,13.86,-11.14,0,350,14,39,0.14,14,-11,0,0,25,-14,-13.86,-25,625,11,11.14,25,107.39866666666667,14,13.86,0.99,107.39866666666667,0,25
334,1.99,0.01,625,618.75,612.56,0.0,618.75,49.75,24.75,49.75,-0.25,24.75,-0.25,0,625,25,50,0.25,25,0,0,0,25,-25,-24.75,-25,625,0,0.25,25,328.16266666666667,25,24.75,0.99,328.16266666666667,0,25
335,1.99,0.01,169,167.31,165.64,0.0,321.75,25.87,12.87,37.87,-0.13,12.87,-12.13,0,325,13,38,0.13,13,-12,0,0,25,-13,-12.87,-25,625,12,12.13,25,93.372,13,12.87,0.99,93.372,0,25
336,1.99,0.01,625,618.75,612.56,618.75,0.0,49.75,49.75,24.75,-0.25,-0.25,24.75,625,0,50,25,0.25,0,25,625,0,25,0,0.25,25,0,-25,-24.75,-25,347.0106666666667,25,24.75,0.99,322.0106666666667,25,0
337,1.99,0.01,625,618.75,612.56,0.0,0.0,49.75,24.75,24.75,-0.25,24.75,24.75,0,0,25,25,0.25,25,25,0,0,0,-25,-24.75,0,0,-25,-24.75,0,321.75866666666667,25,24.75,0.99,321.75866666666667,0,0
338,1.99,0.01,625,618.75,612.56,618.75,618.75,49.75,49.75,49.75,-0.25,-0.25,-0.25,625,625,50,50,0.25,0,0,625,625,50,0,0.25,0,625,0,0.25,0,353.192,25,24.75,0.99,328.192,25,25
339,1.99,0.01,625,618.75,612.56,0.0,321.75,49.75,24.75,37.75,-0.25,24.75,11.75,0,325,25,38,0.25,25,12,0,0,13,-25,-24.75,-13,169,-12,-11.75,13,325.006,25,24.75,0.99,325.006,0,13
340,1.99,0.01,625,618.75,612.56,0.0,618.75,49.75,24.75,49.75,-0.25,24.75,-0.25,0,625,25,50,0.25,25,0,0,0,25,-25,-24.75,-25,625,0,0.25,25,328.1073333333333,25,24.75,0.99,328.1073333333333,0,25
341,1.99,0.01,625,618.75,612.56,0.0,321.75,49.75,24.75,37.75,-0.25,24.75,11.75,0,325,25,38,0.25,25,12,0,0,13,-25,-24.75,-13,169,-12,-11.75,13,325.0713333333333,25,24.75,0.99,325.0713333333333,0,13
342,1.01,0.99,169,1.69,0.02,3.25,3.25,13.13,25.13,25.13,-12.87,-24.87,-24.87,325,325,38,38,12.87,-12,-12,625,625,50,12,24.87,0,625,12,24.87,0,347.3813333333333,13,0.13,0.010000006329579965,322.3813333333333,25,25
343,1.99,0.01,625,618.75,612.56,618.75,321.75,49.75,49.75,37.75,-0.25,-0.25,11.75,625,325,50,38,0.25,0,12,625,325,38,0,0.25,12,169,-12,-11.75,-12,349.872,25,24.75,0.99,324.872,25,13
344,1.01,0.99,625,6.25,0.06,0.0,3.25,25.25,0.25,13.25,-24.75,0.25,-12.75,0,325,25,38,24.75,25,12,0,0,13,-25,-0.25,-13,169,-12,12.75,13,325.03133333333335,25,0.25,0.01,325.03133333333335,0,13
345,1.99,0.01,625,618.75,612.56,0.0,0.0,49.75,24.75,24.75,-0.25,24.75,24.75,0,0,25,25,0.25,25,25,0,0,0,-25,-24.75,0,0,-25,-24.75,0,321.80266666666665,25,24.75,0.99,321.80266666666665,0,0
346,1.99,0.01,1,0.99,0.98,0.0,0.99,1.99,0.99,1.99,-0.01,0.99,-0.01,0,1,1,2,0.01,1,0,0,0,1,-1,-0.99,-1,1,0,0.01,1,1.0,1,0.99,0.99,1.0,0,1
347,1.99,0.01,1,0.99,0.98,0.0,0.0,1.99,0.99,0.99,-0.01,0.99,0.99,0,0,1,1,0.01,1,1,0,0,0,-1,-0.99,0,0,-1,-0.99,0,0.99,1,0.99,0.99,0.99,0,0
348,1.01,0.99,1,0.01,0.0,0.0,0.25,1.01,0.01,25.01,-0.99,0.01,-24.99,0,25,1,26,0.99,1,-24,0,0,25,-1,-0.01,-25,625,24,24.99,25,24.792,1,0.01,0.01,24.792,0,25
349,1.99,0.01,625,618.75,612.56,0.0,618.75,49.75,24.75,49.75,-0.25,24.75,-0.25,0,625,25,50,0.25,25,0,0,0,25,-25,-24.75,-25,625,0,0.25,25,327.902,25,24.75,0.99,327.902,0,25
350,1.99,0.01,1,0.99,0.98,0.0,24.75,1.99,0.99,25.99,-0.01,0.99,-24.01,0,25,1,26,0.01,1,-24,0,0,25,-1,-0.99,-25,625,24,24.01,25,1.144,1,0.99,0.99,1.144,0,25
351,1.99,0.01,625,618.75,612.56,0.0,0.0,49.75,24.75,24.75,-0.25,24.75,24.75,0,0,25,25,0.25,25,25,0,0,0,-25,-24.75,0,0,-25,-24.75,0,322.046,25,24.75,0.99,322.046,0,0
352,1.99,0.01,1,0.99,0.98,24.75,0.0,1.99,25.99,0.99,-0.01,-24.01,0.99,25,0,26,1,0.01,-24,1,625,0,25,24,24.01,25,0,-1,-0.99,-25,25.989333333333335,1,0.99,0.99,0.9893333333333345,25,0
353,1.01,0.99,4,0.04,0.0,0.5,0.0,2.02,25.02,0.02,-1.98,-24.98,0.02,50,0,27,2,1.98,-23,2,625,0,25,23,24.98,25,0,-2,-0.02,-25,25.032,2,0.02,0.01,0.03200000000000003,25,0
354,1.99,0.01,1,0.99,0.98,0.0,0.0,1.99,0.99,0.99,-0.01,0.99,0.99,0,0,1,1,0.01,1,1,0,0,0,-1,-0.99,0,0,-1,-0.99,0,0.9886666666666667,1,0.99,0.99,0.9886666666666667,0,0
355,1.01,0.99,625,6.25,0.06,0.0,0.0,25.25,0.25,0.25,-24.75,0.25,0.25,0,0,25,25,24.75,25,25,0,0,0,-25,-0.25,0,0,-25,-0.25,0,2.9966666666666666,25,0.25,0.01,2.9966666666666666,0,0
356,1.01,0.99,196,1.96,0.02,3.5,3.5,14.14,25.14,25.14,-13.86,-24.86,-24.86,350,350,39,39,13.86,-11,-11,625,625,50,11,24.86,0,625,11,24.86,0,372.34133333333335,14,0.14,0.01,347.34133333333335,25,25
357,1.99,0.01,625,618.75,612.56,618.75,321.75,49.75,49.75,37.75,-0.25,-0.25,11.75,625,325,50,38,0.25,0,12,625,325,38,0,0.25,12,169,-12,-11.75,-12,350.08666666666664,25,24.75,0.99,325.08666666666664,25,13
358,1.01,0.99,225,2.25,0.02,3.75,3.45,15.15,25.15,23.15,-14.85,-24.85,-22.85,375,345,40,38,14.85,-10,-8,625,575,48,10,24.85,2,529,8,22.85,-2,367.71733333333333,15,0.15,0.01,342.71733333333333,25,23
359,1.99,0.01,625,618.75,612.56,618.75,321.75,49.75,49.75,37.75,-0.25,-0.25,11.75,625,325,50,38,0.25,0,12,625,325,38,0,0.25,12,169,-12,-11.75,-12,350.04133333333334,25,24.75,0.99,325.04133333333334,25,13
360,1.99,0.01,625,618.75,612.56,0.0,618.75,49.75,24.75,49.75,-0.25,24.75,-0.25,0,625,25,50,0.25,25,0,0,0,25,-25,-24.75,-25,625,0,0.25,25,328.048,25,24.75,0.99,328.048,0,25
361,1.99,0.01,196,194.04,192.1,0.0,346.5,27.86,13.86,38.86,-0.14,13.86,-11.14,0,350,14,39,0.14,14,-11,0,0,25,-14,-13.86,-25,625,11,11.14,25,107.39866666666667,14,13.86,0.99,107.39866666666667,0,25
362,1.99,0.01,625,618.75,612.56,0.0,618.75,49.75,24.75,49.75,-0.25,24.75,-0.25,0,625,25,50,0.25,25,0,0,0,25,-25,-24.75,-25,625,0,0.25,25,328.16266666666667,25,24.75,0.99,328.16266666666667,0,25
363,1.99,0.01,169,167.31,165.64,0.0,321.75,25.87,12.87,37.87,-0.13,12.87,-12.13,0,325,13,38,0.13,13,-12,0,0,25,-13,-12.87,-25,625,12,12.13,25,93.372,13,12.87,0.99,93.372,0,25
364,1.99,0.01,625,618.75,612.56,618.75,0.0,49.75,49.75,24.75,-0.25,-0.25,24.75,625,0,50,25,0.25,0,25,625,0,25,0,0.25,25,0,-25,-24.75,-25,347.0106666666667,25,24.75,0.99,322.0106666666667,25,0
365,1.99,0.01,625,618.75,612.56,0.0,0.0,49.75,24.75,24.75,-0.25,24.75,24.75,0,0,25,25,0.25,25,25,0,0,0,-25,-24.75,0,0,-25,-24.75,0,321.75866666666667,25,24.75,0.99,321.75866666666667,0,0
366,1.99,0.01,625,618.75,612.56,618.75,618.75,49.75,49.75,49.75,-0.25,-0.25,-0.25,625,625,50,50,0.25,0,0,625,625,50,0,0.25,0,625,0,0.25,0,353.192,25,24.75,0.99,328.192,25,25
367,1.99,0.01,625,618.75,612.56,0.0,321.75,49.75,24.75,37.75,-0.25,24.75,11.75,0,325,25,38,0.25,25,12,0,0,13,-25,-24.75,-13,169,-12,-11.75,13,325.006,25,24.75,0.99,325.006,0,13
368,1.99,0.01,625,618.75,612.56,0.0,618.75,49.75,24.75,49.75,-0.25,24.75,-0.25,0,625,25,50,0.25,25,0,0,0,25,-25,-24.75,-25,625,0,0.25,25,328.1073333333333,25,24.75,0.99,328.1073333333333,0,25
369,1.99,0.01,625,618.75,612.56,0.0,321.75,49.75,24.75,37.75,-0.25,24.75,11.75,0,325,25,38,0.25,25,12,0,0,13,-25,-24.75,-13,169,-12,-11.75,13,325.0713333333333,25,24.75,0.99,325.0713333333333,0,13
370,1.01,0.99,169,1.69,0.02,3.25,3.25,13.13,25.13,25.13,-12.87,-24.87,-24.87,325,325,38,38,12.87,-12,-12,625,625,50,12,24.87,0,625,12,24.87,0,347.3813333333333,13,0.13,0.010000006329579965,322.3813333333333,25,25
371,1.99,0.01,625,618.75,612.56,618.75,321.75,49.75,49.75,37.75,-0.25,-0.25,11.75,625,325,50,38,0.25,0,12,625,325,38,0,0.25,12,169,-12,-11.75,-12,349.872,25,24.75,0.99,324.872,25,13
372,1.01,0.99,625,6.25,0.06,0.0,3.25,25.25,0.25,13.25,-24.75,0.25,-12.75,0,325,25,38,24.75,25,12,0,0,13,-25,-0.25,-13,169,-12,12.75,13,325.03133333333335,25,0.25,0.01,325.03133333333335,0,13
373,1.99,0.01,625,618.75,612.56,0.0,0.0,49.75,24.75,24.75,-0.25,24.75,24.75,0,0,25,25,0.25,25,25,0,0,0,-25,-24.75,0,0,-25,-24.75,0,321.80266666666665,25,24.75,0.99,321.80266666666665,0,0
374,1.99,0.01,1,0.99,0.98,0.0,0.99,1.99,0.99,1.99,-0.01,0.99,-0.01,0,1,1,2,0.01,1,0,0,0,1,-1,-0.99,-1,1,0,0.01,1,1.0,1,0.99,0.99,1.0,0,1
375,1.99,0.01,1,0.99,0.98,0.0,0.0,1.99,0.99,0.99,-0.01,0.99,0.99,0,0,1,1,0.01,1,1,0,0,0,-1,-0.99,0,0,-1,-0.99,0,0.99,1,0.99,0.99,0.99,0,0
376,1.01,0.99,1,0.01,0.0,0.0,0.25,1.01,0.01,25.01,-0.99,0.01,-24.99,0,25,1,26,0.99,1,-24,0,0,25,-1,-0.01,-25,625,24,24.99,25,24.792,1,0.01,0.01,24.792,0,25
377,1.99,0.01,625,618.75,612.56,0.0,618.75,49.75,24.75,49.75,-0.25,24.75,-0.25,0,625,25,50,0.25,25,0,0,0,25,-25,-24.75,-25,625,0,0.25,25,327.902,25,24.75,0.99,327.902,0,25
378,1.99,0.01,1,0.99,0.98,0.0,24.75,1.99,0.99,25.99,-0.01,0.99,-24.01,0,25,1,26,0.01,1,-24,0,0,25,-1,-0.99,-25,625,24,24.01,25,1.144,1,0.99,0.99,1.144,0,25
379,1.99,0.01,625,618.75,612.56,0.0,0.0,49.75,24.75,24.75,-0.25,24.75,24.75,0,0,25,25,0.25,25,25,0,0,0,-25,-24.75,0,0,-25,-24.75,0,322.046,25,24.75,0.99,322.046,0,0
380,1.99,0.01,1,0.99,0.98,24.75,0.0,1.99,25.99,0.99,-0.01,-24.01,0.99,25,0,26,1,0.01,-24,1,625,0,25,24,24.01,25,0,-1,-0.99,-25,25.989333333333335,1,0.99,0.99,0.9893333333333345,25,0
381,1.01,0.99,4,0.04,0.0,0.5,0.0,2.02,25.02,0.02,-1.98,-24.98,0.02,50,0,27,2,1.98,-23,2,625,0,25,23,24.98,25,0,-2,-0.02,-25,25.032,2,0.02,0.01,0.03200000000000003,25,0
382,1.99,0.01,1,0.99,0.98,0.0,0.0,1.99,0.99,0.99,-0.01,0.99,0.99,0,0,1,1,0.01,1,1,0,0,0,-1,-0.99,0,0,-1,-0.99,0,0.9886666666666667,1,0.99,0.99,0.9886666666666667,0,0
383,1.01,0.99,625,6.25,0.06,0.0,0.0,25.25,0.25,0.25,-24.75,0.25,0.25,0,0,25,25,24.75,25,25,0,0,0,-25,-0.25,0,0,-25,-0.25,0,2.9966666666666666,25,0.25,0.01,2.9966666666666666,0,0
384,1.01,0.99,196,1.96,0.02,3.5,3.5,14.14,25.14,25.14,-13.86,-24.86,-24.86,350,350,39,39,13.86,-11,-11,625,625,50,11,24.86,0,625,11,24.86,0,372.34133333333335,14,0.14,0.01,347.34133333333335,25,25
385,1.99,0.01,625,618.75,612.56,618.75,321.75,49.75,49.75,37.75,-0.25,-0.25,11.75,625,325,50,38,0.25,0,12,625,325,38,0,0.25,12,169,-12,-11.75,-12,350.08666666666664,25,24.75,0.99,325.08666666666664,25,13
386,1.01,0.99,225,2.25,0.02,3.75,3.45,15.15,25.15,23.15,-14.85,-24.85,-22.85,375,345,40,38,14.85,-10,-8,625,575,48,10,24.85,2,529,8,22.85,-2,367.71733333333333,15,0.15,0.01,342.71733333333333,25,23
387,1.99,0.01,625,618.75,612.56,618.75,321.75,49.75,49.75,37.75,-0.25,-0.25,11.75,625,325,50,38,0.25,0,12,625,325,38,0,0.25,12,169,-12,-11.75,-12,350.04133333333334,25,24.75,0.99,325.04133333333334,25,13
388,1.99,0.01,625,618.75,612.56,0.0,618.75,49.75,24.75,49.75,-0.25,24.75,-0.25,0,625,25,50,0.25,25,0,0,0,25,-25,-24.75,-25,625,0,0.25,25,328.048,25,24.75,0.99,328.048,0,25
389,1.99,0.01,196,194.04,192.1,0.0,346.5,27.86,13.86,38.86,-0.14,13.86,-11.14,0,350,14,39,0.14,14,-11,0,0,25,-14,-13.86,-25,625,11,11.14,25,107.39866666666667,14,13.86,0.99,107.39866666666667,0,25
390,1.99,0.01,625,618.75,612.56,0.0,618.75,49.75,24.75,49.75,-0.25,24.75,-0.25,0,625,25,50,0.25,25,0,0,0,25,-25,-24.75,-25,625,0,0.25,25,328.16266666666667,25,24.75,0.99,328.16266666666667,0,25
391,1.99,0.01,169,167.31,165.64,0.0,321.75,25.87,12.87,37.87,-0.13,12.87,-12.13,0,325,13,38,0.13,13,-12,0,0,25,-13,-12.87,-25,625,12,12.13,25,93.372,13,12.87,0.99,93.372,0,25
392,1.99,0.01,625,618.75,612.56,618.75,0.0,49.75,49.75,24.75,-0.25,-0.25,24.75,625,0,50,25,0.25,0,25,625,0,25,0,0.25,25,0,-25,-24.75,-25,347.0106666666667,25,24.75,0.99,322.0106666666667,25,0
393,1.99,0.01,625,618.75,612.56,0.0,0.0,49.75,24.75,24.75,-0.25,24.75,24.75,0,0,25,25,0.25,25,25,0,0,0,-25,-24.75,0,0,-25,-24.75,0,321.75866666666667,25,24.75,0.99,321.75866666666667,0,0
394,1.99,0.01,625,618.75,612.56,618.75,618.75,49.75,49.75,49.75,-0.25,-0.25,-0.25,625,625,50,50,0.25,0,0,625,625,50,0,0.25,0,625,0,0.25,0,353.192,25,24.75,0.99,328.192,25,25
395,1.99,0.01,625,618.75,612.56,0.0,321.75,49.75,24.75,37.75,-0.25,24.75,11.75,0,325,25,38,0.25,25,12,0,0,13,-25,-24.75,-13,169,-12,-11.75,13,325.006,25,24.75,0.99,325.006,0,13
396,1.99,0.01,625,618.75,612.56,0.0,618.75,49.75,24.75,49.75,-0.25,24.75,-0.25,0,625,25,50,0.25,25,0,0,0,25,-25,-24.75,-25,625,0,0.25,25,328.1073333333333,25,24.75,0.99,328.1073333333333,0,25
397,1.99,0.01,625,618.75,612.56,0.0,321.75,49.75,24.75,37.75,-0.25,24.75,11.75,0,325,25,38,0.25,25,12,0,0,13,-25,-24.75,-13,169,-12,-11.75,13,325.0713333333333,25,24.75,0.99,325.0713333333333,0,13
398,1.01,0.99,169,1.69,0.02,3.25,3.25,13.13,25.13,25.13,-12.87,-24.87,-24.87,325,325,38,38,12.87,-12,-12,625,625,50,12,24.87,0,625,12,24.87,0,347.3813333333333,13,0.13,0.010000006329579965,322.3813333333333,25,25
399,1.99,0.01,625,618.75,612.56,618.75,321.75,49.75,49.75,37.75,-0.25,-0.25,11.75,625,325,50,38,0.25,0,12,625,325,38,0,0.25,12,169,-12,-11.75,-12,349.872,25,24.75,0.99,324.872,25,13
400,1.01,0.99,625,6.25,0.06,0.0,3.25,25.25,0.25,13.25,-24.75,0.25,-12.75,0,325,25,38,24.75,25,12,0,0,13,-25,-0.25,-13,169,-12,12.75,13,325.03133333333335,25,0.25,0.01,325.03133333333335,0,13
401,1.99,0.01,625,618.75,612.56,0.0,0.0,49.75,24.75,24.75,-0.25,24.75,24.75,0,0,25,25,0.25,25,25,0,0,0,-25,-24.75,0,0,-25,-24.75,0,321.80266666666665,25,24.75,0.99,321.80266666666665,0,0
402,1.99,0.01,1,0.99,0.98,0.0,0.99,1.99,0.99,1.99,-0.01,0.99,-0.01,0,1,1,2,0.01,1,0,0,0,1,-1,-0.99,-1,1,0,0.01,1,1.0,1,0.99,0.99,1.0,0,1
403,1.99,0.01,1,0.99,0.98,0.0,0.0,1.99,0.99,0.99,-0.01,0.99,0.99,0,0,1,1,0.01,1,1,0,0,0,-1,-0.99,0,0,-1,-0.99,0,0.99,1,0.99,0.99,0.99,0,0
404,1.01,0.99,1,0.01,0.0,0.0,0.25,1.01,0.01,25.01,-0.99,0.01,-24.99,0,25,1,26,0.99,1,-24,0,0,25,-1,-0.01,-25,625,24,24.99,25,24.792,1,0.01,0.01,24.792,0,25
405,1.99,0.01,625,618.75,612.56,0.0,618.75,49.75,24.75,49.75,-0.25,24.75,-0.25,0,625,25,50,0.25,25,0,0,0,25,-25,-24.75,-25,625,0,0.25,25,327.902,25,24.75,0.99,327.902,0,25
406,1.99,0.01,1,0.99,0.98,0.0,24.75,1.99,0.99,25.99,-0.01,0.99,-24.01,0,25,1,26,0.01,1,-24,0,0,25,-1,-0.99,-25,625,24,24.01,25,1.144,1,0.99,0.99,1.144,0,25
407,1.99,0.01,625,618.75,612.56,0.0,0.0,49.75,24.75,24.75,-0.25,24.75,24.75,0,0,25,25,0.25,25,25,0,0,0,-25,-24.75,0,0,-25,-24.75,0,322.046,25,24.75,0.99,322.046,0,0
408,1.99,0.01,1,0.99,0.98,24.75,0.0,1.99,25.99,0.99,-0.01,-24.01,0.99,25,0,26,1,0.01,-24,1,625,0,25,24,24.01,25,0,-1,-0.99,-25,25.989333333333335,1,0.99,0.99,0.9893333333333345,25,0
409,1.01,0.99,4,0.04,0.0,0.5,0.0,2.02,25.02,0.02,-1.98,-24.98,0.02,50,0,27,2,1.98,-23,2,625,0,25,23,24.98,25,0,-2,-0.02,-25,25.032,2,0.02,0.01,0.03200000000000003,25,0
410,1.99,0.01,1,0.99,0.98,0.0,0.0,1.99,0.99,0.99,-0.01,0.99,0.99,0,0,1,1,0.01,1,1,0,0,0,-1,-0.99,0,0,-1,-0.99,0,0.9886666666666667,1,0.99,0.99,0.9886666666666667,0,0
411,1.01,0.99,625,6.25,0.06,0.0,0.0,25.25,0.25,0.25,-24.75,0.25,0.25,0,0,25,25,24.75,25,25,0,0,0,-25,-0.25,0,0,-25,-0.25,0,2.9966666666666666,25,0.25,0.01,2.9966666666666666,0,0
412,1.01,0.99,196,1.96,0.02,3.5,3.5,14.14,25.14,25.14,-13.86,-24.86,-24.86,350,350,39,39,13.86,-11,-11,625,625,50,11,24.86,0,625,11,24.86,0,372.34133333333335,14,0.14,0.01,347.34133333333335,25,25
413,1.99,0.01,625,618.75,612.56,618.75,321.75,49.75,49.75,37.75,-0.25,-0.25,11.75,625,325,50,38,0.25,0,12,625,325,38,0,0.25,12,169,-12,-11.75,-12,350.08666666666664,25,24.75,0.99,325.08666666666664,25,13
414,1.01,0.99,225,2.25,0.02,3.75,3.45,15.15,25.15,23.15,-14.85,-24.85,-22.85,375,345,40,38,14.85,-10,-8,625,575,48,10,24.85,2,529,8,22.85,-2,367.71733333333333,15,0.15,0.01,342.71733333333333,25,23
415,1.99,0.01,625,618.75,612.56,618.75,321.75,49.75,49.75,37.75,-0.25,-0.25,11.75,625,325,50,38,0.25,0,12,625,325,38,0,0.25,12,169,-12,-11.75,-12,350.04133333333334,25,24.75,0.99,325.04133333333334,25,13
416,1.99,0.01,625,618.75,612.56,0.0,618.75,49.75,24.75,49.75,-0.25,24.75,-0.25,0,625,25,50,0.25,25,0,0,0,25,-25,-24.75,-25,625,0,0.25,25,328.048,25,24.75,0.99,328.048,0,25
417,1.99,0.01,196,194.04,192.1,0.0,346.5,27.86,13.86,38.86,-0.14,13.86,-11.14,0,350,14,39,0.14,14,-11,0,0,25,-14,-13.86,-25,625,11,11.14,25,107.39866666666667,14,13.86,0.99,107.39866666666667,0,25
418,1.99,0.01,625,618.75,612.56,0.0,618.75,49.75,24.75,49.75,-0.25,24.75,-0.25,0,625,25,50,0.25,25,0,0,0,25,-25,-24.75,-25,625,0,0.25,25,328.16266666666667,25,24.75,0.99,328.16266666666667,0,25
419,1.99,0.01,169,167.31,165.64,0.0,321.75,25.87,12.87,37.87,-0.13,12.87,-12.13,0,325,13,38,0.13,13,-12,0,0,25,-13,-12.87,-25,625,12,12.13,25,93.372,13,12.87,0.99,93.372,0,25
420,1.99,0.01,625,618.75,612.56,618.75,0.0,49.75,49.75,24.75,-0.25,-0.25,24.75,625,0,50,25,0.25,0,25,625,0,25,0,0.25,25,0,-25,-24.75,-25,347.0106666666667,25,24.75,0.99,322.0106666666667,25,0
421,1.99,0.01,625,618.75,612.56,0.0,0.0,49.75,24.75,24.75,-0.25,24.75,24.75,0,0,25,25,0.25,25,25,0,0,0,-25,-24.75,0,0,-25,-24.75,0,321.75866666666667,25,24.75,0.99,321.75866666666667,0,0
422,1.99,0.01,625,618.75,612.56,618.75,618.75,49.75,49.75,49.75,-0.25,-0.25,-0.25,625,625,50,50,0.25,0,0,625,625,50,0,0.25,0,625,0,0.25,0,353.192,25,24.75,0.99,328.192,25,25
423,1.99,0.01,625,618.75,612.56,0.0,321.75,49.75,24.75,37.75,-0.25,24.75,11.75,0,325,25,38,0.25,25,12,0,0,13,-25,-24.75,-13,169,-12,-11.75,13,325.006,25,24.75,0.99,325.006,0,13
424,1.99,0.01,625,618.75,612.56,0.0,618.75,49.75,24.75,49.75,-0.25,24.75,-0.25,0,625,25,50,0.25,25,0,0,0,25,-25,-24.75,-25,625,0,0.25,25,328.1073333333333,25,24.75,0.99,328.1073333333333,0,25
425,1.99,0.01,625,618.75,612.56,0.0,321.75,49.75,24.75,37.75,-0.25,24.75,11.75,0,325,25,38,0.25,25,12,0,0,13,-25,-24.75,-13,169,-12,-11.75,13,325.0713333333333,25,24.75,0.99,325.0713333333333,0,13
426,1.01,0.99,169,1.69,0.02,3.25,3.25,13.13,25.13,25.13,-12.87,-24.87,-24.87,325,325,38,38,12.87,-12,-12,625,625,50,12,24.87,0,625,12,24.87,0,347.3813333333333,13,0.13,0.010000006329579965,322.3813333333333,25,25
427,1.99,0.01,625,618.75,612.56,618.75,321.75,49.75,49.75,37.75,-0.25,-0.25,11.75,625,325,50,38,0.25,0,12,625,325,38,0,0.25,12,169,-12,-11.75,-12,349.872,25,24.75,0.99,324.872,25,13
428,1.01,0.99,625,6.25,0.06,0.0,3.25,25.25,0.25,13.25,-24.75,0.25,-12.75,0,325,25,38,24.75,25,12,0,0,13,-25,-0.25,-13,169,-12,12.75,13,325.03133333333335,25,0.25,0.01,325.03133333333335,0,13
429,1.99,0.01,625,618.75,612.56,0.0,0.0,49.75,24.75,24.75,-0.25,24.75,24.75,0,0,25,25,0.25,25,25,0,0,0,-25,-24.75,0,0,-25,-24.75,0,321.80266666666665,25,24.75,0.99,321.80266666666665,0,0
430,1.99,0.01,1,0.99,0.98,0.0,0.99,1.99,0.99,1.99,-0.01,0.99,-0.01,0,1,1,2,0.01,1,0,0,0,1,-1,-0.99,-1,1,0,0.01,1,1.0,1,0.99,0.99,1.0,0,1
431,1.99,0.01,1,0.99,0.98,0.0,0.0,1.99,0.99,0.99,-0.01,0.99,0.99,0,0,1,1,0.01,1,1,0,0,0,-1,-0.99,0,0,-1,-0.99,0,0.99,1,0.99,0.99,0.99,0,0
432,1.01,0.99,1,0.01,0.0,0.0,0.25,1.01,0.01,25.01,-0.99,0.01,-24.99,0,25,1,26,0.99,1,-24,0,0,25,-1,-0.01,-25,625,24,24.99,25,24.792,1,0.01,0.01,24.792,0,25
433,1.99,0.01,625,618.75,612.56,0.0,618.75,49.75,24.75,49.75,-0.25,24.75,-0.25,0,625,25,50,0.25,25,0,0,0,25,-25,-24.75,-25,625,0,0.25,25,327.902,25,24.75,0.99,327.902,0,25
434,1.99,0.01,1,0.99,0.98,0.0,24.75,1.99,0.99,25.99,-0.01,0.99,-24.01,0,25,1,26,0.01,1,-24,0,0,25,-1,-0.99,-25,625,24,24.01,25,1.144,1,0.99,0.99,1.144,0,25
435,1.99,0.01,625,618.75,612.56,0.0,0.0,49.75,24.75,24.75,-0.25,24.75,24.75,0,0,25,25,0.25,25,25,0,0,0,-25,-24.75,0,0,-25,-24.75,0,322.046,25,24.75,0.99,322.046,0,0
436,1.99,0.01,1,0.99,0.98,24.75,0.0,1.99,25.99,0.99,-0.01,-24.01,0.99,25,0,26,1,0.01,-24,1,625,0,25,24,24.01,25,0,-1,-0.99,-25,25.989333333333335,1,0.99,0.99,0.9893333333333345,25,0
437,1.01,0.99,4,0.04,0.0,0.5,0.0,2.02,25.02,0.02,-1.98,-24.98,0.02,50,0,27,2,1.98,-23,2,625,0,25,23,24.98,25,0,-2,-0.02,-25,25.032,2,0.02,0.01,0.03200000000000003,25,0
438,1.99,0.01,1,0.99,0.98,0.0,0.0,1.99,0.99,0.99,-0.01,0.99,0.99,0,0,1,1,0.01,1,1,0,0,0,-1,-0.99,0,0,-1,-0.99,0,0.9886666666666667,1,0.99,0.99,0.9886666666666667,0,0
439,1.01,0.99,625,6.25,0.06,0.0,0.0,25.25,0.25,0.25,-24.75,0.25,0.25,0,0,25,25,24.75,25,25,0,0,0,-25,-0.25,0,0,-25,-0.25,0,2.9966666666666666,25,0.25,0.01,2.9966666666666666,0,0
440,1.01,0.99,196,1.96,0.02,3.5,3.5,14.14,25.14,25.14,-13.86,-24.86,-24.86,350,350,39,39,13.86,-11,-11,625,625,50,11,24.86,0,625,11,24.86,0,372.34133333333335,14,0.14,0.01,347.34133333333335,25,25
441,1.99,0.01,625,618.75,612.56,618.75,321.75,49.75,49.75,37.75,-0.25,-0.25,11.75,625,325,50,38,0.25,0,12,625,325,38,0,0.25,12,169,-12,-11.75,-12,350.08666666666664,25,24.75,0.99,325.08666666666664,25,13
442,1.01,0.99,225,2.25,0.02,3.75,3.45,15.15,25.15,23.15,-14.85,-24.85,-22.85,375,345,40,38,14.85,-10,-8,625,575,48,10,24.85,2,529,8,22.85,-2,367.71733333333333,15,0.15,0.01,342.71733333333333,25,23
443,1.99,0.01,625,618.75,612.56,618.75,321.75,49.75,49.75,37.75,-0.25,-0.25,11.75,625,325,50,38,0.25,0,12,625,325,38,0,0.25,12,169,-12,-11.75,-12,350.04133333333334,25,24.75,0.99,325.04133333333334,25,13
444,1.99,0.01,625,618.75,612.56,0.0,618.75,49.75,24.75,49.75,-0.25,24.75,-0.25,0,625,25,50,0.25,25,0,0,0,25,-25,-24.75,-25,625,0,0.25,25,328.048,25,24.75,0.99,328.048,0,25
445,1.99,0.01,196,194.04,192.1,0.0,346.5,27.86,13.86,38.86,-0.14,13.86,-11.14,0,350,14,39,0.14,14,-11,0,0,25,-14,-13.86,-25,625,11,11.14,25,107.39866666666667,14,13.86,0.99,107.39866666666667,0,25
446,1.99,0.01,625,618.75,612.56,0.0,618.75,49.75,24.75,49.75,-0.25,24.75,-0.25,0,625,25,50,0.25,25,0,0,0,25,-25,-24.75,-25,625,0,0.25,25,328.16266666666667,25,24.75,0.99,328.16266666666667,0,25
447,1.99,0.01,169,167.31,165.64,0.0,321.75,25.87,12.87,37.87,-0.13,12.87,-12.13,0,325,13,38,0.13,13,-12,0,0,25,-13,-12.87,-25,625,12,12.13,25,93.372,13,12.87,0.99,93.372,0,25
448,1.99,0.01,625,618.75,612.56,618.75,0.0,49.75,49.75,24.75,-0.25,-0.25,24.75,625,0,50,25,0.25,0,25,625,0,25,0,0.25,25,0,-25,-24.75,-25,347.0106666666667,25,24.75,0.99,322.0106666666667,25,0
449,1.99,0.01,625,618.75,612.56,0.0,0.0,49.75,24.75,24.75,-0.25,24.75,24.75,0,0,25,25,0.25,25,25,0,0,0,-25,-24.75,0,0,-25,-24.75,0,321.75866666666667,25,24.75,0.99,321.75866666666667,0,0
450,1.99,0.01,625,618.75,612.56,618.75,618.75,49.75,49.75,49.75,-0.25,-0.25,-0.25,625,625,50,50,0.25,0,0,625,625,50,0,0.25,0,625,0,0.25,0,353.192,25,24.75,0.99,328.192,25,25
451,1.99,0.01,625,618.75,612.56,0.0,321.75,49.75,24.75,37.75,-0.25,24.75,11.75,0,325,25,38,0.25,25,12,0,0,13,-25,-24.75,-13,169,-12,-11.75,13,325.006,25,24.75,0.99,325.006,0,13
452,1.99,0.01,625,618.75,612.56,0.0,618.75,49.75,24.75,49.75,-0.25,24.75,-0.25,0,625,25,50,0.25,25,0,0,0,25,-25,-24.75,-25,625,0,0.25,25,328.1073333333333,25,24.75,0.99,328.1073333333333,0,25
453,1.99,0.01,625,618.75,612.56,0.0,321.75,49.75,24.75,37.75,-0.25,24.75,11.75,0,325,25,38,0.25,25,12,0,0,13,-25,-24.75,-13,169,-12,-11.75,13,325.0713333333333,25,24.75,0.99,325.0713333333333,0,13
454,1.01,0.99,169,1.69,0.02,3.25,3.25,13.13,25.13,25.13,-12.87,-24.87,-24.87,325,325,38,38,12.87,-12,-12,625,625,50,12,24.87,0,625,12,24.87,0,347.3813333333333,13,0.13,0.010000006329579965,322.3813333333333,25,25
455,1.99,0.01,625,618.75,612.56,618.75,321.75,49.75,49.75,37.75,-0.25,-0.25,11.75,625,325,50,38,0.25,0,12,625,325,38,0,0.25,12,169,-12,-11.75,-12,349.872,25,24.75,0.99,324.872,25,13
456,1.01,0.99,625,6.25,0.06,0.0,3.25,25.25,0.25,13.25,-24.75,0.25,-12.75,0,325,25,38,24.75,25,12,0,0,13,-25,-0.25,-13,169,-12,12.75,13,325.03133333333335,25,0.25,0.01,325.03133333333335,0,13
457,1.99,0.01,625,618.75,612.56,0.0,0.0,49.75,24.75,24.75,-0.25,24.75,24.75,0,0,25,25,0.25,25,25,0,0,0,-25,-24.75,0,0,-25,-24.75,0,321.80266666666665,25,24.75,0.99,321.80266666666665,0,0
458,1.99,0.01,1,0.99,0.98,0.0,0.99,1.99,0.99,1.99,-0.01,0.99,-0.01,0,1,1,2,0.01,1,0,0,0,1,-1,-0.99,-1,1,0,0.01,1,1.0,1,0.99,0.99,1.0,0,1
459,1.99,0.01,1,0.99,0.98,0.0,0.0,1.99,0.99,0.99,-0.01,0.99,0.99,0,0,1,1,0.01,1,1,0,0,0,-1,-0.99,0,0,-1,-0.99,0,0.99,1,0.99,0.99,0.99,0,0
460,1.01,0.99,1,0.01,0.0,0.0,0.25,1.01,0.01,25.01,-0.99,0.01,-24.99,0,25,1,26,0.99,1,-24,0,0,25,-1,-0.01,-25,625,24,24.99,25,24.792,1,0.01,0.01,24.792,0,25
461,1.99,0.01,625,618.75,612.56,0.0,618.75,49.75,24.75,49.75,-0.25,24.75,-0.25,0,625,25,50,0.25,25,0,0,0,25,-25,-24.75,-25,625,0,0.25,25,327.902,25,24.75,0.99,327.902,0,25
462,1.99,0.01,1,0.99,0.98,0.0,24.75,1.99,0.99,25.99,-0.01,0.99,-24.01,0,25,1,26,0.01,1,-24,0,0,25,-1,-0.99,-25,625,24,24.01,25,1.144,1,0.99,0.99,1.144,0,25
463,1.99,0.01,625,618.75,612.56,0.0,0.0,49.75,24.75,24.75,-0.25,24.75,24.75,0,0,25,25,0.25,25,25,0,0,0,-25,-24.75,0,0,-25,-24.75,0,322.046,25,24.75,0.99,322.046,0,0
464,1.99,0.01,1,0.99,0.98,24.75,0.0,1.99,25.99,0.99,-0.01,-24.01,0.99,25,0,26,1,0.01,-24,1,625,0,25,24,24.01,25,0,-1,-0.99,-25,25.989333333333335,1,0.99,0.99,0.9893333333333345,25,0
465,1.01,0.99,4,0.04,0.0,0.5,0.0,2.02,25.02,0.02,-1.98,-24.98,0.02,50,0,27,2,1.98,-23,2,625,0,25,23,24.98,25,0,-2,-0.02,-25,25.032,2,0.02,0.01,0.03200000000000003,25,0
466,1.99,0.01,1,0.99,0.98,0.0,0.0,1.99,0.99,0.99,-0.01,0.99,0.99,0,0,1,1,0.01,1,1,0,0,0,-1,-0.99,0,0,-1,-0.99,0,0.9886666666666667,1,0.99,0.99,0.9886666666666667,0,0
467,1.01,0.99,625,6.25,0.06,0.0,0.0,25.25,0.25,0.25,-24.75,0.25,0.25,0,0,25,25,24.75,25,25,0,0,0,-25,-0.25,0,0,-25,-0.25,0,2.9966666666666666,25,0.25,0.01,2.9966666666666666,0,0
468,1.01,0.99,196,1.96,0.02,3.5,3.5,14.14,25.14,25.14,-13.86,-24.86,-24.86,350,350,39,39,13.86,-11,-11,625,625,50,11,24.86,0,625,11,24.86,0,372.34133333333335,14,0.14,0.01,347.34133333333335,25,25
469,1.99,0.01,625,618.75,612.56,618.75,321.75,49.75,49.75,37.75,-0.25,-0.25,11.75,625,325,50,38,0.25,0,12,625,325,38,0,0.25,12,169,-12,-11.75,-12,350.08666666666664,25,24.75,0.99,325.08666666666664,25,13
470,1.01,0.99,225,2.25,0.02,3.75,3.45,15.15,25.15,23.15,-14.85,-24.85,-22.85,375,345,40,38,14.85,-10,-8,625,575,48,10,24.85,2,529,8,22.85,-2,367.71733333333333,15,0.15,0.01,342.71733333333333,25,23
471,1.99,0.01,625,618.75,612.56,618.75,321.75,49.75,49.75,37.75,-0.25,-0.25,11.75,625,325,50,38,0.25,0,12,625,325,38,0,0.25,12,169,-12,-11.75,-12,350.04133333333334,25,24.75,0.99,325.04133333333334,25,13
472,1.99,0.01,625,618.75,612.56,0.0,618.75,49.75,24.75,49.75,-0.25,24.75,-0.25,0,625,25,50,0.25,25,0,0,0,25,-25,-24.75,-25,625,0,0.25,25,328.048,25,24.75,0.99,328.048,0,25
473,1.99,0.01,196,194.04,192.1,0.0,346.5,27.86,13.86,38.86,-0.14,13.86,-11.14,0,350,14,39,0.14,14,-11,0,0,25,-14,-13.86,-25,625,11,11.14,25,107.39866666666667,14,13.86,0.99,107.39866666666667,0,25
474,1.99,0.01,625,618.75,612.56,0.0,618.75,49.75,24.75,49.75,-0.25,24.75,-0.25,0,625,25,50,0.25,25,0,0,0,25,-25,-24.75,-25,625,0,0.25,25,328.16266666666667,25,24.75,0.99,328.16266666666667,0,25
475,1.99,0.01,169,167.31,165.64,0.0,321.75,25.87,12.87,37.87,-0.13,12.87,-12.13,0,325,13,38,0.13,13,-12,0,0,25,-13,-12.87,-25,625,12,12.13,25,93.372,13,12.87,0.99,93.372,0,25
476,1.99,0.01,625,618.75,612.56,618.75,0.0,49.75,49.75,24.75,-0.25,-0.25,24.75,625,0,50,25,0.25,0,25,625,0,25,0,0.25,25,0,-25,-24.75,-25,347.0106666666667,25,24.75,0.99,322.0106666666667,25,0
477,1.99,0.01,625,618.75,612.56,0.0,0.0,49.75,24.75,24.75,-0.25,24.75,24.75,0,0,25,25,0.25,25,25,0,0,0,-25,-24.75,0,0,-25,-24.75,0,321.75866666666667,25,24.75,0.99,321.75866666666667,0,0
478,1.99,0.01,625,618.75,612.56,618.75,618.75,49.75,49.75,49.75,-0.25,-0.25,-0.25,625,625,50,50,0.25,0,0,625,625,50,0,0.25,0,625,0,0.25,0,353.192,25,24.75,0.99,328.192,25,25
479,1.99,0.01,625,618.75,612.56,0.0,321.75,49.75,24.75,37.75,-0.25,24.75,11.75,0,325,25,38,0.25,25,12,0,0,13,-25,-24.75,-13,169,-12,-11.75,13,325.006,25,24.75,0.99,325.006,0,13
480,1.99,0.01,625,618.75,612.56,0.0,618.75,49.75,24.75,49.75,-0.25,24.75,-0.25,0,625,25,50,0.25,25,0,0,0,25,-25,-24.75,-25,625,0,0.25,25,328.1073333333333,25,24.75,0.99,328.1073333333333,0,25
481,1.99,0.01,625,618.75,612.56,0.0,321.75,49.75,24.75,37.75,-0.25,24.75,11.75,0,325,25,38,0.25,25,12,0,0,13,-25,-24.75,-13,169,-12,-11.75,13,325.0713333333333,25,24.75,0.99,325.0713333333333,0,13
482,1.01,0.99,169,1.69,0.02,3.25,3.25,13.13,25.13,25.13,-12.87,-24.87,-24.87,325,325,38,38,12.87,-12,-12,625,625,50,12,24.87,0,625,12,24.87,0,347.3813333333333,13,0.13,0.010000006329579965,322.3813333333333,25,25
483,1.99,0.01,625,618.75,612.56,618.75,321.75,49.75,49.75,37.75,-0.25,-0.25,11.75,625,325,50,38,0.25,0,12,625,325,38,0,0.25,12,169,-12,-11.75,-12,349.872,25,24.75,0.99,324.872,25,13
484,1.01,0.99,625,6.25,0.06,0.0,3.25,25.25,0.25,13.25,-24.75,0.25,-12.75,0,325,25,38,24.75,25,12,0,0,13,-25,-0.25,-13,169,-12,12.75,13,325.03133333333335,25,0.25,0.01,325.03133333333335,0,13
485,1.99,0.01,625,618.75,612.56,0.0,0.0,49.75,24.75,24.75,-0.25,24.75,24.75,0,0,25,25,0.25,25,25,0,0,0,-25,-24.75,0,0,-25,-24.75,0,321.80266666666665,25,24.75,0.99,321.80266666666665,0,0
486,1.99,0.01,1,0.99,0.98,0.0,0.99,1.99,0.99,1.99,-0.01,0.99,-0.01,0,1,1,2,0.01,1,0,0,0,1,-1,-0.99,-1,1,0,0.01,1,1.0,1,0.99,0.99,1.0,0,1
487,1.99,0.01,1,0.99,0.98,0.0,0.0,1.99,0.99,0.99,-0.01,0.99,0.99,0,0,1,1,0.01,1,1,0,0,0,-1,-0.99,0,0,-1,-0.99,0,0.99,1,0.99,0.99,0.99,0,0
488,1.01,0.99,1,0.01,0.0,0.0,0.25,1.01,0.01,25.01,-0.99,0.01,-24.99,0,25,1,26,0.99,1,-24,0,0,25,-1,-0.01,-25,625,24,24.99,25,24.792,1,0.01,0.01,24.792,0,25
489,1.99,0.01,625,618.75,612.56,0.0,618.75,49.75,24.75,49.75,-0.25,24.75,-0.25,0,625,25,50,0.25,25,0,0,0,25,-25,-24.75,-25,625,0,0.25,25,327.902,25,24.75,0.99,327.902,0,25
490,1.99,0.01,1,0.99,0.98,0.0,24.75,1.99,0.99,25.99,-0.01,0.99,-24.01,0,25,1,26,0.01,1,-24,0,0,25,-1,-0.99,-25,625,24,24.01,25,1.144,1,0.99,0.99,1.144,0,25
491,1.99,0.01,625,618.75,612.56,0.0,0.0,49.75,24.75,24.75,-0.25,24.75,24.75,0,0,25,25,0.25,25,25,0,0,0,-25,-24.75,0,0,-25,-24.75,0,322.046,25,24.75,0.99,322.046,0,0
492,1.99,0.01,1,0.99,0.98,24.75,0.0,1.99,25.99,0.99,-0.01,-24.01,0.99,25,0,26,1,0.01,-24,1,625,0,25,24,24.01,25,0,-1,-0.99,-25,25.989333333333335,1,0.99,0.99,0.9893333333333345,25,0
493,1.01,0.99,4,0.04,0.0,0.5,0.0,2.02,25.02,0.02,-1.98,-24.98,0.02,50,0,27,2,1.98,-23,2,625,0,25,23,24.98,25,0,-2,-0.02,-25,25.032,2,0.02,0.01,0.03200000000000003,25,0
494,1.99,0.01,1,0.99,0.98,0.0,0.0,1.99,0.99,0.99,-0.01,0.99,0.99,0,0,1,1,0.01,1,1,0,0,0,-1,-0.99,0,0,-1,-0.99,0,0.9886666666666667,1,0.99,0.99,0.9886666666666667,0,0
495,1.01,0.99,625,6.25,0.06,0.0,0.0,25.25,0.25,0.25,-24.75,0.25,0.25,0,0,25,25,24.75,25,25,0,0,0,-25,-0.25,0,0,-25,-0.25,0,2.9966666666666666,25,0.25,0.01,2.9966666666666666,0,0
496,1.01,0.99,196,1.96,0.02,3.5,3.5,14.14,25.14,25.14,-13.86,-24.86,-24.86,350,350,39,39,13.86,-11,-11,625,625,50,11,24.86,0,625,11,24.86,0,372.34133333333335,14,0.14,0.01,347.34133333333335,25,25
497,1.99,0.01,625,618.75,612.56,618.75,321.75,49.75,49.75,37.75,-0.25,-0.25,11.75,625,325,50,38,0.25,0,12,625,325,38,0,0.25,12,169,-12,-11.75,-12,350.08666666666664,25,24.75,0.99,325.08666666666664,25,13
498,1.01,0.99,225,2.25,0.02,3.75,3.45,15.15,25.15,23.15,-14.85,-24.85,-22.85,375,345,40,38,14.85,-10,-8,625,575,48,10,24.85,2,529,8,22.85,-2,367.71733333333333,15,0.15,0.01,342.71733333333333,25,23
499,1.99,0.01,625,618.75,612.56,618.75,321.75,49.75,49.75,37.75,-0.25,-0.25,11.75,625,325,50,38,0.25,0,12,625,325,38,0,0.25,12,169,-12,-11.75,-12,350.04133333333334,25,24.75,0.99,325.04133333333334,25,13
500,1.99,0.01,625,618.75,612.56,0.0,618.75,49.75,24.75,49.75,-0.25,24.75,-0.25,0,625,25,50,0.25,25,0,0,0,25,-25,-24.75,-25,625,0,0.25,25,328.048,25,24.75,0.99,328.048,0,25
501,1.99,0.01,196,194.04,192.1,0.0,346.5,27.86,13.86,38.86,-0.14,13.86,-11.14,0,350,14,39,0.14,14,-11,0,0,25,-14,-13.86,-25,625,11,11.14,25,107.39866666666667,14,13.86,0.99,107.39866666666667,0,25
502,1.99,0.01,625,618.75,612.56,0.0,618.75,49.75,24.75,49.75,-0.25,24.75,-0.25,0,625,25,50,0.25,25,0,0,0,25,-25,-24.75,-25,625,0,0.25,25,328.16266666666667,25,24.75,0.99,328.16266666666667,0,25
503,1.99,0.01,169,167.31,165.64,0.0,321.75,25.87,12.87,37.87,-0.13,12.87,-12.13,0,325,13,38,0.13,13,-12,0,0,25,-13,-12.87,-25,625,12,12.13,25,93.372,13,12.87,0.99,93.372,0,25
504,1.99,0.01,625,618.75,612.56,618.75,0.0,49.75,49.75,24.75,-0.25,-0.25,24.75,625,0,50,25,0.25,0,25,625,0,25,0,0.25,25,0,-25,-24.75,-25,347.0106666666667,25,24.75,0.99,322.0106666666667,25,0
505,1.99,0.01,625,618.75,612.56,0.0,0.0,49.75,24.75,24.75,-0.25,24.75,24.75,0,0,25,25,0.25,25,25,0,0,0,-25,-24.75,0,0,-25,-24.75,0,321.75866666666667,25,24.75,0.99,321.75866666666667,0,0
506,1.99,0.01,625,618.75,612.56,618.75,618.75,49.75,49.75,49.75,-0.25,-0.25,-0.25,625,625,50,50,0.25,0,0,625,625,50,0,0.25,0,625,0,0.25,0,353.192,25,24.75,0.99,328.192,25,25
507,1.99,0.01,625,618.75,612.56,0.0,321.75,49.75,24.75,37.75,-0.25,24.75,11.75,0,325,25,38,0.25,25,12,0,0,13,-25,-24.75,-13,169,-12,-11.75,13,325.006,25,24.75,0.99,325.006,0,13
508,1.99,0.01,625,618.75,612.56,0.0,618.75,49.75,24.75,49.75,-0.25,24.75,-0.25,0,625,25,50,0.25,25,0,0,0,25,-25,-24.75,-25,625,0,0.25,25,328.1073333333333,25,24.75,0.99,328.1073333333333,0,25
509,1.99,0.01,625,618.75,612.56,0.0,321.75,49.75,24.75,37.75,-0.25,24.75,11.75,0,325,25,38,0.25,25,12,0,0,13,-25,-24.75,-13,169,-12,-11.75,13,325.0713333333333,25,24.75,0.99,325.0713333333333,0,13
510,1.01,0.99,169,1.69,0.02,3.25,3.25,13.13,25.13,25.13,-12.87,-24.87,-24.87,325,325,38,38,12.87,-12,-12,625,625,50,12,24.87,0,625,12,24.87,0,347.3813333333333,13,0.13,0.010000006329579965,322.3813333333333,25,25
511,1.99,0.01,625,618.75,612.56,618.75,321.75,49.75,49.75,37.75,-0.25,-0.25,11.75,625,325,50,38,0.25,0,12,625,325,38,0,0.25,12,169,-12,-11.75,-12,349.872,25,24.75,0.99,324.872,25,13
512,1.01,0.99,625,6.25,0.06,0.0,3.25,25.25,0.25,13.25,-24.75,0.25,-12.75,0,325,25,38,24.75,25,12,0,0,13,-25,-0.25,-13,169,-12,12.75,13,325.03133333333335,25,0.25,0.01,325.03133333333335,0,13
513,1.99,0.01,625,618.75,612.56,0.0,0.0,49.75,24.75,24.75,-0.25,24.75,24.75,0,0,25,25,0.25,25,25,0,0,0,-25,-24.75,0,0,-25,-24.75,0,321.80266666666665,25,24.75,0.99,321.80266666666665,0,0
514,1.99,0.01,1,0.99,0.98,0.0,0.99,1.99,0.99,1.99,-0.01,0.99,-0.01,0,1,1,2,0.01,1,0,0,0,1,-1,-0.99,-1,1,0,0.01,1,1.0,1,0.99,0.99,1.0,0,1
515,1.99,0.01,1,0.99,0.98,0.0,0.0,1.99,0.99,0.99,-0.01,0.99,0.99,0,0,1,1,0.01,1,1,0,0,0,-1,-0.99,0,0,-1,-0.99,0,0.99,1,0.99,0.99,0.99,0,0
516,1.01,0.99,1,0.01,0.0,0.0,0.25,1.01,0.01,25.01,-0.99,0.01,-24.99,0,25,1,26,0.99,1,-24,0,0,25,-1,-0.01,-25,625,24,24.99,25,24.792,1,0.01,0.01,24.792,0,25
517,1.99,0.01,625,618.75,612.56,0.0,618.75,49.75,24.75,49.75,-0.25,24.75,-0.25,0,625,25,50,0.25,25,0,0,0,25,-25,-24.75,-25,625,0,0.25,25,327.902,25,24.75,0.99,327.902,0,25
518,1.99,0.01,1,0.99,0.98,0.0,24.75,1.99,0.99,25.99,-0.01,0.99,-24.01,0,25,1,26,0.01,1,-24,0,0,25,-1,-0.99,-25,625,24,24.01,25,1.144,1,0.99,0.99,1.144,0,25
519,1.99,0.01,625,618.75,612.56,0.0,0.0,49.75,24.75,24.75,-0.25,24.75,24.75,0,0,25,25,0.25,25,25,0,0,0,-25,-24.75,0,0,-25,-24.75,0,322.046,25,24.75,0.99,322.046,0,0
520,1.99,0.01,1,0.99,0.98,24.75,0.0,1.99,25.99,0.99,-0.01,-24.01,0.99,25,0,26,1,0.01,-24,1,625,0,25,24,24.01,25,0,-1,-0.99,-25,25.989333333333335,1,0.99,0.99,0.9893333333333345,25,0
521,1.01,0.99,4,0.04,0.0,0.5,0.0,2.02,25.02,0.02,-1.98,-24.98,0.02,50,0,27,2,1.98,-23,2,625,0,25,23,24.98,25,0,-2,-0.02,-25,25.032,2,0.02,0.01,0.03200000000000003,25,0
522,1.99,0.01,1,0.99,0.98,0.0,0.0,1.99,0.99,0.99,-0.01,0.99,0.99,0,0,1,1,0.01,1,1,0,0,0,-1,-0.99,0,0,-1,-0.99,0,0.9886666666666667,1,0.99,0.99,0.9886666666666667,0,0
523,1.01,0.99,625,6.25,0.06,0.0,0.0,25.25,0.25,0.25,-24.75,0.25,0.25,0,0,25,25,24.75,25,25,0,0,0,-25,-0.25,0,0,-25,-0.25,0,2.9966666666666666,25,0.25,0.01,2.9966666666666666,0,0
524,1.01,0.99,196,1.96,0.02,3.5,3.5,14.14,25.14,25.14,-13.86,-24.86,-24.86,350,350,39,39,13.86,-11,-11,625,625,50,11,24.86,0,625,11,24.86,0,372.34133333333335,14,0.14,0.01,347.34133333333335,25,25
525,1.99,0.01,625,618.75,612.56,618.75,321.75,49.75,49.75,37.75,-0.25,-0.25,11.75,625,325,50,38,0.25,0,12,625,325,38,0,0.25,12,169,-12,-11.75,-12,350.08666666666664,25,24.75,0.99,325.08666666666664,25,13
526,1.01,0.99,225,2.25,0.02,3.75,3.45,15.15,25.15,23.15,-14.85,-24.85,-22.85,375,345,40,38,14.85,-10,-8,625,575,48,10,24.85,2,529,8,22.85,-2,367.71733333333333,15,0.15,0.01,342.71733333333333,25,23
527,1.99,0.01,625,618.75,612.56,618.75,321.75,49.75,49.75,37.75,-0.25,-0.25,11.75,625,325,50,38,0.25,0,12,625,325,38,0,0.25,12,169,-12,-11.75,-12,350.04133333333334,25,24.75,0.99,325.04133333333334,25,13
528,1.99,0.01,625,618.75,612.56,0.0,618.75,49.75,24.75,49.75,-0.25,24.75,-0.25,0,625,25,50,0.25,25,0,0,0,25,-25,-24.75,-25,625,0,0.25,25,328.048,25,24.75,0.99,328.048,0,25
529,1.99,0.01,196,194.04,192.1,0.0,346.5,27.86,13.86,38.86,-0.14,13.86,-11.14,0,350,14,39,0.14,14,-11,0,0,25,-14,-13.86,-25,625,11,11.14,25,107.39866666666667,14,13.86,0.99,107.39866666666667,0,25
530,1.99,0.01,625,618.75,612.56,0.0,618.75,49.75,24.75,49.75,-0.25,24.75,-0.25,0,625,25,50,0.25,25,0,0,0,25,-25,-24.75,-25,625,0,0.25,25,328.16266666666667,25,24.75,0.99,328.16266666666667,0,25
531,1.99,0.01,169,167.31,165.64,0.0,321.75,25.87,12.87,37.87,-0.13,12.87,-12.13,0,325,13,38,0.13,13,-12,0,0,25,-13,-12.87,-25,625,12,12.13,25,93.372,13,12.87,0.99,93.372,0,25
532,1.99,0.01,625,618.75,612.56,618.75,0.0,49.75,49.75,24.75,-0.25,-0.25,24.75,625,0,50,25,0.25,0,25,625,0,25,0,0.25,25,0,-25,-24.75,-25,347.0106666666667,25,24.75,0.99,322.0106666666667,25,0
533,1.99,0.01,625,618.75,612.56,0.0,0.0,49.75,24.75,24.75,-0.25,24.75,24.75,0,0,25,25,0.25,25,25,0,0,0,-25,-24.75,0,0,-25,-24.75,0,321.75866666666667,25,24.75,0.99,321.75866666666667,0,0
534,1.99,0.01,625,618.75,612.56,618.75,618.75,49.75,49.75,49.75,-0.25,-0.25,-0.25,625,625,50,50,0.25,0,0,625,625,50,0,0.25,0,625,0,0.25,0,353.192,25,24.75,0.99,328.192,25,25
535,1.99,0.01,625,618.75,612.56,0.0,321.75,49.75,24.75,37.75,-0.25,24.75,11.75,0,325,25,38,0.25,25,12,0,0,13,-25,-24.75,-13,169,-12,-11.75,13,325.006,25,24.75,0.99,325.006,0,13
536,1.99,0.01,625,618.75,612.56,0.0,618.75,49.75,24.75,49.75,-0.25,24.75,-0.25,0,625,25,50,0.25,25,0,0,0,25,-25,-24.75,-25,625,0,0.25,25,328.1073333333333,25,24.75,0.99,328.1073333333333,0,25
537,1.99,0.01,625,618.75,612.56,0.0,321.75,49.75,24.75,37.75,-0.25,24.75,11.75,0,325,25,38,0.25,25,12,0,0,13,-25,-24.75,-13,169,-12,-11.75,13,325.0713333333333,25,24.75,0.99,325.0713333333333,0,13
538,1.01,0.99,169,1.69,0.02,3.25,3.25,13.13,25.13,25.13,-12.87,-24.87,-24.87,325,325,38,38,12.87,-12,-12,625,625,50,12,24.87,0,625,12,24.87,0,347.3813333333333,13,0.13,0.010000006329579965,322.3813333333333,25,25
539,1.99,0.01,625,618.75,612.56,618.75,321.75,49.75,49.75,37.75,-0.25,-0.25,11.75,625,325,50,38,0.25,0,12,625,325,38,0,0.25,12,169,-12,-11.75,-12,349.872,25,24.75,0.99,324.872,25,13
540,1.01,0.99,625,6.25,0.06,0.0,3.25,25.25,0.25,13.25,-24.75,0.25,-12.75,0,325,25,38,24.75,25,12,0,0,13,-25,-0.25,-13,169,-12,12.75,13,325.03133333333335,25,0.25,0.01,325.03133333333335,0,13
541,1.99,0.01,625,618.75,612.56,0.0,0.0,49.75,24.75,24.75,-0.25,24.75,24.75,0,0,25,25,0.25,25,25,0,0,0,-25,-24.75,0,0,-25,-24.75,0,321.80266666666665,25,24.75,0.99,321.80266666666665,0,0
542,1.99,0.01,1,0.99,0.98,0.0,0.99,1.99,0.99,1.99,-0.01,0.99,-0.01,0,1,1,2,0.01,1,0,0,0,1,-1,-0.99,-1,1,0,0.01,1,1.0,1,0.99,0.99,1.0,0,1
543,1.99,0.01,1,0.99,0.98,0.0,0.0,1.99,0.99,0.99,-0.01,0.99,0.99,0,0,1,1,0.01,1,1,0,0,0,-1,-0.99,0,0,-1,-0.99,0,0.99,1,0.99,0.99,0.99,0,0
544,1.01,0.99,1,0.01,0.0,0.0,0.25,1.01,0.01,25.01,-0.99,0.01,-24.99,0,25,1,26,0.99,1,-24,0,0,25,-1,-0.01,-25,625,24,24.99,25,24.792,1,0.01,0.01,24.792,0,25
545,1.99,0.01,625,618.75,612.56,0.0,618.75,49.75,24.75,49.75,-0.25,24.75,-0.25,0,625,25,50,0.25,25,0,0,0,25,-25,-24.75,-25,625,0,0.25,25,327.902,25,24.75,0.99,327.902,0,25
546,1.99,0.01,1,0.99,0.98,0.0,24.75,1.99,0.99,25.99,-0.01,0.99,-24.01,0,25,1,26,0.01,1,-24,0,0,25,-1,-0.99,-25,625,24,24.01,25,1.144,1,0.99,0.99,1.144,0,25
547,1.99,0.01,625,618.75,612.56,0.0,0.0,49.75,24.75,24.75,-0.25,24.75,24.75,0,0,25,25,0.25,25,25,0,0,0,-25,-24.75,0,0,-25,-24.75,0,322.046,25,24.75,0.99,322.046,0,0
548,1.99,0.01,1,0.99,0.98,24.75,0.0,1.99,25.99,0.99,-0.01,-24.01,0.99,25,0,26,1,0.01,-24,1,625,0,25,24,24.01,25,0,-1,-0.99,-25,25.989333333333335,1,0.99,0.99,0.9893333333333345,25,0
549,1.01,0.99,4,0.04,0.0,0.5,0.0,2.02,25.02,0.02,-1.98,-24.98,0.02,50,0,27,2,1.98,-23,2,625,0,25,23,24.98,25,0,-2,-0.02,-25,25.032,2,0.02,0.01,0.03200000000000003,25,0
550,1.99,0.01,1,0.99,0.98,0.0,0.0,1.99,0.99,0.99,-0.01,0.99,0.99,0,0,1,1,0.01,1,1,0,0,0,-1,-0.99,0,0,-1,-0.99,0,0.9886666666666667,1,0.99,0.99,0.9886666666666667,0,0
551,1.01,0.99,625,6.25,0.06,0.0,0.0,25.25,0.25,0.25,-24.75,0.25,0.25,0,0,25,25,24.75,25,25,0,0,0,-25,-0.25,0,0,-25,-0.25,0,2.9966666666666666,25,0.25,0.01,2.9966666666666666,0,0
552,1.01,0.99,196,1.96,0.02,3.5,3.5,14.14,25.14,25.14,-13.86,-24.86,-24.86,350,350,39,39,13.86,-11,-11,625,625,50,11,24.86,0,625,11,24.86,0,372.34133333333335,14,0.14,0.01,347.34133333333335,25,25
553,1.99,0.01,625,618.75,612.56,618.75,321.75,49.75,49.75,37.75,-0.25,-0.25,11.75,625,325,50,38,0.25,0,12,625,325,38,0,0.25,12,169,-12,-11.75,-12,350.08666666666664,25,24.75,0.99,325.08666666666664,25,13
554,1.01,0.99,225,2.25,0.02,3.75,3.45,15.15,25.15,23.15,-14.85,-24.85,-22.85,375,345,40,38,14.85,-10,-8,625,575,48,10,24.85,2,529,8,22.85,-2,367.71733333333333,15,0.15,0.01,342.71733333333333,25,23
555,1.99,0.01,625,618.75,612.56,618.75,321.75,49.75,49.75,37.75,-0.25,-0.25,11.75,625,325,50,38,0.25,0,12,625,325,38,0,0.25,12,169,-12,-11.75,-12,350.04133333333334,25,24.75,0.99,325.04133333333334,25,13
556,1.99,0.01,625,618.75,612.56,0.0,618.75,49.75,24.75,49.75,-0.25,24.75,-0.25,0,625,25,50,0.25,25,0,0,0,25,-25,-24.75,-25,625,0,0.25,25,328.048,25,24.75,0.99,328.048,0,25
557,1.99,0.01,196,194.04,192.1,0.0,346.5,27.86,13.86,38.86,-0.14,13.86,-11.14,0,350,14,39,0.14,14,-11,0,0,25,-14,-13.86,-25,625,11,11.14,25,107.39866666666667,14,13.86,0.99,107.39866666666667,0,25
558,1.99,0.01,625,618.75,612.56,0.0,618.75,49.75,24.75,49.75,-0.25,24.75,-0.25,0,625,25,50,0.25,25,0,0,0,25,-25,-24.75,-25,625,0,0.25,25,328.16266666666667,25,24.75,0.99,328.16266666666667,0,25
559,1.99,0.01,169,167.31,165.64,0.0,321.75,25.87,12.87,37.87,-0.13,12.87,-12.13,0,325,13,38,0.13,13,-12,0,0,25,-13,-12.87,-25,625,12,12.13,25,93.372,13,12.87,0.99,93.372,0,25
560,1.99,0.01,625,618.75,612.56,618.75,0.0,49.75,49.75,24.75,-0.25,-0.25,24.75,625,0,50,25,0.25,0,25,625,0,25,0,0.25,25,0,-25,-24.75,-25,347.0106666666667,25,24.75,0.99,322.0106666666667,25,0
561,1.99,0.01,625,618.75,612.56,0.0,0.0,49.75,24.75,24.75,-0.25,24.75,24.75,0,0,25,25,0.25,25,25,0,0,0,-25,-24.75,0,0,-25,-24.75,0,321.75866666666667,25,24.75,0.99,321.75866666666667,0,0
562,1.99,0.01,625,618.75,612.56,618.75,618.75,49.75,49.75,49.75,-0.25,-0.25,-0.25,625,625,50,50,0.25,0,0,625,625,50,0,0.25,0,625,0,0.25,0,353.192,25,24.75,0.99,328.192,25,25
563,1.99,0.01,625,618.75,612.56,0.0,321.75,49.75,24.75,37.75,-0.25,24.75,11.75,0,325,25,38,0.25,25,12,0,0,13,-25,-24.75,-13,169,-12,-11.75,13,325.006,25,24.75,0.99,325.006,0,13
564,1.99,0.01,625,618.75,612.56,0.0,618.75,49.75,24.75,49.75,-0.25,24.75,-0.25,0,625,25,50,0.25,25,0,0,0,25,-25,-24.75,-25,625,0,0.25,25,328.1073333333333,25,24.75,0.99,328.1073333333333,0,25
565,1.99,0.01,625,618.75,612.56,0.0,321.75,49.75,24.75,37.75,-0.25,24.75,11.75,0,325,25,38,0.25,25,12,0,0,13,-25,-24.75,-13,169,-12,-11.75,13,325.0713333333333,25,24.75,0.99,325.0713333333333,0,13
566,1.01,0.99,169,1.69,0.02,3.25,3.25,13.13,25.13,25.13,-12.87,-24.87,-24.87,325,325,38,38,12.87,-12,-12,625,625,50,12,24.87,0,625,12,24.87,0,347.3813333333333,13,0.13,0.010000006329579965,322.3813333333333,25,25
567,1.99,0.01,625,618.75,612.56,618.75,321.75,49.75,49.75,37.75,-0.25,-0.25,11.75,625,325,50,38,0.25,0,12,625,325,38,0,0.25,12,169,-12,-11.75,-12,349.872,25,24.75,0.99,324.872,25,13
568,1.01,0.99,625,6.25,0.06,0.0,3.25,25.25,0.25,13.25,-24.75,0.25,-12.75,0,325,25,38,24.75,25,12,0,0,13,-25,-0.25,-13,169,-12,12.75,13,325.03133333333335,25,0.25,0.01,325.03133333333335,0,13
569,1.99,0.01,625,618.75,612.56,0.0,0.0,49.75,24.75,24.75,-0.25,24.75,24.75,0,0,25,25,0.25,25,25,0,0,0,-25,-24.75,0,0,-25,-24.75,0,321.80266666666665,25,24.75,0.99,321.80266666666665,0,0
570,1.99,0.01,1,0.99,0.98,0.0,0.99,1.99,0.99,1.99,-0.01,0.99,-0.01,0,1,1,2,0.01,1,0,0,0,1,-1,-0.99,-1,1,0,0.01,1,1.0,1,0.99,0.99,1.0,0,1
571,1.99,0.01,1,0.99,0.98,0.0,0.0,1.99,0.99,0.99,-0.01,0.99,0.99,0,0,1,1,0.01,1,1,0,0,0,-1,-0.99,0,0,-1,-0.99,0,0.99,1,0.99,0.99,0.99,0,0
572,1.01,0.99,1,0.01,0.0,0.0,0.25,1.01,0.01,25.01,-0.99,0.01,-24.99,0,25,1,26,0.99,1,-24,0,0,25,-1,-0.01,-25,625,24,24.99,25,24.792,1,0.01,0.01,24.792,0,25
573,1.99,0.01,625,618.75,612.56,0.0,618.75,49.75,24.75,49.75,-0.25,24.75,-0.25,0,625,25,50,0.25,25,0,0,0,25,-25,-24.75,-25,625,0,0.25,25,327.902,25,24.75,0.99,327.902,0,25
574,1.99,0.01,1,0.99,0.98,0.0,24.75,1.99,0.99,25.99,-0.01,0.99,-24.01,0,25,1,26,0.01,1,-24,0,0,25,-1,-0.99,-25,625,24,24.01,25,1.144,1,0.99,0.99,1.144,0,25
575,1.99,0.01,625,618.75,612.56,0.0,0.0,49.75,24.75,24.75,-0.25,24.75,24.75,0,0,25,25,0.25,25,25,0,0,0,-25,-24.75,0,0,-25,-24.75,0,322.046,25,24.75,0.99,322.046,0,0
576,1.99,0.01,1,0.99,0.98,24.75,0.0,1.99,25.99,0.99,-0.01,-24.01,0.99,25,0,26,1,0.01,-24,1,625,0,25,24,24.01,25,0,-1,-0.99,-25,25.989333333333335,1,0.99,0.99,0.9893333333333345,25,0
577,1.01,0.99,4,0.04,0.0,0.5,0.0,2.02,25.02,0.02,-1.98,-24.98,0.02,50,0,27,2,1.98,-23,2,625,0,25,23,24.98,25,0,-2,-0.02,-25,25.032,2,0.02,0.01,0.03200000000000003,25,0
578,1.99,0.01,1,0.99,0.98,0.0,0.0,1.99,0.99,0.99,-0.01,0.99,0.99,0,0,1,1,0.01,1,1,0,0,0,-1,-0.99,0,0,-1,-0.99,0,0.9886666666666667,1,0.99,0.99,0.9886666666666667,0,0
579,1.01,0.99,625,6.25,0.06,0.0,0.0,25.25,0.25,0.25,-24.75,0.25,0.25,0,0,25,25,24.75,25,25,0,0,0,-25,-0.25,0,0,-25,-0.25,0,2.9966666666666666,25,0.25,0.01,2.9966666666666666,0,0
580,1.01,0.99,196,1.96,0.02,3.5,3.5,14.14,25.14,25.14,-13.86,-24.86,-24.86,350,350,39,39,13.86,-11,-11,625,625,50,11,24.86,0,625,11,24.86,0,372.34133333333335,14,0.14,0.01,347.34133333333335,25,25
581,1.99,0.01,625,618.75,612.56,618.75,321.75,49.75,49.75,37.75,-0.25,-0.25,11.75,625,325,50,38,0.25,0,12,625,325,38,0,0.25,12,169,-12,-11.75,-12,350.08666666666664,25,24.75,0.99,325.08666666666664,25,13
582,1.01,0.99,225,2.25,0.02,3.75,3.45,15.15,25.15,23.15,-14.85,-24.85,-22.85,375,345,40,38,14.85,-10,-8,625,575,48,10,24.85,2,529,8,22.85,-2,367.71733333333333,15,0.15,0.01,342.71733333333333,25,23
583,1.99,0.01,625,618.75,612.56,618.75,321.75,49.75,49.75,37.75,-0.25,-0.25,11.75,625,325,50,38,0.25,0,12,625,325,38,0,0.25,12,169,-12,-11.75,-12,350.04133333333334,25,24.75,0.99,325.04133333333334,25,13
584,1.99,0.01,625,618.75,612.56,0.0,618.75,49.75,24.75,49.75,-0.25,24.75,-0.25,0,625,25,50,0.25,25,0,0,0,25,-25,-24.75,-25,625,0,0.25,25,328.048,25,24.75,0.99,328.048,0,25
585,1.99,0.01,196,194.04,192.1,0.0,346.5,27.86,13.86,38.86,-0.14,13.86,-11.14,0,350,14,39,0.14,14,-11,0,0,25,-14,-13.86,-25,625,11,11.14,25,107.39866666666667,14,13.86,0.99,107.39866666666667,0,25
586,1.99,0.01,625,618.75,612.56,0.0,618.75,49.75,24.75,49.75,-0.25,24.75,-0.25,0,625,25,50,0.25,25,0,0,0,25,-25,-24.75,-25,625,0,0.25,25,328.16266666666667,25,24.75,0.99,328.16266666666667,0,25
587,1.99,0.01,169,167.31,165.64,0.0,321.75,25.87,12.87,37.87,-0.13,12.87,-12.13,0,325,13,38,0.13,13,-12,0,0,25,-13,-12.87,-25,625,12,12.13,25,93.372,13,12.87,0.99,93.372,0,25
588,1.99,0.01,625,618.75,612.56,618.75,0.0,49.75,49.75,24.75,-0.25,-0.25,24.75,625,0,50,25,0.25,0,25,625,0,25,0,0.25,25,0,-25,-24.75,-25,347.0106666666667,25,24.75,0.99,322.0106666666667,25,0
589,1.99,0.01,625,618.75,612.56,0.0,0.0,49.75,24.75,24.75,-0.25,24.75,24.75,0,0,25,25,0.25,25,25,0,0,0,-25,-24.75,0,0,-25,-24.75,0,321.75866666666667,25,24.75,0.99,321.75866666666667,0,0
590,1.99,0.01,625,618.75,612.56,618.75,618.75,49.75,49.75,49.75,-0.25,-0.25,-0.25,625,625,50,50,0.25,0,0,625,625,50,0,0.25,0,625,0,0.25,0,353.192,25,24.75,0.99,328.192,25,25
591,1.99,0.01,625,618.75,612.56,0.0,321.75,49.75,24.75,37.75,-0.25,24.75,11.75,0,325,25,38,0.25,25,12,0,0,13,-25,-24.75,-13,169,-12,-11.75,13,325.006,25,24.75,0.99,325.006,0,13
592,1.99,0.01,625,618.75,612.56,0.0,618.75,49.75,24.75,49.75,-0.25,24.75,-0.25,0,625,25,50,0.25,25,0,0,0,25,-25,-24.75,-25,625,0,0.25,25,328.1073333333333,25,24.75,0.99,328.1073333333333,0,25
593,1.99,0.01,625,618.75,612.56,0.0,321.75,49.75,24.75,37.75,-0.25,24.75,11.75,0,325,25,38,0.25,25,12,0,0,13,-25,-24.75,-13,169,-12,-11.75,13,325.0713333333333,25,24.75,0.99,325.0713333333333,0,13
594,1.01,0.99,169,1.69,0.02,3.25,3.25,13.13,25.13,25.13,-12.87,-24.87,-24.87,325,325,38,38,12.87,-12,-12,625,625,50,12,24.87,0,625,12,24.87,0,347.3813333333333,13,0.13,0.010000006329579965,322.3813333333333,25,25
595,1.99,0.01,625,618.75,612.56,618.75,321.75,49.75,49.75,37.75,-0.25,-0.25,11.75,625,325,50,38,0.25,0,12,625,325,38,0,0.25,12,169,-12,-11.75,-12,349.872,25,24.75,0.99,324.872,25,13
596,1.01,0.99,625,6.25,0.06,0.0,3.25,25.25,0.25,13.25,-24.75,0.25,-12.75,0,325,25,38,24.75,25,12,0,0,13,-25,-0.25,-13,169,-12,12.75,13,325.03133333333335,25,0.25,0.01,325.03133333333335,0,13
597,1.99,0.01,625,618.75,612.56,0.0,0.0,49.75,24.75,24.75,-0.25,24.75,24.75,0,0,25,25,0.25,25,25,0,0,0,-25,-24.75,0,0,-25,-24.75,0,321.80266666666665,25,24.75,0.99,321.80266666666665,0,0
598,1.99,0.01,1,0.99,0.98,0.0,0.99,1.99,0.99,1.99,-0.01,0.99,-0.01,0,1,1,2,0.01,1,0,0,0,1,-1,-0.99,-1,1,0,0.01,1,1.0,1,0.99,0.99,1.0,0,1
599,1.99,0.01,1,0.99,0.98,0.0,0.0,1.99,0.99,0.99,-0.01,0.99,0.99,0,0,1,1,0.01,1,1,0,0,0,-1,-0.99,0,0,-1,-0.99,0,0.99,1,0.99,0.99,0.99,0,0
600,1.01,0.99,1,0.01,0.0,0.0,0.25,1.01,0.01,25.01,-0.99,0.01,-24.99,0,25,1,26,0.99,1,-24,0,0,25,-1,-0.01,-25,625,24,24.99,25,24.792,1,0.01,0.01,24.792,0,25
601,1.99,0.01,625,618.75,612.56,0.0,618.75,49.75,24.75,49.75,-0.25,24.75,-0.25,0,625,25,50,0.25,25,0,0,0,25,-25,-24.75,-25,625,0,0.25,25,327.902,25,24.75,0.99,327.902,0,25
602,1.99,0.01,1,0.99,0.98,0.0,24.75,1.99,0.99,25.99,-0.01,0.99,-24.01,0,25,1,26,0.01,1,-24,0,0,25,-1,-0.99,-25,625,24,24.01,25,1.144,1,0.99,0.99,1.144,0,25
603,1.99,0.01,625,618.75,612.56,0.0,0.0,49.75,24.75,24.75,-0.25,24.75,24.75,0,0,25,25,0.25,25,25,0,0,0,-25,-24.75,0,0,-25,-24.75,0,322.046,25,24.75,0.99,322.046,0,0
604,1.99,0.01,1,0.99,0.98,24.75,0.0,1.99,25.99,0.99,-0.01,-24.01,0.99,25,0,26,1,0.01,-24,1,625,0,25,24,24.01,25,0,-1,-0.99,-25,25.989333333333335,1,0.99,0.99,0.9893333333333345,25,0
605,1.01,0.99,4,0.04,0.0,0.5,0.0,2.02,25.02,0.02,-1.98,-24.98,0.02,50,0,27,2,1.98,-23,2,625,0,25,23,24.98,25,0,-2,-0.02,-25,25.032,2,0.02,0.01,0.03200000000000003,25,0
606,1.99,0.01,1,0.99,0.98,0.0,0.0,1.99,0.99,0.99,-0.01,0.99,0.99,0,0,1,1,0.01,1,1,0,0,0,-1,-0.99,0,0,-1,-0.99,0,0.9886666666666667,1,0.99,0.99,0.9886666666666667,0,0
607,1.01,0.99,625,6.25,0.06,0.0,0.0,25.25,0.25,0.25,-24.75,0.25,0.25,0,0,25,25,24.75,25,25,0,0,0,-25,-0.25,0,0,-25,-0.25,0,2.9966666666666666,25,0.25,0.01,2.9966666666666666,0,0
608,1.01,0.99,196,1.96,0.02,3.5,3.5,14.14,25.14,25.14,-13.86,-24.86,-24.86,350,350,39,39,13.86,-11,-11,625,625,50,11,24.86,0,625,11,24.86,0,372.34133333333335,14,0.14,0.01,347.34133333333335,25,25
609,1.99,0.01,625,618.75,612.56,618.75,321.75,49.75,49.75,37.75,-0.25,-0.25,11.75,625,325,50,38,0.25,0,12,625,325,38,0,0.25,12,169,-12,-11.75,-12,350.08666666666664,25,24.75,0.99,325.08666666666664,25,13
610,1.01,0.99,225,2.25,0.02,3.75,3.45,15.15,25.15,23.15,-14.85,-24.85,-22.85,375,345,40,38,14.85,-10,-8,625,575,48,10,24.85,2,529,8,22.85,-2,367.71733333333333,15,0.15,0.01,342.71733333333333,25,23
611,1.99,0.01,625,618.75,612.56,618.75,321.75,49.75,49.75,37.75,-0.25,-0.25,11.75,625,325,50,38,0.25,0,12,625,325,38,0,0.25,12,169,-12,-11.75,-12,350.04133333333334,25,24.75,0.99,325.04133333333334,25,13
612,1.99,0.01,625,618.75,612.56,0.0,618.75,49.75,24.75,49.75,-0.25,24.75,-0.25,0,625,25,50,0.25,25,0,0,0,25,-25,-24.75,-25,625,0,0.25,25,328.048,25,24.75,0.99,328.048,0,25
613,1.99,0.01,196,194.04,192.1,0.0,346.5,27.86,13.86,38.86,-0.14,13.86,-11.14,0,350,14,39,0.14,14,-11,0,0,25,-14,-13.86,-25,625,11,11.14,25,107.39866666666667,14,13.86,0.99,107.39866666666667,0,25
614,1.99,0.01,625,618.75,612.56,0.0,618.75,49.75,24.75,49.75,-0.25,24.75,-0.25,0,625,25,50,0.25,25,0,0,0,25,-25,-24.75,-25,625,0,0.25,25,328.16266666666667,25,24.75,0.99,328.16266666666667,0,25
615,1.99,0.01,169,167.31,165.64,0.0,321.75,25.87,12.87,37.87,-0.13,12.87,-12.13,0,325,13,38,0.13,13,-12,0,0,25,-13,-12.87,-25,625,12,12.13,25,93.372,13,12.87,0.99,93.372,0,25
616,1.99,0.01,625,618.75,612.56,618.75,0.0,49.75,49.75,24.75,-0.25,-0.25,24.75,625,0,50,25,0.25,0,25,625,0,25,0,0.25,25,0,-25,-24.75,-25,347.0106666666667,25,24.75,0.99,322.0106666666667,25,0
617,1.99,0.01,625,618.75,612.56,0.0,0.0,49.75,24.75,24.75,-0.25,24.75,24.75,0,0,25,25,0.25,25,25,0,0,0,-25,-24.75,0,0,-25,-24.75,0,321.75866666666667,25,24.75,0.99,321.75866666666667,0,0
618,1.99,0.01,625,618.75,612.56,618.75,618.75,49.75,49.75,49.75,-0.25,-0.25,-0.25,625,625,50,50,0.25,0,0,625,625,50,0,0.25,0,625,0,0.25,0,353.192,25,24.75,0.99,328.192,25,25
619,1.99,0.01,625,618.75,612.56,0.0,321.75,49.75,24.75,37.75,-0.25,24.75,11.75,0,325,25,38,0.25,25,12,0,0,13,-25,-24.75,-13,169,-12,-11.75,13,325.006,25,24.75,0.99,325.006,0,13
620,1.99,0.01,625,618.75,612.56,0.0,618.75,49.75,24.75,49.75,-0.25,24.75,-0.25,0,625,25,50,0.25,25,0,0,0,25,-25,-24.75,-25,625,0,0.25,25,328.1073333333333,25,24.75,0.99,328.1073333333333,0,25
621,1.99,0.01,625,618.75,612.56,0.0,321.75,49.75,24.75,37.75,-0.25,24.75,11.75,0,325,25,38,0.25,25,12,0,0,13,-25,-24.75,-13,169,-12,-11.75,13,325.0713333333333,25,24.75,0.99,325.0713333333333,0,13
622,1.01,0.99,169,1.69,0.02,3.25,3.25,13.13,25.13,25.13,-12.87,-24.87,-24.87,325,325,38,38,12.87,-12,-12,625,625,50,12,24.87,0,625,12,24.87,0,347.3813333333333,13,0.13,0.010000006329579965,322.3813333333333,25,25
623,1.99,0.01,625,618.75,612.56,618.75,321.75,49.75,49.75,37.75,-0.25,-0.25,11.75,625,325,50,38,0.25,0,12,625,325,38,0,0.25,12,169,-12,-11.75,-12,349.872,25,24.75,0.99,324.872,25,13
624,1.01,0.99,625,6.25,0.06,0.0,3.25,25.25,0.25,13.25,-24.75,0.25,-12.75,0,325,25,38,24.75,25,12,0,0,13,-25,-0.25,-13,169,-12,12.75,13,325.03133333333335,25,0.25,0.01,325.03133333333335,0,13
625,1.99,0.01,625,618.75,612.56,0.0,0.0,49.75,24.75,24.75,-0.25,24.75,24.75,0,0,25,25,0.25,25,25,0,0,0,-25,-24.75,0,0,-25,-24.75,0,321.80266666666665,25,24.75,0.99,321.80266666666665,0,0
626,1.99,0.01,1,0.99,0.98,0.0,0.99,1.99,0.99,1.99,-0.01,0.99,-0.01,0,1,1,2,0.01,1,0,0,0,1,-1,-0.99,-1,1,0,0.01,1,1.0,1,0.99,0.99,1.0,0,1
627,1.99,0.01,1,0.99,0.98,0.0,0.0,1.99,0.99,0.99,-0.01,0.99,0.99,0,0,1,1,0.01,1,1,0,0,0,-1,-0.99,0,0,-1,-0.99,0,0.99,1,0.99,0.99,0.99,0,0
628,1.01,0.99,1,0.01,0.0,0.0,0.25,1.01,0.01,25.01,-0.99,0.01,-24.99,0,25,1,26,0.99,1,-24,0,0,25,-1,-0.01,-25,625,24,24.99,25,24.792,1,0.01,0.01,24.792,0,25
629,1.99,0.01,625,618.75,612.56,0.0,618.75,49.75,24.75,49.75,-0.25,24.75,-0.25,0,625,25,50,0.25,25,0,0,0,25,-25,-24.75,-25,625,0,0.25,25,327.902,25,24.75,0.99,327.902,0,25
630,1.99,0.01,1,0.99,0.98,0.0,24.75,1.99,0.99,25.99,-0.01,0.99,-24.01,0,25,1,26,0.01,1,-24,0,0,25,-1,-0.99,-25,625,24,24.01,25,1.144,1,0.99,0.99,1.144,0,25
631,1.99,0.01,625,618.75,612.56,0.0,0.0,49.75,24.75,24.75,-0.25,24.75,24.75,0,0,25,25,0.25,25,25,0,0,0,-25,-24.75,0,0,-25,-24.75,0,322.046,25,24.75,0.99,322.046,0,0
632,1.99,0.01,1,0.99,0.98,24.75,0.0,1.99,25.99,0.99,-0.01,-24.01,0.99,25,0,26,1,0.01,-24,1,625,0,25,24,24.01,25,0,-1,-0.99,-25,25.989333333333335,1,0.99,0.99,0.9893333333333345,25,0
633,1.01,0.99,4,0.04,0.0,0.5,0.0,2.02,25.02,0.02,-1.98,-24.98,0.02,50,0,27,2,1.98,-23,2,625,0,25,23,24.98,25,0,-2,-0.02,-25,25.032,2,0.02,0.01,0.03200000000000003,25,0
634,1.99,0.01,1,0.99,0.98,0.0,0.0,1.99,0.99,0.99,-0.01,0.99,0.99,0,0,1,1,0.01,1,1,0,0,0,-1,-0.99,0,0,-1,-0.99,0,0.9886666666666667,1,0.99,0.99,0.9886666666666667,0,0
635,1.01,0.99,625,6.25,0.06,0.0,0.0,25.25,0.25,0.25,-24.75,0.25,0.25,0,0,25,25,24.75,25,25,0,0,0,-25,-0.25,0,0,-25,-0.25,0,2.9966666666666666,25,0.25,0.01,2.9966666666666666,0,0
636,1.01,0.99,196,1.96,0.02,3.5,3.5,14.14,25.14,25.14,-13.86,-24.86,-24.86,350,350,39,39,13.86,-11,-11,625,625,50,11,24.86,0,625,11,24.86,0,372.34133333333335,14,0.14,0.01,347.34133333333335,25,25
637,1.99,0.01,625,618.75,612.56,618.75,321.75,49.75,49.75,37.75,-0.25,-0.25,11.75,625,325,50,38,0.25,0,12,625,325,38,0,0.25,12,169,-12,-11.75,-12,350.08666666666664,25,24.75,0.99,325.08666666666664,25,13
638,1.01,0.99,225,2.25,0.02,3.75,3.45,15.15,25.15,23.15,-14.85,-24.85,-22.85,375,345,40,38,14.85,-10,-8,625,575,48,10,24.85,2,529,8,22.85,-2,367.71733333333333,15,0.15,0.01,342.71733333333333,25,23
639,1.99,0.01,625,618.75,612.56,618.75,321.75,49.75,49.75,37.75,-0.25,-0.25,11.75,625,325,50,38,0.25,0,12,625,325,38,0,0.25,12,169,-12,-11.75,-12,350.04133333333334,25,24.75,0.99,325.04133333333334,25,13
640,1.99,0.01,625,618.75,612.56,0.0,618.75,49.75,24.75,49.75,-0.25,24.75,-0.25,0,625,25,50,0.25,25,0,0,0,25,-25,-24.75,-25,625,0,0.25,25,328.048,25,24.75,0.99,328.048,0,25
641,1.99,0.01,196,194.04,192.1,0.0,346.5,27.86,13.86,38.86,-0.14,13.86,-11.14,0,350,14,39,0.14,14,-11,0,0,25,-14,-13.86,-25,625,11,11.14,25,107.39866666666667,14,13.86,0.99,107.39866666666667,0,25
642,1.99,0.01,625,618.75,612.56,0.0,618.75,49.75,24.75,49.75,-0.25,24.75,-0.25,0,625,25,50,0.25,25,0,0,0,25,-25,-24.75,-25,625,0,0.25,25,328.16266666666667,25,24.75,0.99,328.16266666666667,0,25
643,1.99,0.01,169,167.31,165.64,0.0,321.75,25.87,12.87,37.87,-0.13,12.87,-12.13,0,325,13,38,0.13,13,-12,0,0,25,-13,-12.87,-25,625,12,12.13,25,93.372,13,12.87,0.99,93.372,0,25
644,1.99,0.01,625,618.75,612.56,618.75,0.0,49.75,49.75,24.75,-0.25,-0.25,24.75,625,0,50,25,0.25,0,25,625,0,25,0,0.25,25,0,-25,-24.75,-25,347.0106666666667,25,24.75,0.99,322.0106666666667,25,0
645,1.99,0.01,625,618.75,612.56,0.0,0.0,49.75,24.75,24.75,-0.25,24.75,24.75,0,0,25,25,0.25,25,25,0,0,0,-25,-24.75,0,0,-25,-24.75,0,321.75866666666667,25,24.75,0.99,321.75866666666667,0,0
646,1.99,0.01,625,618.75,612.56,618.75,618.75,49.75,49.75,49.75,-0.25,-0.25,-0.25,625,625,50,50,0.25,0,0,625,625,50,0,0.25,0,625,0,0.25,0,353.192,25,24.75,0.99,328.192,25,25
647,1.99,0.01,625,618.75,612.56,0.0,321.75,49.75,24.75,37.75,-0.25,24.75,11.75,0,325,25,38,0.25,25,12,0,0,13,-25,-24.75,-13,169,-12,-11.75,13,325.006,25,24.75,0.99,325.006,0,13
648,1.99,0.01,625,618.75,612.56,0.0,618.75,49.75,24.75,49.75,-0.25,24.75,-0.25,0,625,25,50,0.25,25,0,0,0,25,-25,-24.75,-25,625,0,0.25,25,328.1073333333333,25,24.75,0.99,328.1073333333333,0,25
649,1.99,0.01,625,618.75,612.56,0.0,321.75,49.75,24.75,37.75,-0.25,24.75,11.75,0,325,25,38,0.25,25,12,0,0,13,-25,-24.75,-13,169,-12,-11.75,13,325.0713333333333,25,24.75,0.99,325.0713333333333,0,13
650,1.01,0.99,169,1.69,0.02,3.25,3.25,13.13,25.13,25.13,-12.87,-24.87,-24.87,325,325,38,38,12.87,-12,-12,625,625,50,12,24.87,0,625,12,24.87,0,347.3813333333333,13,0.13,0.010000006329579965,322.3813333333333,25,25
651,1.99,0.01,625,618.75,612.56,618.75,321.75,49.75,49.75,37.75,-0.25,-0.25,11.75,625,325,50,38,0.25,0,12,625,325,38,0,0.25,12,169,-12,-11.75,-12,349.872,25,24.75,0.99,324.872,25,13
652,1.01,0.99,625,6.25,0.06,0.0,3.25,25.25,0.25,13.25,-24.75,0.25,-12.75,0,325,25,38,24.75,25,12,0,0,13,-25,-0.25,-13,169,-12,12.75,13,325.03133333333335,25,0.25,0.01,325.03133333333335,0,13
653,1.99,0.01,625,618.75,612.56,0.0,0.0,49.75,24.75,24.75,-0.25,24.75,24.75,0,0,25,25,0.25,25,25,0,0,0,-25,-24.75,0,0,-25,-24.75,0,321.80266666666665,25,24.75,0.99,321.80266666666665,0,0
654,1.99,0.01,1,0.99,0.98,0.0,0.99,1.99,0.99,1.99,-0.01,0.99,-0.01,0,1,1,2,0.01,1,0,0,0,1,-1,-0.99,-1,1,0,0.01,1,1.0,1,0.99,0.99,1.0,0,1
655,1.99,0.01,1,0.99,0.98,0.0,0.0,1.99,0.99,0.99,-0.01,0.99,0.99,0,0,1,1,0.01,1,1,0,0,0,-1,-0.99,0,0,-1,-0.99,0,0.99,1,0.99,0.99,0.99,0,0
656,1.01,0.99,1,0.01,0.0,0.0,0.25,1.01,0.01,25.01,-0.99,0.01,-24.99,0,25,1,26,0.99,1,-24,0,0,25,-1,-0.01,-25,625,24,24.99,25,24.792,1,0.01,0.01,24.792,0,25
657,1.99,0.01,625,618.75,612.56,0.0,618.75,49.75,24.75,49.75,-0.25,24.75,-0.25,0,625,25,50,0.25,25,0,0,0,25,-25,-24.75,-25,625,0,0.25,25,327.902,25,24.75,0.99,327.902,0,25
658,1.99,0.01,1,0.99,0.98,0.0,24.75,1.99,0.99,25.99,-0.01,0.99,-24.01,0,25,1,26,0.01,1,-24,0,0,25,-1,-0.99,-25,625,24,24.01,25,1.144,1,0.99,0.99,1.144,0,25
659,1.99,0.01,625,618.75,612.56,0.0,0.0,49.75,24.75,24.75,-0.25,24.75,24.75,0,0,25,25,0.25,25,25,0,0,0,-25,-24.75,0,0,-25,-24.75,0,322.046,25,24.75,0.99,322.046,0,0
660,1.99,0.01,1,0.99,0.98,24.75,0.0,1.99,25.99,0.99,-0.01,-24.01,0.99,25,0,26,1,0.01,-24,1,625,0,25,24,24.01,25,0,-1,-0.99,-25,25.989333333333335,1,0.99,0.99,0.9893333333333345,25,0
661,1.01,0.99,4,0.04,0.0,0.5,0.0,2.02,25.02,0.02,-1.98,-24.98,0.02,50,0,27,2,1.98,-23,2,625,0,25,23,24.98,25,0,-2,-0.02,-25,25.032,2,0.02,0.01,0.03200000000000003,25,0
662,1.99,0.01,1,0.99,0.98,0.0,0.0,1.99,0.99,0.99,-0.01,0.99,0.99,0,0,1,1,0.01,1,1,0,0,0,-1,-0.99,0,0,-1,-0.99,0,0.9886666666666667,1,0.99,0.99,0.9886666666666667,0,0
663,1.01,0.99,625,6.25,0.06,0.0,0.0,25.25,0.25,0.25,-24.75,0.25,0.25,0,0,25,25,24.75,25,25,0,0,0,-25,-0.25,0,0,-25,-0.25,0,2.9966666666666666,25,0.25,0.01,2.9966666666666666,0,0
664,1.01,0.99,196,1.96,0.02,3.5,3.5,14.14,25.14,25.14,-13.86,-24.86,-24.86,350,350,39,39,13.86,-11,-11,625,625,50,11,24.86,0,625,11,24.86,0,372.34133333333335,14,0.14,0.01,347.34133333333335,25,25
665,1.99,0.01,625,618.75,612.56,618.75,321.75,49.75,49.75,37.75,-0.25,-0.25,11.75,625,325,50,38,0.25,0,12,625,325,38,0,0.25,12,169,-12,-11.75,-12,350.08666666666664,25,24.75,0.99,325.08666666666664,25,13
666,1.01,0.99,225,2.25,0.02,3.75,3.45,15.15,25.15,23.15,-14.85,-24.85,-22.85,375,345,40,38,14.85,-10,-8,625,575,48,10,24.85,2,529,8,22.85,-2,367.71733333333333,15,0.15,0.01,342.71733333333333,25,23
667,1.99,0.01,625,618.75,612.56,618.75,321.75,49.75,49.75,37.75,-0.25,-0.25,11.75,625,325,50,38,0.25,0,12,625,325,38,0,0.25,12,169,-12,-11.75,-12,350.04133333333334,25,24.75,0.99,325.04133333333334,25,13
668,1.99,0.01,625,618.75,612.56,0.0,618.75,49.75,24.75,49.75,-0.25,24.75,-0.25,0,625,25,50,0.25,25,0,0,0,25,-25,-24.75,-25,625,0,0.25,25,328.048,25,24.75,0.99,328.048,0,25
669,1.99,0.01,196,194.04,192.1,0.0,346.5,27.86,13.86,38.86,-0.14,13.86,-11.14,0,350,14,39,0.14,14,-11,0,0,25,-14,-13.86,-25,625,11,11.14,25,107.39866666666667,14,13.86,0.99,107.39866666666667,0,25
670,1.99,0.01,625,618.75,612.56,0.0,618.75,49.75,24.75,49.75,-0.25,24.75,-0.25,0,625,25,50,0.25,25,0,0,0,25,-25,-24.75,-25,625,0,0.25,25,328.16266666666667,25,24.75,0.99,328.16266666666667,0,25
671,1.99,0.01,169,167.31,165.64,0.0,321.75,25.87,12.87,37.87,-0.13,12.87,-12.13,0,325,13,38,0.13,13,-12,0,0,25,-13,-12.87,-25,625,12,12.13,25,93.372,13,12.87,0.99,93.372,0,25
672,1.99,0.01,625,618.75,612.56,618.75,0.0,49.75,49.75,24.75,-0.25,-0.25,24.75,625,0,50,25,0.25,0,25,625,0,25,0,0.25,25,0,-25,-24.75,-25,347.0106666666667,25,24.75,0.99,322.0106666666667,25,0
673,1.99,0.01,625,618.75,612.56,0.0,0.0,49.75,24.75,24.75,-0.25,24.75,24.75,0,0,25,25,0.25,25,25,0,0,0,-25,-24.75,0,0,-25,-24.75,0,321.75866666666667,25,24.75,0.99,321.75866666666667,0,0
674,1.99,0.01,625,618.75,612.56,618.75,618.75,49.75,49.75,49.75,-0.25,-0.25,-0.25,625,625,50,50,0.25,0,0,625,625,50,0,0.25,0,625,0,0.25,0,353.192,25,24.75,0.99,328.192,25,25
675,1.99,0.01,625,618.75,612.56,0.0,321.75,49.75,24.75,37.75,-0.25,24.75,11.75,0,325,25,38,0.25,25,12,0,0,13,-25,-24.75,-13,169,-12,-11.75,13,325.006,25,24.75,0.99,325.006,0,13
676,1.99,0.01,625,618.75,612.56,0.0,618.75,49.75,24.75,49.75,-0.25,24.75,-0.25,0,625,25,50,0.25,25,0,0,0,25,-25,-24.75,-25,625,0,0.25,25,328.1073333333333,25,24.75,0.99,328.1073333333333,0,25
677,1.99,0.01,625,618.75,612.56,0.0,321.75,49.75,24.75,37.75,-0.25,24.75,11.75,0,325,25,38,0.25,25,12,0,0,13,-25,-24.75,-13,169,-12,-11.75,13,325.0713333333333,25,24.75,0.99,325.0713333333333,0,13
678,1.01,0.99,169,1.69,0.02,3.25,3.25,13.13,25.13,25.13,-12.87,-24.87,-24.87,325,325,38,38,12.87,-12,-12,625,625,50,12,24.87,0,625,12,24.87,0,347.3813333333333,13,0.13,0.010000006329579965,322.3813333333333,25,25
679,1.99,0.01,625,618.75,612.56,618.75,321.75,49.75,49.75,37.75,-0.25,-0.25,11.75,625,325,50,38,0.25,0,12,625,325,38,0,0.25,12,169,-12,-11.75,-12,349.872,25,24.75,0.99,324.872,25,13
680,1.01,0.99,625,6.25,0.06,0.0,3.25,25.25,0.25,13.25,-24.75,0.25,-12.75,0,325,25,38,24.75,25,12,0,0,13,-25,-0.25,-13,169,-12,12.75,13,325.03133333333335,25,0.25,0.01,325.03133333333335,0,13
681,1.99,0.01,625,618.75,612.56,0.0,0.0,49.75,24.75,24.75,-0.25,24.75,24.75,0,0,25,25,0.25,25,25,0,0,0,-25,-24.75,0,0,-25,-24.75,0,321.80266666666665,25,24.75,0.99,321.80266666666665,0,0
682,1.99,0.01,1,0.99,0.98,0.0,0.99,1.99,0.99,1.99,-0.01,0.99,-0.01,0,1,1,2,0.01,1,0,0,0,1,-1,-0.99,-1,1,0,0.01,1,1.0,1,0.99,0.99,1.0,0,1
683,1.99,0.01,1,0.99,0.98,0.0,0.0,1.99,0.99,0.99,-0.01,0.99,0.99,0,0,1,1,0.01,1,1,0,0,0,-1,-0.99,0,0,-1,-0.99,0,0.99,1,0.99,0.99,0.99,0,0
684,1.01,0.99,1,0.01,0.0,0.0,0.25,1.01,0.01,25.01,-0.99,0.01,-24.99,0,25,1,26,0.99,1,-24,0,0,25,-1,-0.01,-25,625,24,24.99,25,24.792,1,0.01,0.01,24.792,0,25
685,1.99,0.01,625,618.75,612.56,0.0,618.75,49.75,24.75,49.75,-0.25,24.75,-0.25,0,625,25,50,0.25,25,0,0,0,25,-25,-24.75,-25,625,0,0.25,25,327.902,25,24.75,0.99,327.902,0,25
686,1.99,0.01,1,0.99,0.98,0.0,24.75,1.99,0.99,25.99,-0.01,0.99,-24.01,0,25,1,26,0.01,1,-24,0,0,25,-1,-0.99,-25,625,24,24.01,25,1.144,1,0.99,0.99,1.144,0,25
687,1.99,0.01,625,618.75,612.56,0.0,0.0,49.75,24.75,24.75,-0.25,24.75,24.75,0,0,25,25,0.25,25,25,0,0,0,-25,-24.75,0,0,-25,-24.75,0,322.046,25,24.75,0.99,322.046,0,0
688,1.99,0.01,1,0.99,0.98,24.75,0.0,1.99,25.99,0.99,-0.01,-24.01,0.99,25,0,26,1,0.01,-24,1,625,0,25,24,24.01,25,0,-1,-0.99,-25,25.989333333333335,1,0.99,0.99,0.9893333333333345,25,0
689,1.01,0.99,4,0.04,0.0,0.5,0.0,2.02,25.02,0.02,-1.98,-24.98,0.02,50,0,27,2,1.98,-23,2,625,0,25,23,24.98,25,0,-2,-0.02,-25,25.032,2,0.02,0.01,0.03200000000000003,25,0
690,1.99,0.01,1,0.99,0.98,0.0,0.0,1.99,0.99,0.99,-0.01,0.99,0.99,0,0,1,1,0.01,1,1,0,0,0,-1,-0.99,0,0,-1,-0.99,0,0.9886666666666667,1,0.99,0.99,0.9886666666666667,0,0
691,1.01,0.99,625,6.25,0.06,0.0,0.0,25.25,0.25,0.25,-24.75,0.25,0.25,0,0,25,25,24.75,25,25,0,0,0,-25,-0.25,0,0,-25,-0.25,0,2.9966666666666666,25,0.25,0.01,2.9966666666666666,0,0
692,1.01,0.99,196,1.96,0.02,3.5,3.5,14.14,25.14,25.14,-13.86,-24.86,-24.86,350,350,39,39,13.86,-11,-11,625,625,50,11,24.86,0,625,11,24.86,0,372.34133333333335,14,0.14,0.01,347.34133333333335,25,25
693,1.99,0.01,625,618.75,612.56,618.75,321.75,49.75,49.75,37.75,-0.25,-0.25,11.75,625,325,50,38,0.25,0,12,625,325,38,0,0.25,12,169,-12,-11.75,-12,350.08666666666664,25,24.75,0.99,325.08666666666664,25,13
694,1.01,0.99,225,2.25,0.02,3.75,3.45,15.15,25.15,23.15,-14.85,-24.85,-22.85,375,345,40,38,14.85,-10,-8,625,575,48,10,24.85,2,529,8,22.85,-2,367.71733333333333,15,0.15,0.01,342.71733333333333,25,23
695,1.99,0.01,625,618.75,612.56,618.75,321.75,49.75,49.75,37.75,-0.25,-0.25,11.75,625,325,50,38,0.25,0,12,625,325,38,0,0.25,12,169,-12,-11.75,-12,350.04133333333334,25,24.75,0.99,325.04133333333334,25,13
696,1.99,0.01,625,618.75,612.56,0.0,618.75,49.75,24.75,49.75,-0.25,24.75,-0.25,0,625,25,50,0.25,25,0,0,0,25,-25,-24.75,-25,625,0,0.25,25,328.048,25,24.75,0.99,328.048,0,25
697,1.99,0.01,196,194.04,192.1,0.0,346.5,27.86,13.86,38.86,-0.14,13.86,-11.14,0,350,14,39,0.14,14,-11,0,0,25,-14,-13.86,-25,625,11,11.14,25,107.39866666666667,14,13.86,0.99,107.39866666666667,0,25
698,1.99,0.01,625,618.75,612.56,0.0,618.75,49.75,24.75,49.75,-0.25,24.75,-0.25,0,625,25,50,0.25,25,0,0,0,25,-25,-24.75,-25,625,0,0.25,25,328.16266666666667,25,24.75,0.99,328.16266666666667,0,25
699,1.99,0.01,169,167.31,165.64,0.0,321.75,25.87,12.87,37.87,-0.13,12.87,-12.13,0,325,13,38,0.13,13,-12,0,0,25,-13,-12.87,-25,625,12,12.13,25,93.372,13,12.87,0.99,93.372,0,25
700,1.99,0.01,625,618.75,612.56,618.75,0.0,49.75,49.75,24.75,-0.25,-0.25,24.75,625,0,50,25,0.25,0,25,625,0,25,0,0.25,25,0,-25,-24.75,-25,347.0106666666667,25,24.75,0.99,322.0106666666667,25,0
701,1.99,0.01,625,618.75,612.56,0.0,0.0,49.75,24.75,24.75,-0.25,24.75,24.75,0,0,25,25,0.25,25,25,0,0,0,-25,-24.75,0,0,-25,-24.75,0,321.75866666666667,25,24.75,0.99,321.75866666666667,0,0
702,1.99,0.01,625,618.75,612.56,618.75,618.75,49.75,49.75,49.75,-0.25,-0.25,-0.25,625,625,50,50,0.25,0,0,625,625,50,0,0.25,0,625,0,0.25,0,353.192,25,24.75,0.99,328.192,25,25
703,1.99,0.01,625,618.75,612.56,0.0,321.75,49.75,24.75,37.75,-0.25,24.75,11.75,0,325,25,38,0.25,25,12,0,0,13,-25,-24.75,-13,169,-12,-11.75,13,325.006,25,24.75,0.99,325.006,0,13
704,1.99,0.01,625,618.75,612.56,0.0,618.75,49.75,24.75,49.75,-0.25,24.75,-0.25,0,625,25,50,0.25,25,0,0,0,25,-25,-24.75,-25,625,0,0.25,25,328.1073333333333,25,24.75,0.99,328.1073333333333,0,25
705,1.99,0.01,625,618.75,612.56,0.0,321.75,49.75,24.75,37.75,-0.25,24.75,11.75,0,325,25,38,0.25,25,12,0,0,13,-25,-24.75,-13,169,-12,-11.75,13,325.0713333333333,25,24.75,0.99,325.0713333333333,0,13
706,1.01,0.99,169,1.69,0.02,3.25,3.25,13.13,25.13,25.13,-12.87,-24.87,-24.87,325,325,38,38,12.87,-12,-12,625,625,50,12,24.87,0,625,12,24.87,0,347.3813333333333,13,0.13,0.010000006329579965,322.3813333333333,25,25
707,1.99,0.01,625,618.75,612.56,618.75,321.75,49.75,49.75,37.75,-0.25,-0.25,11.75,625,325,50,38,0.25,0,12,625,325,38,0,0.25,12,169,-12,-11.75,-12,349.872,25,24.75,0.99,324.872,25,13
708,1.01,0.99,625,6.25,0.06,0.0,3.25,25.25,0.25,13.25,-24.75,0.25,-12.75,0,325,25,38,24.75,25,12,0,0,13,-25,-0.25,-13,169,-12,12.75,13,325.03133333333335,25,0.25,0.01,325.03133333333335,0,13
709,1.99,0.01,625,618.75,612.56,0.0,0.0,49.75,24.75,24.75,-0.25,24.75,24.75,0,0,25,25,0.25,25,25,0,0,0,-25,-24.75,0,0,-25,-24.75,0,321.80266666666665,25,24.75,0.99,321.80266666666665,0,0
710,1.99,0.01,1,0.99,0.98,0.0,0.99,1.99,0.99,1.99,-0.01,0.99,-0.01,0,1,1,2,0.01,1,0,0,0,1,-1,-0.99,-1,1,0,0.01,1,1.0,1,0.99,0.99,1.0,0,1
711,1.99,0.01,1,0.99,0.98,0.0,0.0,1.99,0.99,0.99,-0.01,0.99,0.99,0,0,1,1,0.01,1,1,0,0,0,-1,-0.99,0,0,-1,-0.99,0,0.99,1,0.99,0.99,0.99,0,0
712,1.01,0.99,1,0.01,0.0,0.0,0.25,1.01,0.01,25.01,-0.99,0.01,-24.99,0,25,1,26,0.99,1,-24,0,0,25,-1,-0.01,-25,625,24,24.99,25,24.792,1,0.01,0.01,24.792,0,25
713,1.99,0.01,625,618.75,612.56,0.0,618.75,49.75,24.75,49.75,-0.25,24.75,-0.25,0,625,25,50,0.25,25,0,0,0,25,-25,-24.75,-25,625,0,0.25,25,327.902,25,24.75,0.99,327.902,0,25
714,1.99,0.01,1,0.99,0.98,0.0,24.75,1.99,0.99,25.99,-0.01,0.99,-24.01,0,25,1,26,0.01,1,-24,0,0,25,-1,-0.99,-25,625,24,24.01,25,1.144,1,0.99,0.99,1.144,0,25
715,1.99,0.01,625,618.75,612.56,0.0,0.0,49.75,24.75,24.75,-0.25,24.75,24.75,0,0,25,25,0.25,25,25,0,0,0,-25,-24.75,0,0,-25,-24.75,0,322.046,25,24.75,0.99,322.046,0,0
716,1.99,0.01,1,0.99,0.98,24.75,0.0,1.99,25.99,0.99,-0.01,-24.01,0.99,25,0,26,1,0.01,-24,1,625,0,25,24,24.01,25,0,-1,-0.99,-25,25.989333333333335,1,0.99,0.99,0.9893333333333345,25,0
717,1.01,0.99,4,0.04,0.0,0.5,0.0,2.02,25.02,0.02,-1.98,-24.98,0.02,50,0,27,2,1.98,-23,2,625,0,25,23,24.98,25,0,-2,-0.02,-25,25.032,2,0.02,0.01,0.03200000000000003,25,0
718,1.99,0.01,1,0.99,0.98,0.0,0.0,1.99,0.99,0.99,-0.01,0.99,0.99,0,0,1,1,0.01,1,1,0,0,0,-1,-0.99,0,0,-1,-0.99,0,0.9886666666666667,1,0.99,0.99,0.9886666666666667,0,0
719,1.01,0.99,625,6.25,0.06,0.0,0.0,25.25,0.25,0.25,-24.75,0.25,0.25,0,0,25,25,24.75,25,25,0,0,0,-25,-0.25,0,0,-25,-0.25,0,2.9966666666666666,25,0.25,0.01,2.9966666666666666,0,0
720,1.01,0.99,196,1.96,0.02,3.5,3.5,14.14,25.14,25.14,-13.86,-24.86,-24.86,350,350,39,39,13.86,-11,-11,625,625,50,11,24.86,0,625,11,24.86,0,372.34133333333335,14,0.14,0.01,347.34133333333335,25,25
721,1.99,0.01,625,618.75,612.56,618.75,321.75,49.75,49.75,37.75,-0.25,-0.25,11.75,625,325,50,38,0.25,0,12,625,325,38,0,0.25,12,169,-12,-11.75,-12,350.08666666666664,25,24.75,0.99,325.08666666666664,25,13
722,1.01,0.99,225,2.25,0.02,3.75,3.45,15.15,25.15,23.15,-14.85,-24.85,-22.85,375,345,40,38,14.85,-10,-8,625,575,48,10,24.85,2,529,8,22.85,-2,367.71733333333333,15,0.15,0.01,342.71733333333333,25,23
723,1.99,0.01,625,618.75,612.56,618.75,321.75,49.75,49.75,37.75,-0.25,-0.25,11.75,625,325,50,38,0.25,0,12,625,325,38,0,0.25,12,169,-12,-11.75,-12,350.04133333333334,25,24.75,0.99,325.04133333333334,25,13
724,1.99,0.01,625,618.75,612.56,0.0,618.75,49.75,24.75,49.75,-0.25,24.75,-0.25,0,625,25,50,0.25,25,0,0,0,25,-25,-24.75,-25,625,0,0.25,25,328.048,25,24.75,0.99,328.048,0,25
725,1.99,0.01,196,194.04,192.1,0.0,346.5,27.86,13.86,38.86,-0.14,13.86,-11.14,0,350,14,39,0.14,14,-11,0,0,25,-14,-13.86,-25,625,11,11.14,25,107.39866666666667,14,13.86,0.99,107.39866666666667,0,25
726,1.99,0.01,625,618.75,612.56,0.0,618.75,49.75,24.75,49.75,-0.25,24.75,-0.25,0,625,25,50,0.25,25,0,0,0,25,-25,-24.75,-25,625,0,0.25,25,328.16266666666667,25,24.75,0.99,328.16266666666667,0,25
727,1.99,0.01,169,167.31,165.64,0.0,321.75,25.87,12.87,37.87,-0.13,12.87,-12.13,0,325,13,38,0.13,13,-12,0,0,25,-13,-12.87,-25,625,12,12.13,25,93.372,13,12.87,0.99,93.372,0,25
728,1.99,0.01,625,618.75,612.56,618.75,0.0,49.75,49.75,24.75,-0.25,-0.25,24.75,625,0,50,25,0.25,0,25,625,0,25,0,0.25,25,0,-25,-24.75,-25,347.0106666666667,25,24.75,0.99,322.0106666666667,25,0
729,1.99,0.01,625,618.75,612.56,0.0,0.0,49.75,24.75,24.75,-0.25,24.75,24.75,0,0,25,25,0.25,25,25,0,0,0,-25,-24.75,0,0,-25,-24.75,0,321.75866666666667,25,24.75,0.99,321.75866666666667,0,0
730,1.99,0.01,625,618.75,612.56,618.75,618.75,49.75,49.75,49.75,-0.25,-0.25,-0.25,625,625,50,50,0.25,0,0,625,625,50,0,0.25,0,625,0,0.25,0,353.192,25,24.75,0.99,328.192,25,25
731,1.99,0.01,625,618.75,612.56,0.0,321.75,49.75,24.75,37.75,-0.25,24.75,11.75,0,325,25,38,0.25,25,12,0,0,13,-25,-24.75,-13,169,-12,-11.75,13,325.006,25,24.75,0.99,325.006,0,13
732,1.99,0.01,625,618.75,612.56,0.0,618.75,49.75,24.75,49.75,-0.25,24.75,-0.25,0,625,25,50,0.25,25,0,0,0,25,-25,-24.75,-25,625,0,0.25,25,328.1073333333333,25,24.75,0.99,328.1073333333333,0,25
733,1.99,0.01,625,618.75,612.56,0.0,321.75,49.75,24.75,37.75,-0.25,24.75,11.75,0,325,25,38,0.25,25,12,0,0,13,-25,-24.75,-13,169,-12,-11.75,13,325.0713333333333,25,24.75,0.99,325.0713333333333,0,13
734,1.01,0.99,169,1.69,0.02,3.25,3.25,13.13,25.13,25.13,-12.87,-24.87,-24.87,325,325,38,38,12.87,-12,-12,625,625,50,12,24.87,0,625,12,24.87,0,347.3813333333333,13,0.13,0.010000006329579965,322.3813333333333,25,25
735,1.99,0.01,625,618.75,612.56,618.75,321.75,49.75,49.75,37.75,-0.25,-0.25,11.75,625,325,50,38,0.25,0,12,625,325,38,0,0.25,12,169,-12,-11.75,-12,349.872,25,24.75,0.99,324.872,25,13
736,1.01,0.99,625,6.25,0.06,0.0,3.25,25.25,0.25,13.25,-24.75,0.25,-12.75,0,325,25,38,24.75,25,12,0,0,13,-25,-0.25,-13,169,-12,12.75,13,325.03133333333335,25,0.25,0.01,325.03133333333335,0,13
737,1.99,0.01,625,618.75,612.56,0.0,0.0,49.75,24.75,24.75,-0.25,24.75,24.75,0,0,25,25,0.25,25,25,0,0,0,-25,-24.75,0,0,-25,-24.75,0,321.80266666666665,25,24.75,0.99,321.80266666666665,0,0
738,1.99,0.01,1,0.99,0.98,0.0,0.99,1.99,0.99,1.99,-0.01,0.99,-0.01,0,1,1,2,0.01,1,0,0,0,1,-1,-0.99,-1,1,0,0.01,1,1.0,1,0.99,0.99,1.0,0,1
739,1.99,0.01,1,0.99,0.98,0.0,0.0,1.99,0.99,0.99,-0.01,0.99,0.99,0,0,1,1,0.01,1,1,0,0,0,-1,-0.99,0,0,-1,-0.99,0,0.99,1,0.99,0.99,0.99,0,0
740,1.01,0.99,1,0.01,0.0,0.0,0.25,1.01,0.01,25.01,-0.99,0.01,-24.99,0,25,1,26,0.99,1,-24,0,0,25,-1,-0.01,-25,625,24,24.99,25,24.792,1,0.01,0.01,24.792,0,25
741,1.99,0.01,625,618.75,612.56,0.0,618.75,49.75,24.75,49.75,-0.25,24.75,-0.25,0,625,25,50,0.25,25,0,0,0,25,-25,-24.75,-25,625,0,0.25,25,327.902,25,24.75,0.99,327.902,0,25
742,1.99,0.01,1,0.99,0.98,0.0,24.75,1.99,0.99,25.99,-0.01,0.99,-24.01,0,25,1,26,0.01,1,-24,0,0,25,-1,-0.99,-25,625,24,24.01,25,1.144,1,0.99,0.99,1.144,0,25
743,1.99,0.01,625,618.75,612.56,0.0,0.0,49.75,24.75,24.75,-0.25,24.75,24.75,0,0,25,25,0.25,25,25,0,0,0,-25,-24.75,0,0,-25,-24.75,0,322.046,25,24.75,0.99,322.046,0,0
744,1.99,0.01,1,0.99,0.98,24.75,0.0,1.99,25.99,0.99,-0.01,-24.01,0.99,25,0,26,1,0.01,-24,1,625,0,25,24,24.01,25,0,-1,-0.99,-25,25.989333333333335,1,0.99,0.99,0.9893333333333345,25,0
745,1.01,0.99,4,0.04,0.0,0.5,0.0,2.02,25.02,0.02,-1.98,-24.98,0.02,50,0,27,2,1.98,-23,2,625,0,25,23,24.98,25,0,-2,-0.02,-25,25.032,2,0.02,0.01,0.03200000000000003,25,0
746,1.99,0.01,1,0.99,0.98,0.0,0.0,1.99,0.99,0.99,-0.01,0.99,0.99,0,0,1,1,0.01,1,1,0,0,0,-1,-0.99,0,0,-1,-0.99,0,0.9886666666666667,1,0.99,0.99,0.9886666666666667,0,0
747,1.01,0.99,625,6.25,0.06,0.0,0.0,25.25,0.25,0.25,-24.75,0.25,0.25,0,0,25,25,24.75,25,25,0,0,0,-25,-0.25,0,0,-25,-0.25,0,2.9966666666666666,25,0.25,0.01,2.9966666666666666,0,0
748,1.01,0.99,196,1.96,0.02,3.5,3.5,14.14,25.14,25.14,-13.86,-24.86,-24.86,350,350,39,39,13.86,-11,-11,625,625,50,11,24.86,0,625,11,24.86,0,372.34133333333335,14,0.14,0.01,347.34133333333335,25,25
749,1.99,0.01,625,618.75,612.56,618.75,321.75,49.75,49.75,37.75,-0.25,-0.25,11.75,625,325,50,38,0.25,0,12,625,325,38,0,0.25,12,169,-12,-11.75,-12,350.08666666666664,25,24.75,0.99,325.08666666666664,25,13
750,1.01,0.99,225,2.25,0.02,3.75,3.45,15.15,25.15,23.15,-14.85,-24.85,-22.85,375,345,40,38,14.85,-10,-8,625,575,48,10,24.85,2,529,8,22.85,-2,367.71733333333333,15,0.15,0.01,342.71733333333333,25,23
751,1.99,0.01,625,618.75,612.56,618.75,321.75,49.75,49.75,37.75,-0.25,-0.25,11.75,625,325,50,38,0.25,0,12,625,325,38,0,0.25,12,169,-12,-11.75,-12,350.04133333333334,25,24.75,0.99,325.04133333333334,25,13
752,1.99,0.01,625,618.75,612.56,0.0,618.75,49.75,24.75,49.75,-0.25,24.75,-0.25,0,625,25,50,0.25,25,0,0,0,25,-25,-24.75,-25,625,0,0.25,25,328.048,25,24.75,0.99,328.048,0,25
753,1.99,0.01,196,194.04,192.1,0.0,346.5,27.86,13.86,38.86,-0.14,13.86,-11.14,0,350,14,39,0.14,14,-11,0,0,25,-14,-13.86,-25,625,11,11.14,25,107.39866666666667,14,13.86,0.99,107.39866666666667,0,25
754,1.99,0.01,625,618.75,612.56,0.0,618.75,49.75,24.75,49.75,-0.25,24.75,-0.25,0,625,25,50,0.25,25,0,0,0,25,-25,-24.75,-25,625,0,0.25,25,328.16266666666667,25,24.75,0.99,328.16266666666667,0,25
755,1.99,0.01,169,167.31,165.64,0.0,321.75,25.87,12.87,37.87,-0.13,12.87,-12.13,0,325,13,38,0.13,13,-12,0,0,25,-13,-12.87,-25,625,12,12.13,25,93.372,13,12.87,0.99,93.372,0,25
756,1.99,0.01,625,618.75,612.56,618.75,0.0,49.75,49.75,24.75,-0.25,-0.25,24.75,625,0,50,25,0.25,0,25,625,0,25,0,0.25,25,0,-25,-24.75,-25,347.0106666666667,25,24.75,0.99,322.0106666666667,25,0
757,1.99,0.01,625,618.75,612.56,0.0,0.0,49.75,24.75,24.75,-0.25,24.75,24.75,0,0,25,25,0.25,25,25,0,0,0,-25,-24.75,0,0,-25,-24.75,0,321.75866666666667,25,24.75,0.99,321.75866666666667,0,0
758,1.99,0.01,625,618.75,612.56,618.75,618.75,49.75,49.75,49.75,-0.25,-0.25,-0.25,625,625,50,50,0.25,0,0,625,625,50,0,0.25,0,625,0,0.25,0,353.192,25,24.75,0.99,328.192,25,25
759,1.99,0.01,625,618.75,612.56,0.0,321.75,49.75,24.75,37.75,-0.25,24.75,11.75,0,325,25,38,0.25,25,12,0,0,13,-25,-24.75,-13,169,-12,-11.75,13,325.006,25,24.75,0.99,325.006,0,13
760,1.99,0.01,625,618.75,612.56,0.0,618.75,49.75,24.75,49.75,-0.25,24.75,-0.25,0,625,25,50,0.25,25,0,0,0,25,-25,-24.75,-25,625,0,0.25,25,328.1073333333333,25,24.75,0.99,328.1073333333333,0,25
761,1.99,0.01,625,618.75,612.56,0.0,321.75,49.75,24.75,37.75,-0.25,24.75,11.75,0,325,25,38,0.25,25,12,0,0,13,-25,-24.75,-13,169,-12,-11.75,13,325.0713333333333,25,24.75,0.99,325.0713333333333,0,13
762,1.01,0.99,169,1.69,0.02,3.25,3.25,13.13,25.13,25.13,-12.87,-24.87,-24.87,325,325,38,38,12.87,-12,-12,625,625,50,12,24.87,0,625,12,24.87,0,347.3813333333333,13,0.13,0.010000006329579965,322.3813333333333,25,25
763,1.99,0.01,625,618.75,612.56,618.75,321.75,49.75,49.75,37.75,-0.25,-0.25,11.75,625,325,50,38,0.25,0,12,625,325,38,0,0.25,12,169,-12,-11.75,-12,349.872,25,24.75,0.99,324.872,25,13
764,1.01,0.99,625,6.25,0.06,0.0,3.25,25.25,0.25,13.25,-24.75,0.25,-12.75,0,325,25,38,24.75,25,12,0,0,13,-25,-0.25,-13,169,-12,12.75,13,325.03133333333335,25,0.25,0.01,325.03133333333335,0,13
765,1.99,0.01,625,618.75,612.56,0.0,0.0,49.75,24.75,24.75,-0.25,24.75,24.75,0,0,25,25,0.25,25,25,0,0,0,-25,-24.75,0,0,-25,-24.75,0,321.80266666666665,25,24.75,0.99,321.80266666666665,0,0
766,1.99,0.01,1,0.99,0.98,0.0,0.99,1.99,0.99,1.99,-0.01,0.99,-0.01,0,1,1,2,0.01,1,0,0,0,1,-1,-0.99,-1,1,0,0.01,1,1.0,1,0.99,0.99,1.0,0,1
767,1.99,0.01,1,0.99,0.98,0.0,0.0,1.99,0.99,0.99,-0.01,0.99,0.99,0,0,1,1,0.01,1,1,0,0,0,-1,-0.99,0,0,-1,-0.99,0,0.99,1,0.99,0.99,0.99,0,0
768,1.01,0.99,1,0.01,0.0,0.0,0.25,1.01,0.01,25.01,-0.99,0.01,-24.99,0,25,1,26,0.99,1,-24,0,0,25,-1,-0.01,-25,625,24,24.99,25,24.792,1,0.01,0.01,24.792,0,25
769,1.99,0.01,625,618.75,612.56,0.0,618.75,49.75,24.75,49.75,-0.25,24.75,-0.25,0,625,25,50,0.25,25,0,0,0,25,-25,-24.75,-25,625,0,0.25,25,327.902,25,24.75,0.99,327.902,0,25
770,1.99,0.01,1,0.99,0.98,0.0,24.75,1.99,0.99,25.99,-0.01,0.99,-24.01,0,25,1,26,0.01,1,-24,0,0,25,-1,-0.99,-25,625,24,24.01,25,1.144,1,0.99,0.99,1.144,0,25
771,1.99,0.01,625,618.75,612.56,0.0,0.0,49.75,24.75,24.75,-0.25,24.75,24.75,0,0,25,25,0.25,25,25,0,0,0,-25,-24.75,0,0,-25,-24.75,0,322.046,25,24.75,0.99,322.046,0,0
772,1.99,0.01,1,0.99,0.98,24.75,0.0,1.99,25.99,0.99,-0.01,-24.01,0.99,25,0,26,1,0.01,-24,1,625,0,25,24,24.01,25,0,-1,-0.99,-25,25.989333333333335,1,0.99,0.99,0.9893333333333345,25,0
773,1.01,0.99,4,0.04,0.0,0.5,0.0,2.02,25.02,0.02,-1.98,-24.98,0.02,50,0,27,2,1.98,-23,2,625,0,25,23,24.98,25,0,-2,-0.02,-25,25.032,2,0.02,0.01,0.03200000000000003,25,0
774,1.99,0.01,1,0.99,0.98,0.0,0.0,1.99,0.99,0.99,-0.01,0.99,0.99,0,0,1,1,0.01,1,1,0,0,0,-1,-0.99,0,0,-1,-0.99,0,0.9886666666666667,1,0.99,0.99,0.9886666666666667,0,0
775,1.01,0.99,625,6.25,0.06,0.0,0.0,25.25,0.25,0.25,-24.75,0.25,0.25,0,0,25,25,24.75,25,25,0,0,0,-25,-0.25,0,0,-25,-0.25,0,2.9966666666666666,25,0.25,0.01,2.9966666666666666,0,0
776,1.01,0.99,196,1.96,0.02,3.5,3.5,14.14,25.14,25.14,-13.86,-24.86,-24.86,350,350,39,39,13.86,-11,-11,625,625,50,11,24.86,0,625,11,24.86,0,372.34133333333335,14,0.14,0.01,347.34133333333335,25,25
777,1.99,0.01,625,618.75,612.56,618.75,321.75,49.75,49.75,37.75,-0.25,-0.25,11.75,625,325,50,38,0.25,0,12,625,325,38,0,0.25,12,169,-12,-11.75,-12,350.08666666666664,25,24.75,0.99,325.08666666666664,25,13
778,1.01,0.99,225,2.25,0.02,3.75,3.45,15.15,25.15,23.15,-14.85,-24.85,-22.85,375,345,40,38,14.85,-10,-8,625,575,48,10,24.85,2,529,8,22.85,-2,367.71733333333333,15,0.15,0.01,342.71733333333333,25,23
779,1.99,0.01,625,618.75,612.56,618.75,321.75,49.75,49.75,37.75,-0.25,-0.25,11.75,625,325,50,38,0.25,0,12,625,325,38,0,0.25,12,169,-12,-11.75,-12,350.04133333333334,25,24.75,0.99,325.04133333333334,25,13
780,1.99,0.01,625,618.75,612.56,0.0,618.75,49.75,24.75,49.75,-0.25,24.75,-0.25,0,625,25,50,0.25,25,0,0,0,25,-25,-24.75,-25,625,0,0.25,25,328.048,25,24.75,0.99,328.048,0,25
781,1.99,0.01,196,194.04,192.1,0.0,346.5,27.86,13.86,38.86,-0.14,13.86,-11.14,0,350,14,39,0.14,14,-11,0,0,25,-14,-13.86,-25,625,11,11.14,25,107.39866666666667,14,13.86,0.99,107.39866666666667,0,25
782,1.99,0.01,625,618.75,612.56,0.0,618.75,49.75,24.75,49.75,-0.25,24.75,-0.25,0,625,25,50,0.25,25,0,0,0,25,-25,-24.75,-25,625,0,0.25,25,328.16266666666667,25,24.75,0.99,328.16266666666667,0,25
783,1.99,0.01,169,167.31,165.64,0.0,321.75,25.87,12.87,37.87,-0.13,12.87,-12.13,0,325,13,38,0.13,13,-12,0,0,25,-13,-12.87,-25,625,12,12.13,25,93.372,13,12.87,0.99,93.372,0,25
784,1.99,0.01,625,618.75,612.56,618.75,0.0,49.75,49.75,24.75,-0.25,-0.25,24.75,625,0,50,25,0.25,0,25,625,0,25,0,0.25,25,0,-25,-24.75,-25,347.0106666666667,25,24.75,0.99,322.0106666666667,25,0
785,1.99,0.01,625,618.75,612.56,0.0,0.0,49.75,24.75,24.75,-0.25,24.75,24.75,0,0,25,25,0.25,25,25,0,0,0,-25,-24.75,0,0,-25,-24.75,0,321.75866666666667,25,24.75,0.99,321.75866666666667,0,0
786,1.99,0.01,625,618.75,612.56,618.75,618.75,49.75,49.75,49.75,-0.25,-0.25,-0.25,625,625,50,50,0.25,0,0,625,625,50,0,0.25,0,625,0,0.25,0,353.192,25,24.75,0.99,328.192,25,25
787,1.99,0.01,625,618.75,612.56,0.0,321.75,49.75,24.75,37.75,-0.25,24.75,11.75,0,325,25,38,0.25,25,12,0,0,13,-25,-24.75,-13,169,-12,-11.75,13,325.006,25,24.75,0.99,325.006,0,13
788,1.99,0.01,625,618.75,612.56,0.0,618.75,49.75,24.75,49.75,-0.25,24.75,-0.25,0,625,25,50,0.25,25,0,0,0,25,-25,-24.75,-25,625,0,0.25,25,328.1073333333333,25,24.75,0.99,328.1073333333333,0,25
789,1.99,0.01,625,618.75,612.56,0.0,321.75,49.75,24.75,37.75,-0.25,24.75,11.75,0,325,25,38,0.25,25,12,0,0,13,-25,-24.75,-13,169,-12,-11.75,13,325.0713333333333,25,24.75,0.99,325.0713333333333,0,13
790,1.01,0.99,169,1.69,0.02,3.25,3.25,13.13,25.13,25.13,-12.87,-24.87,-24.87,325,325,38,38,12.87,-12,-12,625,625,50,12,24.87,0,625,12,24.87,0,347.3813333333333,13,0.13,0.010000006329579965,322.3813333333333,25,25
791,1.99,0.01,625,618.75,612.56,618.75,321.75,49.75,49.75,37.75,-0.25,-0.25,11.75,625,325,50,38,0.25,0,12,625,325,38,0,0.25,12,169,-12,-11.75,-12,349.872,25,24.75,0.99,324.872,25,13
792,1.01,0.99,625,6.25,0.06,0.0,3.25,25.25,0.25,13.25,-24.75,0.25,-12.75,0,325,25,38,24.75,25,12,0,0,13,-25,-0.25,-13,169,-12,12.75,13,325.03133333333335,25,0.25,0.01,325.03133333333335,0,13
793,1.99,0.01,625,618.75,612.56,0.0,0.0,49.75,24.75,24.75,-0.25,24.75,24.75,0,0,25,25,0.25,25,25,0,0,0,-25,-24.75,0,0,-25,-24.75,0,321.80266666666665,25,24.75,0.99,321.80266666666665,0,0
794,1.99,0.01,1,0.99,0.98,0.0,0.99,1.99,0.99,1.99,-0.01,0.99,-0.01,0,1,1,2,0.01,1,0,0,0,1,-1,-0.99,-1,1,0,0.01,1,1.0,1,0.99,0.99,1.0,0,1
795,1.99,0.01,1,0.99,0.98,0.0,0.0,1.99,0.99,0.99,-0.01,0.99,0.99,0,0,1,1,0.01,1,1,0,0,0,-1,-0.99,0,0,-1,-0.99,0,0.99,1,0.99,0.99,0.99,0,0
796,1.01,0.99,1,0.01,0.0,0.0,0.25,1.01,0.01,25.01,-0.99,0.01,-24.99,0,25,1,26,0.99,1,-24,0,0,25,-1,-0.01,-25,625,24,24.99,25,24.792,1,0.01,0.01,24.792,0,25
797,1.99,0.01,625,618.75,612.56,0.0,618.75,49.75,24.75,49.75,-0.25,24.75,-0.25,0,625,25,50,0.25,25,0,0,0,25,-25,-24.75,-25,625,0,0.25,25,327.902,25,24.75,0.99,327.902,0,25
798,1.99,0.01,1,0.99,0.98,0.0,24.75,1.99,0.99,25.99,-0.01,0.99,-24.01,0,25,1,26,0.01,1,-24,0,0,25,-1,-0.99,-25,625,24,24.01,25,1.144,1,0.99,0.99,1.144,0,25
799,1.99,0.01,625,618.75,612.56,0.0,0.0,49.75,24.75,24.75,-0.25,24.75,24.75,0,0,25,25,0.25,25,25,0,0,0,-25,-24.75,0,0,-25,-24.75,0,322.046,25,24.75,0.99,322.046,0,0
800,1.99,0.01,1,0.99,0.98,24.75,0.0,1.99,25.99,0.99,-0.01,-24.01,0.99,25,0,26,1,0.01,-24,1,625,0,25,24,24.01,25,0,-1,-0.99,-25,25.989333333333335,1,0.99,0.99,0.9893333333333345,25,0
801,1.01,0.99,4,0.04,0.0,0.5,0.0,2.02,25.02,0.02,-1.98,-24.98,0.02,50,0,27,2,1.98,-23,2,625,0,25,23,24.98,25,0,-2,-0.02,-25,25.032,2,0.02,0.01,0.03200000000000003,25,0
802,1.99,0.01,1,0.99,0.98,0.0,0.0,1.99,0.99,0.99,-0.01,0.99,0.99,0,0,1,1,0.01,1,1,0,0,0,-1,-0.99,0,0,-1,-0.99,0,0.9886666666666667,1,0.99,0.99,0.9886666666666667,0,0
803,1.01,0.99,625,6.25,0.06,0.0,0.0,25.25,0.25,0.25,-24.75,0.25,0.25,0,0,25,25,24.75,25,25,0,0,0,-25,-0.25,0,0,-25,-0.25,0,2.9966666666666666,25,0.25,0.01,2.9966666666666666,0,0
804,1.01,0.99,196,1.96,0.02,3.5,3.5,14.14,25.14,25.14,-13.86,-24.86,-24.86,350,350,39,39,13.86,-11,-11,625,625,50,11,24.86,0,625,11,24.86,0,372.34133333333335,14,0.14,0.01,347.34133333333335,25,25
805,1.99,0.01,625,618.75,612.56,618.75,321.75,49.75,49.75,37.75,-0.25,-0.25,11.75,625,325,50,38,0.25,0,12,625,325,38,0,0.25,12,169,-12,-11.75,-12,350.08666666666664,25,24.75,0.99,325.08666666666664,25,13
806,1.01,0.99,225,2.25,0.02,3.75,3.45,15.15,25.15,23.15,-14.85,-24.85,-22.85,375,345,40,38,14.85,-10,-8,625,575,48,10,24.85,2,529,8,22.85,-2,367.71733333333333,15,0.15,0.01,342.71733333333333,25,23
807,1.99,0.01,625,618.75,612.56,618.75,321.75,49.75,49.75,37.75,-0.25,-0.25,11.75,625,325,50,38,0.25,0,12,625,325,38,0,0.25,12,169,-12,-11.75,-12,350.04133333333334,25,24.75,0.99,325.04133333333334,25,13
808,1.99,0.01,625,618.75,612.56,0.0,618.75,49.75,24.75,49.75,-0.25,24.75,-0.25,0,625,25,50,0.25,25,0,0,0,25,-25,-24.75,-25,625,0,0.25,25,328.048,25,24.75,0.99,328.048,0,25
809,1.99,0.01,196,194.04,192.1,0.0,346.5,27.86,13.86,38.86,-0.14,13.86,-11.14,0,350,14,39,0.14,14,-11,0,0,25,-14,-13.86,-25,625,11,11.14,25,107.39866666666667,14,13.86,0.99,107.39866666666667,0,25
810,1.99,0.01,625,618.75,612.56,0.0,618.75,49.75,24.75,49.75,-0.25,24.75,-0.25,0,625,25,50,0.25,25,0,0,0,25,-25,-24.75,-25,625,0,0.25,25,328.16266666666667,25,24.75,0.99,328.16266666666667,0,25
811,1.99,0.01,169,167.31,165.64,0.0,321.75,25.87,12.87,37.87,-0.13,12.87,-12.13,0,325,13,38,0.13,13,-12,0,0,25,-13,-12.87,-25,625,12,12.13,25,93.372,13,12.87,0.99,93.372,0,25
812,1.99,0.01,625,618.75,612.56,618.75,0.0,49.75,49.75,24.75,-0.25,-0.25,24.75,625,0,50,25,0.25,0,25,625,0,25,0,0.25,25,0,-25,-24.75,-25,347.0106666666667,25,24.75,0.99,322.0106666666667,25,0
813,1.99,0.01,625,618.75,612.56,0.0,0.0,49.75,24.75,24.75,-0.25,24.75,24.75,0,0,25,25,0.25,25,25,0,0,0,-25,-24.75,0,0,-25,-24.75,0,321.75866666666667,25,24.75,0.99,321.75866666666667,0,0
814,1.99,0.01,625,618.75,612.56,618.75,618.75,49.75,49.75,49.75,-0.25,-0.25,-0.25,625,625,50,50,0.25,0,0,625,625,50,0,0.25,0,625,0,0.25,0,353.192,25,24.75,0.99,328.192,25,25
815,1.99,0.01,625,618.75,612.56,0.0,321.75,49.75,24.75,37.75,-0.25,24.75,11.75,0,325,25,38,0.25,25,12,0,0,13,-25,-24.75,-13,169,-12,-11.75,13,325.006,25,24.75,0.99,325.006,0,13
816,1.99,0.01,625,618.75,612.56,0.0,618.75,49.75,24.75,49.75,-0.25,24.75,-0.25,0,625,25,50,0.25,25,0,0,0,25,-25,-24.75,-25,625,0,0.25,25,328.1073333333333,25,24.75,0.99,328.1073333333333,0,25
817,1.99,0.01,625,618.75,612.56,0.0,321.75,49.75,24.75,37.75,-0.25,24.75,11.75,0,325,25,38,0.25,25,12,0,0,13,-25,-24.75,-13,169,-12,-11.75,13,325.0713333333333,25,24.75,0.99,325.0713333333333,0,13
818,1.01,0.99,169,1.69,0.02,3.25,3.25,13.13,25.13,25.13,-12.87,-24.87,-24.87,325,325,38,38,12.87,-12,-12,625,625,50,12,24.87,0,625,12,24.87,0,347.3813333333333,13,0.13,0.010000006329579965,322.3813333333333,25,25
819,1.99,0.01,625,618.75,612.56,618.75,321.75,49.75,49.75,37.75,-0.25,-0.25,11.75,625,325,50,38,0.25,0,12,625,325,38,0,0.25,12,169,-12,-11.75,-12,349.872,25,24.75,0.99,324.872,25,13
820,1.01,0.99,625,6.25,0.06,0.0,3.25,25.25,0.25,13.25,-24.75,0.25,-12.75,0,325,25,38,24.75,25,12,0,0,13,-25,-0.25,-13,169,-12,12.75,13,325.03133333333335,25,0.25,0.01,325.03133333333335,0,13
821,1.99,0.01,625,618.75,612.56,0.0,0.0,49.75,24.75,24.75,-0.25,24.75,24.75,0,0,25,25,0.25,25,25,0,0,0,-25,-24.75,0,0,-25,-24.75,0,321.80266666666665,25,24.75,0.99,321.80266666666665,0,0
822,1.99,0.01,1,0.99,0.98,0.0,0.99,1.99,0.99,1.99,-0.01,0.99,-0.01,0,1,1,2,0.01,1,0,0,0,1,-1,-0.99,-1,1,0,0.01,1,1.0,1,0.99,0.99,1.0,0,1
823,1.99,0.01,1,0.99,0.98,0.0,0.0,1.99,0.99,0.99,-0.01,0.99,0.99,0,0,1,1,0.01,1,1,0,0,0,-1,-0.99,0,0,-1,-0.99,0,0.99,1,0.99,0.99,0.99,0,0
824,1.01,0.99,1,0.01,0.0,0.0,0.25,1.01,0.01,25.01,-0.99,0.01,-24.99,0,25,1,26,0.99,1,-24,0,0,25,-1,-0.01,-25,625,24,24.99,25,24.792,1,0.01,0.01,24.792,0,25
825,1.99,0.01,625,618.75,612.56,0.0,618.75,49.75,24.75,49.75,-0.25,24.75,-0.25,0,625,25,50,0.25,25,0,0,0,25,-25,-24.75,-25,625,0,0.25,25,327.902,25,24.75,0.99,327.902,0,25
826,1.99,0.01,1,0.99,0.98,0.0,24.75,1.99,0.99,25.99,-0.01,0.99,-24.01,0,25,1,26,0.01,1,-24,0,0,25,-1,-0.99,-25,625,24,24.01,25,1.144,1,0.99,0.99,1.144,0,25
827,1.99,0.01,625,618.75,612.56,0.0,0.0,49.75,24.75,24.75,-0.25,24.75,24.75,0,0,25,25,0.25,25,25,0,0,0,-25,-24.75,0,0,-25,-24.75,0,322.046,25,24.75,0.99,322.046,0,0
828,1.99,0.01,1,0.99,0.98,24.75,0.0,1.99,25.99,0.99,-0.01,-24.01,0.99,25,0,26,1,0.01,-24,1,625,0,25,24,24.01,25,0,-1,-0.99,-25,25.989333333333335,1,0.99,0.99,0.9893333333333345,25,0
829,1.01,0.99,4,0.04,0.0,0.5,0.0,2.02,25.02,0.02,-1.98,-24.98,0.02,50,0,27,2,1.98,-23,2,625,0,25,23,24.98,25,0,-2,-0.02,-25,25.032,2,0.02,0.01,0.03200000000000003,25,0
830,1.99,0.01,1,0.99,0.98,0.0,0.0,1.99,0.99,0.99,-0.01,0.99,0.99,0,0,1,1,0.01,1,1,0,0,0,-1,-0.99,0,0,-1,-0.99,0,0.9886666666666667,1,0.99,0.99,0.9886666666666667,0,0
831,1.01,0.99,625,6.25,0.06,0.0,0.0,25.25,0.25,0.25,-24.75,0.25,0.25,0,0,25,25,24.75,25,25,0,0,0,-25,-0.25,0,0,-25,-0.25,0,2.9966666666666666,25,0.25,0.01,2.9966666666666666,0,0
832,1.01,0.99,196,1.96,0.02,3.5,3.5,14.14,25.14,25.14,-13.86,-24.86,-24.86,350,350,39,39,13.86,-11,-11,625,625,50,11,24.86,0,625,11,24.86,0,372.34133333333335,14,0.14,0.01,347.34133333333335,25,25
833,1.99,0.01,625,618.75,612.56,618.75,321.75,49.75,49.75,37.75,-0.25,-0.25,11.75,625,325,50,38,0.25,0,12,625,325,38,0,0.25,12,169,-12,-11.75,-12,350.08666666666664,25,24.75,0.99,325.08666666666664,25,13
834,1.01,0.99,225,2.25,0.02,3.75,3.45,15.15,25.15,23.15,-14.85,-24.85,-22.85,375,345,40,38,14.85,-10,-8,625,575,48,10,24.85,2,529,8,22.85,-2,367.71733333333333,15,0.15,0.01,342.71733333333333,25,23
835,1.99,0.01,625,618.75,612.56,618.75,321.75,49.75,49.75,37.75,-0.25,-0.25,11.75,625,325,50,38,0.25,0,12,625,325,38,0,0.25,12,169,-12,-11.75,-12,350.04133333333334,25,24.75,0.99,325.04133333333334,25,13
836,1.99,0.01,625,618.75,612.56,0.0,618.75,49.75,24.75,49.75,-0.25,24.75,-0.25,0,625,25,50,0.25,25,0,0,0,25,-25,-24.75,-25,625,0,0.25,25,328.048,25,24.75,0.99,328.048,0,25
837,1.99,0.01,196,194.04,192.1,0.0,346.5,27.86,13.86,38.86,-0.14,13.86,-11.14,0,350,14,39,0.14,14,-11,0,0,25,-14,-13.86,-25,625,11,11.14,25,107.39866666666667,14,13.86,0.99,107.39866666666667,0,25
838,1.99,0.01,625,618.75,612.56,0.0,618.75,49.75,24.75,49.75,-0.25,24.75,-0.25,0,625,25,50,0.25,25,0,0,0,25,-25,-24.75,-25,625,0,0.25,25,328.16266666666667,25,24.75,0.99,328.16266666666667,0,25
839,1.99,0.01,169,167.31,165.64,0.0,321.75,25.87,12.87,37.87,-0.13,12.87,-12.13,0,325,13,38,0.13,13,-12,0,0,25,-13,-12.87,-25,625,12,12.13,25,93.372,13,12.87,0.99,93.372,0,25
0,1.46,0.54,81,37.26,17.14,41.4,78.66,13.14,14.14,23.14,-4.86,-5.86,-14.86,90,171,19,28,4.86,-1,-10,100,190,29,1,5.86,-9,361,10,14.86,9,124.638,9,4.14,0.46,114.638,10,19
1,1.39,0.61,16,6.24,2.43,9.36,28.08,5.56,7.56,19.56,-2.44,-4.44,-16.44,24,72,10,22,2.44,-2,-14,36,108,24,2,4.44,-12,324,14,16.44,12,53.284,4,1.56,0.39,47.284,6,18
2,1.11,0.89,361,39.71,4.37,12.54,18.81,21.09,8.09,11.09,-16.91,-3.91,-6.91,114,171,25,28,16.91,13,10,36,54,15,-13,3.91,-3,81,-10,6.91,3,179.734,19,2.09,0.11,173.734,6,9
3,1.51,0.49,16,8.16,4.16,18.36,28.56,6.04,11.04,16.04,-1.96,-6.96,-11.96,36,56,13,18,1.96,-5,-10,81,126,23,5,6.96,-5,196,10,11.96,5,41.32,4,2.04,0.51,32.32,9,14
4,1.73,0.27,121,88.33,64.48,88.33,56.21,19.03,19.03,15.03,-2.97,-2.97,1.03,121,77,22,18,2.97,0,4,121,77,18,0,2.97,4,49,-4,-1.03,-4,80.116,11,8.03,0.73,69.116,11,7
5,1.93,0.07,4,3.72,3.46,0.0,35.34,3.86,1.86,20.86,-0.14,1.86,-17.14,0,38,2,21,0.14,2,-17,0,0,19,-2,-1.86,-19,361,17,17.14,19,5.066,2,1.86,0.93,5.066,0,19
6,1.37,0.63,121,44.77,16.56,12.21,16.28,15.07,7.07,8.07,-6.93,1.07,0.07,33,44,14,15,6.93,8,7,9,12,7,-8,-1.07,-1,16,-7,-0.07,1,55.106,11,4.07,0.37,52.106,3,4
7,1.16,0.84,4,0.64,0.1,3.52,1.28,2.32,11.32,4.32,-1.68,-10.68,-3.68,22,8,13,6,1.68,-9,-2,121,44,15,9,10.68,7,16,2,3.68,-7,18.14,2,0.32,0.16,7.140000000000001,11,4
8,1.8,0.2,256,204.8,163.84,204.8,38.4,28.8,28.8,15.8,-3.2,-3.2,9.8,256,48,32,19,3.2,0,13,256,48,19,0,3.2,13,9,-13,-9.8,-13,134.546,16,12.8,0.8,118.54599999999999,16,3
9,1.85,0.15,36,30.6,26.01,91.8,51.0,11.1,23.1,15.1,-0.9,-12.9,-4.9,108,60,24,16,0.9,-12,-4,324,180,28,12,12.9,8,100,4,4.9,-8,44.624,6,5.1,0.85,26.624000000000002,18,10
10,1.1,0.9,400,40.0,4.0,4.0,20.0,22.0,4.0,12.0,-18.0,0.0,-8.0,40,200,22,30,18.0,18,10,4,20,12,-18,0.0,-8,100,-10,8.0,8,203.65,20,2.0,0.1,201.65,2,10
11,1.21,0.79,9,1.89,0.4,1.26,6.93,3.63,2.63,11.63,-2.37,-1.37,-10.37,6,33,5,14,2.37,1,-8,4,22,13,-1,1.37,-9,121,8,10.37,9,29.666,3,0.63,0.21,27.666,2,11
12,1.42,0.58,400,168.0,70.56,126.0,100.8,28.4,23.4,20.4,-11.6,-6.6,-3.6,300,240,35,32,11.6,5,8,225,180,27,-5,6.6,3,144,-8,3.6,-3,241.49,20,8.4,0.42,226.49,15,12
13,1.55,0.45,121,66.55,36.6,96.8,96.8,17.05,22.05,22.05,-4.95,-9.95,-9.95,176,176,27,27,4.95,-5,-5,256,256,32,5,9.95,0,256,5,9.95,0,131.378,11,6.05,0.55,115.37799999999999,16,16
14,1.25,0.75,225,56.25,14.06,67.5,48.75,18.75,21.75,16.75,-11.25,-14.25,-9.25,270,195,33,28,11.25,-3,2,324,234,31,3,14.25,5,169,-2,9.25,-5,193.922,15,3.75,0.25,175.922,18,13
15,1.32,0.68,289,92.48,29.59,21.76,59.84,22.44,9.44,16.44,-11.56,1.44,-5.56,68,187,21,28,11.56,13,6,16,44,15,-13,-1.44,-7,121,-6,5.56,7,179.778,17,5.44,0.32,175.778,4,11
16,1.69,0.31,49,33.81,23.33,91.77,67.62,11.83,23.83,18.83,-2.17,-14.17,-9.17,133,98,26,21,2.17,-12,-7,361,266,33,12,14.17,5,196,7,9.17,-5,68.806,7,4.83,0.69,49.806,19,14
17,1.42,0.58,4,1.68,0.71,5.88,12.6,2.84,7.84,15.84,-1.16,-6.16,-14.16,14,30,9,17,1.16,-5,-13,49,105,22,5,6.16,-8,225,13,14.16,8,26.196,2,0.84,0.42,19.196,7,15
18,1.75,0.25,64,48.0,36.0,72.0,24.0,14.0,18.0,10.0,-2.0,-6.0,2.0,96,32,20,12,2.0,-4,4,144,48,16,4,6.0,8,16,-4,-2.0,-8,46.942,8,6.0,0.75,34.942,12,4
19,1.77,0.23,169,130.13,100.2,80.08,60.06,23.01,18.01,16.01,-2.99,2.01,4.01,104,78,21,19,2.99,5,7,64,48,14,-5,-2.01,2,36,-7,-4.01,-2,95.984,13,10.01,0.77,87.984,8,6
20,1.27,0.73,169,45.63,12.32,24.57,24.57,16.51,10.51,10.51,-9.49,-3.49,-3.49,91,91,20,20,9.49,6,6,49,49,14,-6,3.49,0,49,-6,3.49,0,98.072,13,3.51,0.27,91.072,7,7
21,1.41,0.59,9,3.69,1.51,11.07,18.45,4.23,10.23,16.23,-1.77,-7.77,-13.77,27,45,12,18,1.77,-6,-12,81,135,24,6,7.77,-6,225,12,13.77,6,38.564,3,1.23,0.41,29.564,9,15
22,1.87,0.13,121,105.27,91.58,66.99,181.83,20.57,16.57,28.57,-1.43,2.57,-9.43,77,209,18,30,1.43,4,-8,49,133,26,-4,-2.57,-12,361,8,9.43,12,92.386,11,9.57,0.87,85.386,7,19
23,1.52,0.48,324,168.48,87.61,9.36,159.12,27.36,10.36,26.36,-8.64,8.36,-7.64,18,306,19,35,8.64,17,1,1,17,18,-17,-8.36,-16,289,-1,7.64,16,237.006,18,9.36,0.52,236.006,1,17
24,1.78,0.22,225,175.5,136.89,152.1,105.3,26.7,24.7,20.7,-3.3,-1.3,2.7,195,135,28,24,3.3,2,6,169,117,22,-2,1.3,4,81,-6,-2.7,-4,136.34,15,11.7,0.78,123.34,13,9
25,1.91,0.09,400,364.0,331.24,345.8,145.6,38.2,37.2,26.2,-1.8,-0.8,10.2,380,160,39,28,1.8,1,12,361,152,27,-1,0.8,11,64,-12,-10.2,-11,224.076,20,18.2,0.91,205.076,19,8
26,1.94,0.06,196,184.24,173.19,144.76,39.48,27.16,24.16,16.16,-0.84,2.16,10.16,154,42,25,17,0.84,3,11,121,33,14,-3,-2.16,8,9,-11,-10.16,-8,111.652,14,13.16,0.94,100.652,11,3
27,1.53,0.47,4,2.12,1.12,3.18,21.2,3.06,4.06,21.06,-0.94,-1.94,-18.94,6,40,5,22,0.94,-1,-18,9,60,23,1,1.94,-17,400,18,18.94,17,22.996,2,1.06,0.53,19.996,3,20
28,1.17,0.83,400,68.0,11.56,44.2,27.2,23.4,16.4,11.4,-16.6,-9.6,-4.6,260,160,33,28,16.6,7,12,169,104,21,-7,9.6,5,64,-12,4.6,-5,181.054,20,3.4,0.17,168.054,13,8
29,1.8,0.2,121,96.8,77.44,158.4,8.8,19.8,26.8,9.8,-2.2,-9.2,7.8,198,11,29,12,2.2,-7,10,324,18,19,7,9.2,17,1,-10,-7.8,-17,72.892,11,8.8,0.8,54.891999999999996,18,1
30,1.42,0.58,100,42.0,17.64,21.0,84.0,14.2,9.2,24.2,-5.8,-0.8,-15.8,50,200,15,30,5.8,5,-10,25,100,25,-5,0.8,-15,400,10,15.8,15,143.128,10,4.2,0.42,138.128,5,20
31,1.31,0.69,324,100.44,31.14,50.22,33.48,23.58,14.58,11.58,-12.42,-3.42,-0.42,162,108,27,24,12.42,9,12,81,54,15,-9,3.42,3,36,-12,0.42,-3,136.236,18,5.58,0.31,127.23599999999999,9,6
32,1.93,0.07,144,133.92,124.55,55.8,55.8,23.16,16.16,16.16,-0.84,6.16,6.16,60,60,17,17,0.84,7,7,25,25,10,-7,-6.16,0,25,-7,-6.16,0,81.8,12,11.16,0.93,76.8,5,5
33,1.34,0.66,100,34.0,11.56,51.0,34.0,13.4,18.4,13.4,-6.6,-11.6,-6.6,150,100,25,20,6.6,-5,0,225,150,25,5,11.6,5,100,0,6.6,-5,99.71,10,3.4,0.34,84.71,15,10
34,1.39,0.61,4,1.56,0.61,4.68,7.02,2.78,6.78,9.78,-1.22,-5.22,-8.22,12,18,8,11,1.22,-4,-7,36,54,15,4,5.22,-3,81,7,8.22,3,18.15,2,0.78,0.39,12.149999999999999,6,9
35,1.8,0.2,64,51.2,40.96,25.6,51.2,14.4,10.4,14.4,-1.6,2.4,-1.6,32,64,12,16,1.6,4,0,16,32,12,-4,-2.4,-4,64,0,1.6,4,46.234,8,6.4,0.8,42.234,4,8
36,1.66,0.34,36,23.76,15.68,23.76,47.52,9.96,9.96,15.96,-2.04,-2.04,-8.04,36,72,12,18,2.04,0,-6,36,72,18,0,2.04,-6,144,6,8.04,6,43.966,6,3.96,0.66,37.966,6,12
37,1.64,0.36,121,77.44,49.56,91.52,56.32,18.04,20.04,15.04,-3.96,-5.96,-0.96,143,88,24,19,3.96,-2,3,169,104,21,2,5.96,5,64,-3,0.96,-5,87.234,11,7.04,0.64,74.234,13,8
38,1.07,0.93,225,15.75,1.1,4.2,9.45,16.05,5.05,10.05,-13.95,-2.95,-7.95,60,135,19,24,13.95,11,6,16,36,13,-11,2.95,-5,81,-6,7.95,5,138.27,15,1.05,0.07,134.27,4,9
39,1.68,0.32,36,24.48,16.65,20.4,48.96,10.08,9.08,16.08,-1.92,-0.92,-7.92,30,72,11,18,1.92,1,-6,25,60,17,-1,0.92,-7,144,6,7.92,7,42.526,6,4.08,0.68,37.526,5,12
40,1.68,0.32,1,0.68,0.46,8.84,3.4,1.68,13.68,5.68,-0.32,-12.32,-4.32,13,5,14,6,0.32,-12,-4,169,65,18,12,12.32,8,25,4,4.32,-8,15.304,1,0.68,0.68,2.3040000000000003,13,5
41,1.87,0.13,144,125.28,108.99,73.08,52.2,22.44,17.44,15.44,-1.56,3.44,5.44,84,60,19,17,1.56,5,7,49,35,12,-5,-3.44,2,25,-7,-5.44,-2,82.5,12,10.44,0.87,75.5,7,5
42,1.23,0.77,289,66.47,15.29,19.55,7.82,20.91,8.91,5.91,-13.09,-1.09,1.91,85,34,22,19,13.09,12,15,25,10,7,-12,1.09,3,4,-15,-1.91,-3,65.488,17,3.91,0.23,60.488,5,2
43,1.74,0.26,121,89.54,66.26,122.1,146.52,19.14,23.14,26.14,-2.86,-6.86,-9.86,165,198,26,29,2.86,-4,-7,225,270,33,4,6.86,-3,324,7,9.86,3,114.654,11,8.14,0.74,99.654,15,18
44,1.2,0.8,400,80.0,16.0,8.0,20.0,24.0,6.0,9.0,-16.0,2.0,-1.0,40,100,22,25,16.0,18,15,4,10,7,-18,-2.0,-3,25,-15,1.0,3,124.15,20,4.0,0.2,122.15,2,5
45,1.37,0.63,16,5.92,2.19,19.24,20.72,5.48,14.48,15.48,-2.52,-11.52,-12.52,52,56,17,18,2.52,-9,-10,169,182,27,9,11.52,-1,196,10,12.52,1,52.58,4,1.48,0.37,39.58,13,14
46,1.5,0.5,4,2.0,1.0,0.0,17.0,3.0,1.0,18.0,-1.0,1.0,-16.0,0,34,2,19,1.0,2,-15,0,0,17,-2,-1.0,-17,289,15,16.0,17,18.43,2,1.0,0.5,18.43,0,17
47,1.25,0.75,81,20.25,5.06,31.5,22.5,11.25,16.25,12.25,-6.75,-11.75,-7.75,126,90,23,19,6.75,-5,-1,196,140,24,5,11.75,4,100,1,7.75,-4,93.006,9,2.25,0.25,79.006,14,10
0,1.99,0.01,625,618.75,612.56,618.75,0.0,49.75,49.75,24.75,-0.25,-0.25,24.75,625,0,50,25,0.25,0,25,625,0,25,0,0.25,25,0,-25,-24.75,-25,346.45466666666664,25,24.75,0.99,321.45466666666664,25,0
1,1.99,0.01,625,618.75,612.56,0.0,0.0,49.75,24.75,24.75,-0.25,24.75,24.75,0,0,25,25,0.25,25,25,0,0,0,-25,-24.75,0,0,-25,-24.75,0,321.8093333333333,25,24.75,0.99,321.8093333333333,0,0
2,1.99,0.01,625,618.75,612.56,618.75,0.0,49.75,49.75,24.75,-0.25,-0.25,24.75,625,0,50,25,0.25,0,25,625,0,25,0,0.25,25,0,-25,-24.75,-25,346.53266666666667,25,24.75,0.99,321.53266666666667,25,0
3,1.99,0.01,1,0.99,0.98,0.0,19.8,1.99,0.99,20.99,-0.01,0.99,-19.01,0,20,1,21,0.01,1,-19,0,0,20,-1,-0.99,-20,400,19,19.01,20,1.152,1,0.99,0.99,1.152,0,20
4,1.99,0.01,625,618.75,612.56,0.0,495.0,49.75,24.75,44.75,-0.25,24.75,4.75,0,500,25,45,0.25,25,5,0,0,20,-25,-24.75,-20,400,-5,-4.75,20,326.48466666666667,25,24.75,0.99,326.48466666666667,0,20
5,1.99,0.01,625,618.75,612.56,0.0,0.0,49.75,24.75,24.75,-0.25,24.75,24.75,0,0,25,25,0.25,25,25,0,0,0,-25,-24.75,0,0,-25,-24.75,0,322.1,25,24.75,0.99,322.1,0,0
6,1.99,0.01,1,0.99,0.98,0.0,19.8,1.99,0.99,20.99,-0.01,0.99,-19.01,0,20,1,21,0.01,1,-19,0,0,20,-1,-0.99,-20,400,19,19.01,20,1.1266666666666667,1,0.99,0.99,1.1266666666666667,0,20
7,1.99,0.01,625,618.75,612.56,0.0,495.0,49.75,24.75,44.75,-0.25,24.75,4.75,0,500,25,45,0.25,25,5,0,0,20,-25,-24.75,-20,400,-5,-4.75,20,326.8546666666667,25,24.75,0.99,326.8546666666667,0,20
8,1.99,0.01,1,0.99,0.98,0.0,0.99,1.99,0.99,1.99,-0.01,0.99,-0.01,0,1,1,2,0.01,1,0,0,0,1,-1,-0.99,-1,1,0,0.01,1,1.0,1,0.99,0.99,1.0,0,1
9,1.99,0.01,1,0.99,0.98,0.0,0.0,1.99,0.99,0.99,-0.01,0.99,0.99,0,0,1,1,0.01,1,1,0,0,0,-1,-0.99,0,0,-1,-0.99,0,0.9893333333333333,1,0.99,0.99,0.9893333333333333,0,0
10,1.01,0.99,1,0.01,0.0,0.24,0.25,1.01,24.01,25.01,-0.99,-23.99,-24.99,24,25,25,26,0.99,-23,-24,576,600,49,23,23.99,-1,625,24,24.99,1,48.76,1,0.01,0.01,24.759999999999998,24,25
11,1.99,0.01,4,3.96,3.92,0.0,0.0,3.98,1.98,1.98,-0.02,1.98,1.98,0,0,2,2,0.02,2,2,0,0,0,-2,-1.98,0,0,-2,-1.98,0,2.966,2,1.98,0.99,2.966,0,0
12,1.99,0.01,1,0.99,0.98,0.0,0.0,1.99,0.99,0.99,-0.01,0.99,0.99,0,0,1,1,0.01,1,1,0,0,0,-1,-0.99,0,0,-1,-0.99,0,0.9833333333333333,1,0.99,0.99,0.9833333333333333,0,0
13,1.75,0.25,169,125.91,93.8,0.0,0.0,22.69,9.69,9.69,-3.31,9.69,9.69,0,0,13,13,3.31,13,13,0,0,0,-13,-9.69,0,0,-13,-9.69,0,68.02,13,9.69,0.7450002328308657,68.02,0,0
14,1.01,0.99,4,0.04,0.0,0.0,0.0,2.02,0.02,0.02,-1.98,0.02,0.02,0,0,2,2,1.98,2,2,0,0,0,-2,-0.02,0,0,-2,-0.02,0,0.029333333333333333,2,0.02,0.01,0.029333333333333333,0,0
15,1.99,0.01,1,0.99,0.98,0.0,0.0,1.99,0.99,0.99,-0.01,0.99,0.99,0,0,1,1,0.01,1,1,0,0,0,-1,-0.99,0,0,-1,-0.99,0,0.992,1,0.99,0.99,0.992,0,0
16,1.01,0.99,169,1.69,0.02,0.0,0.0,13.13,0.13,0.13,-12.87,0.13,0.13,0,0,13,13,12.87,13,13,0,0,0,-13,-0.13,0,0,-13,-0.13,0,0.9626666666666667,13,0.13,0.01,0.9626666666666667,0,0
17,1.99,0.01,4,3.96,3.92,49.5,39.6,3.98,26.98,21.98,-0.02,-23.02,-18.02,50,40,27,22,0.02,-23,-18,625,500,45,23,23.02,5,400,18,18.02,-5,28.334,2,1.98,0.99,3.3339999999999996,25,20
18,1.99,0.01,25,24.75,24.5,0.0,99.0,9.95,4.95,24.95,-0.05,4.95,-15.05,0,100,5,25,0.05,5,-15,0,0,20,-5,-4.95,-20,400,15,15.05,20,15.707333333333333,5,4.95,0.99,15.707333333333333,0,20
19,1.99,0.01,1,0.99,0.98,0.0,0.99,1.99,0.99,1.99,-0.01,0.99,-0.01,0,1,1,2,0.01,1,0,0,0,1,-1,-0.99,-1,1,0,0.01,1,1.0,1,0.99,0.99,1.0,0,1
20,1.01,0.99,1,0.01,0.0,0.0,0.2,1.01,0.01,20.01,-0.99,0.01,-19.99,0,20,1,21,0.99,1,-19,0,0,20,-1,-0.01,-20,400,19,19.99,20,19.835333333333335,1,0.01,0.01,19.835333333333335,0,20
21,1.99,0.01,625,618.75,612.56,618.75,495.0,49.75,49.75,44.75,-0.25,-0.25,4.75,625,500,50,45,0.25,0,5,625,500,45,0,0.25,5,400,-5,-4.75,-5,351.8113333333333,25,24.75,0.99,326.8113333333333,25,20
22,1.99,0.01,1,0.99,0.98,0.0,0.0,1.99,0.99,0.99,-0.01,0.99,0.99,0,0,1,1,0.01,1,1,0,0,0,-1,-0.99,0,0,-1,-0.99,0,0.9893333333333333,1,0.99,0.99,0.9893333333333333,0,0
23,1.99,0.01,1,0.99,0.98,0.0,19.8,1.99,0.99,20.99,-0.01,0.99,-19.01,0,20,1,21,0.01,1,-19,0,0,20,-1,-0.99,-20,400,19,19.01,20,1.2533333333333334,1,0.99,0.99,1.2533333333333334,0,20
24,1.99,0.01,625,618.75,612.56,0.0,495.0,49.75,24.75,44.75,-0.25,24.75,4.75,0,500,25,45,0.25,25,5,0,0,20,-25,-24.75,-20,400,-5,-4.75,20,326.886,25,24.75,0.99,326.886,0,20
25,1.99,0.01,625,618.75,612.56,618.75,0.0,49.75,49.75,24.75,-0.25,-0.25,24.75,625,0,50,25,0.25,0,25,625,0,25,0,0.25,25,0,-25,-24.75,-25,346.45466666666664,25,24.75,0.99,321.45466666666664,25,0
26,1.99,0.01,625,618.75,612.56,0.0,0.0,49.75,24.75,24.75,-0.25,24.75,24.75,0,0,25,25,0.25,25,25,0,0,0,-25,-24.75,0,0,-25,-24.75,0,321.8093333333333,25,24.75,0.99,321.8093333333333,0,0
27,1.99,0.01,625,618.75,612.56,618.75,0.0,49.75,49.75,24.75,-0.25,-0.25,24.75,625,0,50,25,0.25,0,25,625,0,25,0,0.25,25,0,-25,-24.75,-25,346.53266666666667,25,24.75,0.99,321.53266666666667,25,0
28,1.99,0.01,1,0.99,0.98,0.0,19.8,1.99,0.99,20.99,-0.01,0.99,-19.01,0,20,1,21,0.01,1,-19,0,0,20,-1,-0.99,-20,400,19,19.01,20,1.152,1,0.99,0.99,1.152,0,20
29,1.99,0.01,625,618.75,612.56,0.0,495.0,49.75,24.75,44.75,-0.25,24.75,4.75,0,500,25,45,0.25,25,5,0,0,20,-25,-24.75,-20,400,-5,-4.75,20,326.48466666666667,25,24.75,0.99,326.48466666666667,0,20
30,1.99,0.01,625,618.75,612.56,0.0,0.0,49.75,24.75,24.75,-0.25,24.75,24.75,0,0,25,25,0.25,25,25,0,0,0,-25,-24.75,0,0,-25,-24.75,0,322.1,25,24.75,0.99,322.1,0,0
31,1.99,0.01,1,0.99,0.98,0.0,19.8,1.99,0.99,20.99,-0.01,0.99,-19.01,0,20,1,21,0.01,1,-19,0,0,20,-1,-0.99,-20,400,19,19.01,20,1.1266666666666667,1,0.99,0.99,1.1266666666666667,0,20
32,1.99,0.01,625,618.75,612.56,0.0,495.0,49.75,24.75,44.75,-0.25,24.75,4.75,0,500,25,45,0.25,25,5,0,0,20,-25,-24.75,-20,400,-5,-4.75,20,326.8546666666667,25,24.75,0.99,326.8546666666667,0,20
33,1.99,0.01,1,0.99,0.98,0.0,0.99,1.99,0.99,1.99,-0.01,0.99,-0.01,0,1,1,2,0.01,1,0,0,0,1,-1,-0.99,-1,1,0,0.01,1,1.0,1,0.99,0.99,1.0,0,1
34,1.99,0.01,1,0.99,0.98,0.0,0.0,1.99,0.99,0.99,-0.01,0.99,0.99,0,0,1,1,0.01,1,1,0,0,0,-1,-0.99,0,0,-1,-0.99,0,0.9893333333333333,1,0.99,0.99,0.9893333333333333,0,0
35,1.01,0.99,1,0.01,0.0,0.24,0.25,1.01,24.01,25.01,-0.99,-23.99,-24.99,24,25,25,26,0.99,-23,-24,576,600,49,23,23.99,-1,625,24,24.99,1,48.76,1,0.01,0.01,24.759999999999998,24,25
36,1.99,0.01,4,3.96,3.92,0.0,0.0,3.98,1.98,1.98,-0.02,1.98,1.98,0,0,2,2,0.02,2,2,0,0,0,-2,-1.98,0,0,-2,-1.98,0,2.966,2,1.98,0.99,2.966,0,0
37,1.99,0.01,1,0.99,0.98,0.0,0.0,1.99,0.99,0.99,-0.01,0.99,0.99,0,0,1,1,0.01,1,1,0,0,0,-1,-0.99,0,0,-1,-0.99,0,0.9833333333333333,1,0.99,0.99,0.9833333333333333,0,0
38,1.75,0.25,169,125.91,93.8,0.0,0.0,22.69,9.69,9.69,-3.31,9.69,9.69,0,0,13,13,3.31,13,13,0,0,0,-13,-9.69,0,0,-13,-9.69,0,68.02,13,9.69,0.7450002328308657,68.02,0,0
39,1.01,0.99,4,0.04,0.0,0.0,0.0,2.02,0.02,0.02,-1.98,0.02,0.02,0,0,2,2,1.98,2,2,0,0,0,-2,-0.02,0,0,-2,-0.02,0,0.029333333333333333,2,0.02,0.01,0.029333333333333333,0,0
40,1.99,0.01,1,0.99,0.98,0.0,0.0,1.99,0.99,0.99,-0.01,0.99,0.99,0,0,1,1,0.01,1,1,0,0,0,-1,-0.99,0,0,-1,-0.99,0,0.992,1,0.99,0.99,0.992,0,0
41,1.01,0.99,169,1.69,0.02,0.0,0.0,13.13,0.13,0.13,-12.87,0.13,0.13,0,0,13,13,12.87,13,13,0,0,0,-13,-0.13,0,0,-13,-0.13,0,0.9626666666666667,13,0.13,0.01,0.9626666666666667,0,0
42,1.99,0.01,4,3.96,3.92,49.5,39.6,3.98,26.98,21.98,-0.02,-23.02,-18.02,50,40,27,22,0.02,-23,-18,625,500,45,23,23.02,5,400,18,18.02,-5,28.334,2,1.98,0.99,3.3339999999999996,25,20
43,1.99,0.01,25,24.75,24.5,0.0,99.0,9.95,4.95,24.95,-0.05,4.95,-15.05,0,100,5,25,0.05,5,-15,0,0,20,-5,-4.95,-20,400,15,15.05,20,15.707333333333333,5,4.95,0.99,15.707333333333333,0,20
44,1.99,0.01,1,0.99,0.98,0.0,0.99,1.99,0.99,1.99,-0.01,0.99,-0.01,0,1,1,2,0.01,1,0,0,0,1,-1,-0.99,-1,1,0,0.01,1,1.0,1,0.99,0.99,1.0,0,1
45,1.01,0.99,1,0.01,0.0,0.0,0.2,1.01,0.01,20.01,-0.99,0.01,-19.99,0,20,1,21,0.99,1,-19,0,0,20,-1,-0.01,-20,400,19,19.99,20,19.835333333333335,1,0.01,0.01,19.835333333333335,0,20
46,1.99,0.01,625,618.75,612.56,618.75,495.0,49.75,49.75,44.75,-0.25,-0.25,4.75,625,500,50,45,0.25,0,5,625,500,45,0,0.25,5,400,-5,-4.75,-5,351.8113333333333,25,24.75,0.99,326.8113333333333,25,20
47,1.99,0.01,1,0.99,0.98,0.0,0.0,1.99,0.99,0.99,-0.01,0.99,0.99,0,0,1,1,0.01,1,1,0,0,0,-1,-0.99,0,0,-1,-0.99,0,0.9893333333333333,1,0.99,0.99,0.9893333333333333,0,0
48,1.99,0.01,1,0.99,0.98,0.0,19.8,1.99,0.99,20.99,-0.01,0.99,-19.01,0,20,1,21,0.01,1,-19,0,0,20,-1,-0.99,-20,400,19,19.01,20,1.2533333333333334,1,0.99,0.99,1.2533333333333334,0,20
49,1.99,0.01,625,618.75,612.56,0.0,495.0,49.75,24.75,44.75,-0.25,24.75,4.75,0,500,25,45,0.25,25,5,0,0,20,-25,-24.75,-20,400,-5,-4.75,20,326.886,25,24.75,0.99,326.886,0,20
50,1.99,0.01,625,618.75,612.56,618.75,0.0,49.75,49.75,24.75,-0.25,-0.25,24.75,625,0,50,25,0.25,0,25,625,0,25,0,0.25,25,0,-25,-24.75,-25,346.45466666666664,25,24.75,0.99,321.45466666666664,25,0
51,1.99,0.01,625,618.75,612.56,0.0,0.0,49.75,24.75,24.75,-0.25,24.75,24.75,0,0,25,25,0.25,25,25,0,0,0,-25,-24.75,0,0,-25,-24.75,0,321.8093333333333,25,24.75,0.99,321.8093333333333,0,0
52,1.99,0.01,625,618.75,612.56,618.75,0.0,49.75,49.75,24.75,-0.25,-0.25,24.75,625,0,50,25,0.25,0,25,625,0,25,0,0.25,25,0,-25,-24.75,-25,346.53266666666667,25,24.75,0.99,321.53266666666667,25,0
53,1.99,0.01,1,0.99,0.98,0.0,19.8,1.99,0.99,20.99,-0.01,0.99,-19.01,0,20,1,21,0.01,1,-19,0,0,20,-1,-0.99,-20,400,19,19.01,20,1.152,1,0.99,0.99,1.152,0,20
54,1.99,0.01,625,618.75,612.56,0.0,495.0,49.75,24.75,44.75,-0.25,24.75,4.75,0,500,25,45,0.25,25,5,0,0,20,-25,-24.75,-20,400,-5,-4.75,20,326.48466666666667,25,24.75,0.99,326.48466666666667,0,20
55,1.99,0.01,625,618.75,612.56,0.0,0.0,49.75,24.75,24.75,-0.25,24.75,24.75,0,0,25,25,0.25,25,25,0,0,0,-25,-24.75,0,0,-25,-24.75,0,322.1,25,24.75,0.99,322.1,0,0
56,1.99,0.01,1,0.99,0.98,0.0,19.8,1.99,0.99,20.99,-0.01,0.99,-19.01,0,20,1,21,0.01,1,-19,0,0,20,-1,-0.99,-20,400,19,19.01,20,1.1266666666666667,1,0.99,0.99,1.1266666666666667,0,20
57,1.99,0.01,625,618.75,612.56,0.0,495.0,49.75,24.75,44.75,-0.25,24.75,4.75,0,500,25,45,0.25,25,5,0,0,20,-25,-24.75,-20,400,-5,-4.75,20,326.8546666666667,25,24.75,0.99,326.8546666666667,0,20
58,1.99,0.01,1,0.99,0.98,0.0,0.99,1.99,0.99,1.99,-0.01,0.99,-0.01,0,1,1,2,0.01,1,0,0,0,1,-1,-0.99,-1,1,0,0.01,1,1.0,1,0.99,0.99,1.0,0,1
59,1.99,0.01,1,0.99,0.98,0.0,0.0,1.99,0.99,0.99,-0.01,0.99,0.99,0,0,1,1,0.01,1,1,0,0,0,-1,-0.99,0,0,-1,-0.99,0,0.9893333333333333,1,0.99,0.99,0.9893333333333333,0,0
60,1.01,0.99,1,0.01,0.0,0.24,0.25,1.01,24.01,25.01,-0.99,-23.99,-24.99,24,25,25,26,0.99,-23,-24,576,600,49,23,23.99,-1,625,24,24.99,1,48.76,1,0.01,0.01,24.759999999999998,24,25
61,1.99,0.01,4,3.96,3.92,0.0,0.0,3.98,1.98,1.98,-0.02,1.98,1.98,0,0,2,2,0.02,2,2,0,0,0,-2,-1.98,0,0,-2,-1.98,0,2.966,2,1.98,0.99,2.966,0,0
62,1.99,0.01,1,0.99,0.98,0.0,0.0,1.99,0.99,0.99,-0.01,0.99,0.99,0,0,1,1,0.01,1,1,0,0,0,-1,-0.99,0,0,-1,-0.99,0,0.9833333333333333,1,0.99,0.99,0.9833333333333333,0,0
63,1.75,0.25,169,125.91,93.8,0.0,0.0,22.69,9.69,9.69,-3.31,9.69,9.69,0,0,13,13,3.31,13,13,0,0,0,-13,-9.69,0,0,-13,-9.69,0,68.02,13,9.69,0.7450002328308657,68.02,0,0
64,1.01,0.99,4,0.04,0.0,0.0,0.0,2.02,0.02,0.02,-1.98,0.02,0.02,0,0,2,2,1.98,2,2,0,0,0,-2,-0.02,0,0,-2,-0.02,0,0.029333333333333333,2,0.02,0.01,0.029333333333333333,0,0
65,1.99,0.01,1,0.99,0.98,0.0,0.0,1.99,0.99,0.99,-0.01,0.99,0.99,0,0,1,1,0.01,1,1,0,0,0,-1,-0.99,0,0,-1,-0.99,0,0.992,1,0.99,0.99,0.992,0,0
66,1.01,0.99,169,1.69,0.02,0.0,0.0,13.13,0.13,0.13,-12.87,0.13,0.13,0,0,13,13,12.87,13,13,0,0,0,-13,-0.13,0,0,-13,-0.13,0,0.9626666666666667,13,0.13,0.01,0.9626666666666667,0,0
67,1.99,0.01,4,3.96,3.92,49.5,39.6,3.98,26.98,21.98,-0.02,-23.02,-18.02,50,40,27,22,0.02,-23,-18,625,500,45,23,23.02,5,400,18,18.02,-5,28.334,2,1.98,0.99,3.3339999999999996,25,20
68,1.99,0.01,25,24.75,24.5,0.0,99.0,9.95,4.95,24.95,-0.05,4.95,-15.05,0,100,5,25,0.05,5,-15,0,0,20,-5,-4.95,-20,400,15,15.05,20,15.707333333333333,5,4.95,0.99,15.707333333333333,0,20
69,1.99,0.01,1,0.99,0.98,0.0,0.99,1.99,0.99,1.99,-0.01,0.99,-0.01,0,1,1,2,0.01,1,0,0,0,1,-1,-0.99,-1,1,0,0.01,1,1.0,1,0.99,0.99,1.0,0,1
70,1.01,0.99,1,0.01,0.0,0.0,0.2,1.01,0.01,20.01,-0.99,0.01,-19.99,0,20,1,21,0.99,1,-19,0,0,20,-1,-0.01,-20,400,19,19.99,20,19.835333333333335,1,0.01,0.01,19.835333333333335,0,20
71,1.99,0.01,625,618.75,612.56,618.75,495.0,49.75,49.75,44.75,-0.25,-0.25,4.75,625,500,50,45,0.25,0,5,625,500,45,0,0.25,5,400,-5,-4.75,-5,351.8113333333333,25,24.75,0.99,326.8113333333333,25,20
72,1.99,0.01,1,0.99,0.98,0.0,0.0,1.99,0.99,0.99,-0.01,0.99,0.99,0,0,1,1,0.01,1,1,0,0,0,-1,-0.99,0,0,-1,-0.99,0,0.9893333333333333,1,0.99,0.99,0.9893333333333333,0,0
73,1.99,0.01,1,0.99,0.98,0.0,19.8,1.99,0.99,20.99,-0.01,0.99,-19.01,0,20,1,21,0.01,1,-19,0,0,20,-1,-0.99,-20,400,19,19.01,20,1.2533333333333334,1,0.99,0.99,1.2533333333333334,0,20
74,1.99,0.01,625,618.75,612.56,0.0,495.0,49.75,24.75,44.75,-0.25,24.75,4.75,0,500,25,45,0.25,25,5,0,0,20,-25,-24.75,-20,400,-5,-4.75,20,326.886,25,24.75,0.99,326.886,0,20
75,1.99,0.01,625,618.75,612.56,618.75,0.0,49.75,49.75,24.75,-0.25,-0.25,24.75,625,0,50,25,0.25,0,25,625,0,25,0,0.25,25,0,-25,-24.75,-25,346.45466666666664,25,24.75,0.99,321.45466666666664,25,0
76,1.99,0.01,625,618.75,612.56,0.0,0.0,49.75,24.75,24.75,-0.25,24.75,24.75,0,0,25,25,0.25,25,25,0,0,0,-25,-24.75,0,0,-25,-24.75,0,321.8093333333333,25,24.75,0.99,321.8093333333333,0,0
77,1.99,0.01,625,618.75,612.56,618.75,0.0,49.75,49.75,24.75,-0.25,-0.25,24.75,625,0,50,25,0.25,0,25,625,0,25,0,0.25,25,0,-25,-24.75,-25,346.53266666666667,25,24.75,0.99,321.53266666666667,25,0
78,1.99,0.01,1,0.99,0.98,0.0,19.8,1.99,0.99,20.99,-0.01,0.99,-19.01,0,20,1,21,0.01,1,-19,0,0,20,-1,-0.99,-20,400,19,19.01,20,1.152,1,0.99,0.99,1.152,0,20
79,1.99,0.01,625,618.75,612.56,0.0,495.0,49.75,24.75,44.75,-0.25,24.75,4.75,0,500,25,45,0.25,25,5,0,0,20,-25,-24.75,-20,400,-5,-4.75,20,326.48466666666667,25,24.75,0.99,326.48466666666667,0,20
80,1.99,0.01,625,618.75,612.56,0.0,0.0,49.75,24.75,24.75,-0.25,24.75,24.75,0,0,25,25,0.25,25,25,0,0,0,-25,-24.75,0,0,-25,-24.75,0,322.1,25,24.75,0.99,322.1,0,0
81,1.99,0.01,1,0.99,0.98,0.0,19.8,1.99,0.99,20.99,-0.01,0.99,-19.01,0,20,1,21,0.01,1,-19,0,0,20,-1,-0.99,-20,400,19,19.01,20,1.1266666666666667,1,0.99,0.99,1.1266666666666667,0,20
82,1.99,0.01,625,618.75,612.56,0.0,495.0,49.75,24.75,44.75,-0.25,24.75,4.75,0,500,25,45,0.25,25,5,0,0,20,-25,-24.75,-20,400,-5,-4.75,20,326.8546666666667,25,24.75,0.99,326.8546666666667,0,20
83,1.99,0.01,1,0.99,0.98,0.0,0.99,1.99,0.99,1.99,-0.01,0.99,-0.01,0,1,1,2,0.01,1,0,0,0,1,-1,-0.99,-1,1,0,0.01,1,1.0,1,0.99,0.99,1.0,0,1
84,1.99,0.01,1,0.99,0.98,0.0,0.0,1.99,0.99,0.99,-0.01,0.99,0.99,0,0,1,1,0.01,1,1,0,0,0,-1,-0.99,0,0,-1,-0.99,0,0.9893333333333333,1,0.99,0.99,0.9893333333333333,0,0
85,1.01,0.99,1,0.01,0.0,0.24,0.25,1.01,24.01,25.01,-0.99,-23.99,-24.99,24,25,25,26,0.99,-23,-24,576,600,49,23,23.99,-1,625,24,24.99,1,48.76,1,0.01,0.01,24.759999999999998,24,25
86,1.99,0.01,4,3.96,3.92,0.0,0.0,3.98,1.98,1.98,-0.02,1.98,1.98,0,0,2,2,0.02,2,2,0,0,0,-2,-1.98,0,0,-2,-1.98,0,2.966,2,1.98,0.99,2.966,0,0
87,1.99,0.01,1,0.99,0.98,0.0,0.0,1.99,0.99,0.99,-0.01,0.99,0.99,0,0,1,1,0.01,1,1,0,0,0,-1,-0.99,0,0,-1,-0.99,0,0.9833333333333333,1,0.99,0.99,0.9833333333333333,0,0
88,1.75,0.25,169,125.91,93.8,0.0,0.0,22.69,9.69,9.69,-3.31,9.69,9.69,0,0,13,13,3.31,13,13,0,0,0,-13,-9.69,0,0,-13,-9.69,0,68.02,13,9.69,0.7450002328308657,68.02,0,0
89,1.01,0.99,4,0.04,0.0,0.0,0.0,2.02,0.02,0.02,-1.98,0.02,0.02,0,0,2,2,1.98,2,2,0,0,0,-2,-0.02,0,0,-2,-0.02,0,0.029333333333333333,2,0.02,0.01,0.029333333333333333,0,0
90,1.99,0.01,1,0.99,0.98,0.0,0.0,1.99,0.99,0.99,-0.01,0.99,0.99,0,0,1,1,0.01,1,1,0,0,0,-1,-0.99,0,0,-1,-0.99,0,0.992,1,0.99,0.99,0.992,0,0
91,1.01,0.99,169,1.69,0.02,0.0,0.0,13.13,0.13,0.13,-12.87,0.13,0.13,0,0,13,13,12.87,13,13,0,0,0,-13,-0.13,0,0,-13,-0.13,0,0.9626666666666667,13,0.13,0.01,0.9626666666666667,0,0
92,1.99,0.01,4,3.96,3.92,49.5,39.6,3.98,26.98,21.98,-0.02,-23.02,-18.02,50,40,27,22,0.02,-23,-18,625,500,45,23,23.02,5,400,18,18.02,-5,28.334,2,1.98,0.99,3.3339999999999996,25,20
93,1.99,0.01,25,24.75,24.5,0.0,99.0,9.95,4.95,24.95,-0.05,4.95,-15.05,0,100,5,25,0.05,5,-15,0,0,20,-5,-4.95,-20,400,15,15.05,20,15.707333333333333,5,4.95,0.99,15.707333333333333,0,20
94,1.99,0.01,1,0.99,0.98,0.0,0.99,1.99,0.99,1.99,-0.01,0.99,-0.01,0,1,1,2,0.01,1,0,0,0,1,-1,-0.99,-1,1,0,0.01,1,1.0,1,0.99,0.99,1.0,0,1
95,1.01,0.99,1,0.01,0.0,0.0,0.2,1.01,0.01,20.01,-0.99,0.01,-19.99,0,20,1,21,0.99,1,-19,0,0,20,-1,-0.01,-20,400,19,19.99,20,19.835333333333335,1,0.01,0.01,19.835333333333335,0,20
96,1.99,0.01,625,618.75,612.56,618.75,495.0,49.75,49.75,44.75,-0.25,-0.25,4.75,625,500,50,45,0.25,0,5,625,500,45,0,0.25,5,400,-5,-4.75,-5,351.8113333333333,25,24.75,0.99,326.8113333333333,25,20
97,1.99,0.01,1,0.99,0.98,0.0,0.0,1.99,0.99,0.99,-0.01,0.99,0.99,0,0,1,1,0.01,1,1,0,0,0,-1,-0.99,0,0,-1,-0.99,0,0.9893333333333333,1,0.99,0.99,0.9893333333333333,0,0
98,1.99,0.01,1,0.99,0.98,0.0,19.8,1.99,0.99,20.99,-0.01,0.99,-19.01,0,20,1,21,0.01,1,-19,0,0,20,-1,-0.99,-20,400,19,19.01,20,1.2533333333333334,1,0.99,0.99,1.2533333333333334,0,20
99,1.99,0.01,625,618.75,612.56,0.0,495.0,49.75,24.75,44.75,-0.25,24.75,4.75,0,500,25,45,0.25,25,5,0,0,20,-25,-24.75,-20,400,-5,-4.75,20,326.886,25,24.75,0.99,326.886,0,20
100,1.99,0.01,625,618.75,612.56,618.75,0.0,49.75,49.75,24.75,-0.25,-0.25,24.75,625,0,50,25,0.25,0,25,625,0,25,0,0.25,25,0,-25,-24.75,-25,346.45466666666664,25,24.75,0.99,321.45466666666664,25,0
101,1.99,0.01,625,618.75,612.56,0.0,0.0,49.75,24.75,24.75,-0.25,24.75,24.75,0,0,25,25,0.25,25,25,0,0,0,-25,-24.75,0,0,-25,-24.75,0,321.8093333333333,25,24.75,0.99,321.8093333333333,0,0
102,1.99,0.01,625,618.75,612.56,618.75,0.0,49.75,49.75,24.75,-0.25,-0.25,24.75,625,0,50,25,0.25,0,25,625,0,25,0,0.25,25,0,-25,-24.75,-25,346.53266666666667,25,24.75,0.99,321.53266666666667,25,0
103,1.99,0.01,1,0.99,0.98,0.0,19.8,1.99,0.99,20.99,-0.01,0.99,-19.01,0,20,1,21,0.01,1,-19,0,0,20,-1,-0.99,-20,400,19,19.01,20,1.152,1,0.99,0.99,1.152,0,20
104,1.99,0.01,625,618.75,612.56,0.0,495.0,49.75,24.75,44.75,-0.25,24.75,4.75,0,500,25,45,0.25,25,5,0,0,20,-25,-24.75,-20,400,-5,-4.75,20,326.48466666666667,25,24.75,0.99,326.48466666666667,0,20
105,1.99,0.01,625,618.75,612.56,0.0,0.0,49.75,24.75,24.75,-0.25,24.75,24.75,0,0,25,25,0.25,25,25,0,0,0,-25,-24.75,0,0,-25,-24.75,0,322.1,25,24.75,0.99,322.1,0,0
106,1.99,0.01,1,0.99,0.98,0.0,19.8,1.99,0.99,20.99,-0.01,0.99,-19.01,0,20,1,21,0.01,1,-19,0,0,20,-1,-0.99,-20,400,19,19.01,20,1.1266666666666667,1,0.99,0.99,1.1266666666666667,0,20
107,1.99,0.01,625,618.75,612.56,0.0,495.0,49.75,24.75,44.75,-0.25,24.75,4.75,0,500,25,45,0.25,25,5,0,0,20,-25,-24.75,-20,400,-5,-4.75,20,326.8546666666667,25,24.75,0.99,326.8546666666667,0,20
108,1.99,0.01,1,0.99,0.98,0.0,0.99,1.99,0.99,1.99,-0.01,0.99,-0.01,0,1,1,2,0.01,1,0,0,0,1,-1,-0.99,-1,1,0,0.01,1,1.0,1,0.99,0.99,1.0,0,1
109,1.99,0.01,1,0.99,0.98,0.0,0.0,1.99,0.99,0.99,-0.01,0.99,0.99,0,0,1,1,0.01,1,1,0,0,0,-1,-0.99,0,0,-1,-0.99,0,0.9893333333333333,1,0.99,0.99,0.9893333333333333,0,0
110,1.01,0.99,1,0.01,0.0,0.24,0.25,1.01,24.01,25.01,-0.99,-23.99,-24.99,24,25,25,26,0.99,-23,-24,576,600,49,23,23.99,-1,625,24,24.99,1,48.76,1,0.01,0.01,24.759999999999998,24,25
111,1.99,0.01,4,3.96,3.92,0.0,0.0,3.98,1.98,1.98,-0.02,1.98,1.98,0,0,2,2,0.02,2,2,0,0,0,-2,-1.98,0,0,-2,-1.98,0,2.966,2,1.98,0.99,2.966,0,0
112,1.99,0.01,1,0.99,0.98,0.0,0.0,1.99,0.99,0.99,-0.01,0.99,0.99,0,0,1,1,0.01,1,1,0,0,0,-1,-0.99,0,0,-1,-0.99,0,0.9833333333333333,1,0.99,0.99,0.9833333333333333,0,0
113,1.75,0.25,169,125.91,93.8,0.0,0.0,22.69,9.69,9.69,-3.31,9.69,9.69,0,0,13,13,3.31,13,13,0,0,0,-13,-9.69,0,0,-13,-9.69,0,68.02,13,9.69,0.7450002328308657,68.02,0,0
114,1.01,0.99,4,0.04,0.0,0.0,0.0,2.02,0.02,0.02,-1.98,0.02,0.02,0,0,2,2,1.98,2,2,0,0,0,-2,-0.02,0,0,-2,-0.02,0,0.029333333333333333,2,0.02,0.01,0.029333333333333333,0,0
115,1.99,0.01,1,0.99,0.98,0.0,0.0,1.99,0.99,0.99,-0.01,0.99,0.99,0,0,1,1,0.01,1,1,0,0,0,-1,-0.99,0,0,-1,-0.99,0,0.992,1,0.99,0.99,0.992,0,0
116,1.01,0.99,169,1.69,0.02,0.0,0.0,13.13,0.13,0.13,-12.87,0.13,0.13,0,0,13,13,12.87,13,13,0,0,0,-13,-0.13,0,0,-13,-0.13,0,0.9626666666666667,13,0.13,0.01,0.9626666666666667,0,0
117,1.99,0.01,4,3.96,3.92,49.5,39.6,3.98,26.98,21.98,-0.02,-23.02,-18.02,50,40,27,22,0.02,-23,-18,625,500,45,23,23.02,5,400,18,18.02,-5,28.334,2,1.98,0.99,3.3339999999999996,25,20
118,1.99,0.01,25,24.75,24.5,0.0,99.0,9.95,4.95,24.95,-0.05,4.95,-15.05,0,100,5,25,0.05,5,-15,0,0,20,-5,-4.95,-20,400,15,15.05,20,15.707333333333333,5,4.95,0.99,15.707333333333333,0,20
119,1.99,0.01,1,0.99,0.98,0.0,0.99,1.99,0.99,1.99,-0.01,0.99,-0.01,0,1,1,2,0.01,1,0,0,0,1,-1,-0.99,-1,1,0,0.01,1,1.0,1,0.99,0.99,1.0,0,1
120,1.01,0.99,1,0.01,0.0,0.0,0.2,1.01,0.01,20.01,-0.99,0.01,-19.99,0,20,1,21,0.99,1,-19,0,0,20,-1,-0.01,-20,400,19,19.99,20,19.835333333333335,1,0.01,0.01,19.835333333333335,0,20
121,1.99,0.01,625,618.75,612.56,618.75,495.0,49.75,49.75,44.75,-0.25,-0.25,4.75,625,500,50,45,0.25,0,5,625,500,45,0,0.25,5,400,-5,-4.75,-5,351.8113333333333,25,24.75,0.99,326.8113333333333,25,20
122,1.99,0.01,1,0.99,0.98,0.0,0.0,1.99,0.99,0.99,-0.01,0.99,0.99,0,0,1,1,0.01,1,1,0,0,0,-1,-0.99,0,0,-1,-0.99,0,0.9893333333333333,1,0.99,0.99,0.9893333333333333,0,0
123,1.99,0.01,1,0.99,0.98,0.0,19.8,1.99,0.99,20.99,-0.01,0.99,-19.01,0,20,1,21,0.01,1,-19,0,0,20,-1,-0.99,-20,400,19,19.01,20,1.2533333333333334,1,0.99,0.99,1.2533333333333334,0,20
124,1.99,0.01,625,618.75,612.56,0.0,495.0,49.75,24.75,44.75,-0.25,24.75,4.75,0,500,25,45,0.25,25,5,0,0,20,-25,-24.75,-20,400,-5,-4.75,20,326.886,25,24.75,0.99,326.886,0,20
125,1.99,0.01,625,618.75,612.56,618.75,0.0,49.75,49.75,24.75,-0.25,-0.25,24.75,625,0,50,25,0.25,0,25,625,0,25,0,0.25,25,0,-25,-24.75,-25,346.45466666666664,25,24.75,0.99,321.45466666666664,25,0
126,1.99,0.01,625,618.75,612.56,0.0,0.0,49.75,24.75,24.75,-0.25,24.75,24.75,0,0,25,25,0.25,25,25,0,0,0,-25,-24.75,0,0,-25,-24.75,0,321.8093333333333,25,24.75,0.99,321.8093333333333,0,0
127,1.99,0.01,625,618.75,612.56,618.75,0.0,49.75,49.75,24.75,-0.25,-0.25,24.75,625,0,50,25,0.25,0,25,625,0,25,0,0.25,25,0,-25,-24.75,-25,346.53266666666667,25,24.75,0.99,321.53266666666667,25,0
128,1.99,0.01,1,0.99,0.98,0.0,19.8,1.99,0.99,20.99,-0.01,0.99,-19.01,0,20,1,21,0.01,1,-19,0,0,20,-1,-0.99,-20,400,19,19.01,20,1.152,1,0.99,0.99,1.152,0,20
129,1.99,0.01,625,618.75,612.56,0.0,495.0,49.75,24.75,44.75,-0.25,24.75,4.75,0,500,25,45,0.25,25,5,0,0,20,-25,-24.75,-20,400,-5,-4.75,20,326.48466666666667,25,24.75,0.99,326.48466666666667,0,20
130,1.99,0.01,625,618.75,612.56,0.0,0.0,49.75,24.75,24.75,-0.25,24.75,24.75,0,0,25,25,0.25,25,25,0,0,0,-25,-24.75,0,0,-25,-24.75,0,322.1,25,24.75,0.99,322.1,0,0
131,1.99,0.01,1,0.99,0.98,0.0,19.8,1.99,0.99,20.99,-0.01,0.99,-19.01,0,20,1,21,0.01,1,-19,0,0,20,-1,-0.99,-20,400,19,19.01,20,1.1266666666666667,1,0.99,0.99,1.1266666666666667,0,20
132,1.99,0.01,625,618.75,612.56,0.0,495.0,49.75,24.75,44.75,-0.25,24.75,4.75,0,500,25,45,0.25,25,5,0,0,20,-25,-24.75,-20,400,-5,-4.75,20,326.8546666666667,25,24.75,0.99,326.8546666666667,0,20
133,1.99,0.01,1,0.99,0.98,0.0,0.99,1.99,0.99,1.99,-0.01,0.99,-0.01,0,1,1,2,0.01,1,0,0,0,1,-1,-0.99,-1,1,0,0.01,1,1.0,1,0.99,0.99,1.0,0,1
134,1.99,0.01,1,0.99,0.98,0.0,0.0,1.99,0.99,0.99,-0.01,0.99,0.99,0,0,1,1,0.01,1,1,0,0,0,-1,-0.99,0,0,-1,-0.99,0,0.9893333333333333,1,0.99,0.99,0.9893333333333333,0,0
135,1.01,0.99,1,0.01,0.0,0.24,0.25,1.01,24.01,25.01,-0.99,-23.99,-24.99,24,25,25,26,0.99,-23,-24,576,600,49,23,23.99,-1,625,24,24.99,1,48.76,1,0.01,0.01,24.759999999999998,24,25
136,1.99,0.01,4,3.96,3.92,0.0,0.0,3.98,1.98,1.98,-0.02,1.98,1.98,0,0,2,2,0.02,2,2,0,0,0,-2,-1.98,0,0,-2,-1.98,0,2.966,2,1.98,0.99,2.966,0,0
137,1.99,0.01,1,0.99,0.98,0.0,0.0,1.99,0.99,0.99,-0.01,0.99,0.99,0,0,1,1,0.01,1,1,0,0,0,-1,-0.99,0,0,-1,-0.99,0,0.9833333333333333,1,0.99,0.99,0.9833333333333333,0,0
138,1.75,0.25,169,125.91,93.8,0.0,0.0,22.69,9.69,9.69,-3.31,9.69,9.69,0,0,13,13,3.31,13,13,0,0,0,-13,-9.69,0,0,-13,-9.69,0,68.02,13,9.69,0.7450002328308657,68.02,0,0
139,1.01,0.99,4,0.04,0.0,0.0,0.0,2.02,0.02,0.02,-1.98,0.02,0.02,0,0,2,2,1.98,2,2,0,0,0,-2,-0.02,0,0,-2,-0.02,0,0.029333333333333333,2,0.02,0.01,0.029333333333333333,0,0
140,1.99,0.01,1,0.99,0.98,0.0,0.0,1.99,0.99,0.99,-0.01,0.99,0.99,0,0,1,1,0.01,1,1,0,0,0,-1,-0.99,0,0,-1,-0.99,0,0.992,1,0.99,0.99,0.992,0,0
141,1.01,0.99,169,1.69,0.02,0.0,0.0,13.13,0.13,0.13,-12.87,0.13,0.13,0,0,13,13,12.87,13,13,0,0,0,-13,-0.13,0,0,-13,-0.13,0,0.9626666666666667,13,0.13,0.01,0.9626666666666667,0,0
142,1.99,0.01,4,3.96,3.92,49.5,39.6,3.98,26.98,21.98,-0.02,-23.02,-18.02,50,40,27,22,0.02,-23,-18,625,500,45,23,23.02,5,400,18,18.02,-5,28.334,2,1.98,0.99,3.3339999999999996,25,20
143,1.99,0.01,25,24.75,24.5,0.0,99.0,9.95,4.95,24.95,-0.05,4.95,-15.05,0,100,5,25,0.05,5,-15,0,0,20,-5,-4.95,-20,400,15,15.05,20,15.707333333333333,5,4.95,0.99,15.707333333333333,0,20
144,1.99,0.01,1,0.99,0.98,0.0,0.99,1.99,0.99,1.99,-0.01,0.99,-0.01,0,1,1,2,0.01,1,0,0,0,1,-1,-0.99,-1,1,0,0.01,1,1.0,1,0.99,0.99,1.0,0,1
145,1.01,0.99,1,0.01,0.0,0.0,0.2,1.01,0.01,20.01,-0.99,0.01,-19.99,0,20,1,21,0.99,1,-19,0,0,20,-1,-0.01,-20,400,19,19.99,20,19.835333333333335,1,0.01,0.01,19.835333333333335,0,20
146,1.99,0.01,625,618.75,612.56,618.75,495.0,49.75,49.75,44.75,-0.25,-0.25,4.75,625,500,50,45,0.25,0,5,625,500,45,0,0.25,5,400,-5,-4.75,-5,351.8113333333333,25,24.75,0.99,326.8113333333333,25,20
147,1.99,0.01,1,0.99,0.98,0.0,0.0,1.99,0.99,0.99,-0.01,0.99,0.99,0,0,1,1,0.01,1,1,0,0,0,-1,-0.99,0,0,-1,-0.99,0,0.9893333333333333,1,0.99,0.99,0.9893333333333333,0,0
148,1.99,0.01,1,0.99,0.98,0.0,19.8,1.99,0.99,20.99,-0.01,0.99,-19.01,0,20,1,21,0.01,1,-19,0,0,20,-1,-0.99,-20,400,19,19.01,20,1.2533333333333334,1,0.99,0.99,1.2533333333333334,0,20
149,1.99,0.01,625,618.75,612.56,0.0,495.0,49.75,24.75,44.75,-0.25,24.75,4.75,0,500,25,45,0.25,25,5,0,0,20,-25,-24.75,-20,400,-5,-4.75,20,326.886,25,24.75,0.99,326.886,0,20
150,1.99,0.01,625,618.75,612.56,618.75,0.0,49.75,49.75,24.75,-0.25,-0.25,24.75,625,0,50,25,0.25,0,25,625,0,25,0,0.25,25,0,-25,-24.75,-25,346.45466666666664,25,24.75,0.99,321.45466666666664,25,0
151,1.99,0.01,625,618.75,612.56,0.0,0.0,49.75,24.75,24.75,-0.25,24.75,24.75,0,0,25,25,0.25,25,25,0,0,0,-25,-24.75,0,0,-25,-24.75,0,321.8093333333333,25,24.75,0.99,321.8093333333333,0,0
152,1.99,0.01,625,618.75,612.56,618.75,0.0,49.75,49.75,24.75,-0.25,-0.25,24.75,625,0,50,25,0.25,0,25,625,0,25,0,0.25,25,0,-25,-24.75,-25,346.53266666666667,25,24.75,0.99,321.53266666666667,25,0
153,1.99,0.01,1,0.99,0.98,0.0,19.8,1.99,0.99,20.99,-0.01,0.99,-19.01,0,20,1,21,0.01,1,-19,0,0,20,-1,-0.99,-20,400,19,19.01,20,1.152,1,0.99,0.99,1.152,0,20
154,1.99,0.01,625,618.75,612.56,0.0,495.0,49.75,24.75,44.75,-0.25,24.75,4.75,0,500,25,45,0.25,25,5,0,0,20,-25,-24.75,-20,400,-5,-4.75,20,326.48466666666667,25,24.75,0.99,326.48466666666667,0,20
155,1.99,0.01,625,618.75,612.56,0.0,0.0,49.75,24.75,24.75,-0.25,24.75,24.75,0,0,25,25,0.25,25,25,0,0,0,-25,-24.75,0,0,-25,-24.75,0,322.1,25,24.75,0.99,322.1,0,0
156,1.99,0.01,1,0.99,0.98,0.0,19.8,1.99,0.99,20.99,-0.01,0.99,-19.01,0,20,1,21,0.01,1,-19,0,0,20,-1,-0.99,-20,400,19,19.01,20,1.1266666666666667,1,0.99,0.99,1.1266666666666667,0,20
157,1.99,0.01,625,618.75,612.56,0.0,495.0,49.75,24.75,44.75,-0.25,24.75,4.75,0,500,25,45,0.25,25,5,0,0,20,-25,-24.75,-20,400,-5,-4.75,20,326.8546666666667,25,24.75,0.99,326.8546666666667,0,20
158,1.99,0.01,1,0.99,0.98,0.0,0.99,1.99,0.99,1.99,-0.01,0.99,-0.01,0,1,1,2,0.01,1,0,0,0,1,-1,-0.99,-1,1,0,0.01,1,1.0,1,0.99,0.99,1.0,0,1
159,1.99,0.01,1,0.99,0.98,0.0,0.0,1.99,0.99,0.99,-0.01,0.99,0.99,0,0,1,1,0.01,1,1,0,0,0,-1,-0.99,0,0,-1,-0.99,0,0.9893333333333333,1,0.99,0.99,0.9893333333333333,0,0
160,1.01,0.99,1,0.01,0.0,0.24,0.25,1.01,24.01,25.01,-0.99,-23.99,-24.99,24,25,25,26,0.99,-23,-24,576,600,49,23,23.99,-1,625,24,24.99,1,48.76,1,0.01,0.01,24.759999999999998,24,25
161,1.99,0.01,4,3.96,3.92,0.0,0.0,3.98,1.98,1.98,-0.02,1.98,1.98,0,0,2,2,0.02,2,2,0,0,0,-2,-1.98,0,0,-2,-1.98,0,2.966,2,1.98,0.99,2.966,0,0
162,1.99,0.01,1,0.99,0.98,0.0,0.0,1.99,0.99,0.99,-0.01,0.99,0.99,0,0,1,1,0.01,1,1,0,0,0,-1,-0.99,0,0,-1,-0.99,0,0.9833333333333333,1,0.99,0.99,0.9833333333333333,0,0
163,1.75,0.25,169,125.91,93.8,0.0,0.0,22.69,9.69,9.69,-3.31,9.69,9.69,0,0,13,13,3.31,13,13,0,0,0,-13,-9.69,0,0,-13,-9.69,0,68.02,13,9.69,0.7450002328308657,68.02,0,0
164,1.01,0.99,4,0.04,0.0,0.0,0.0,2.02,0.02,0.02,-1.98,0.02,0.02,0,0,2,2,1.98,2,2,0,0,0,-2,-0.02,0,0,-2,-0.02,0,0.029333333333333333,2,0.02,0.01,0.029333333333333333,0,0
165,1.99,0.01,1,0.99,0.98,0.0,0.0,1.99,0.99,0.99,-0.01,0.99,0.99,0,0,1,1,0.01,1,1,0,0,0,-1,-0.99,0,0,-1,-0.99,0,0.992,1,0.99,0.99,0.992,0,0
166,1.01,0.99,169,1.69,0.02,0.0,0.0,13.13,0.13,0.13,-12.87,0.13,0.13,0,0,13,13,12.87,13,13,0,0,0,-13,-0.13,0,0,-13,-0.13,0,0.9626666666666667,13,0.13,0.01,0.9626666666666667,0,0
167,1.99,0.01,4,3.96,3.92,49.5,39.6,3.98,26.98,21.98,-0.02,-23.02,-18.02,50,40,27,22,0.02,-23,-18,625,500,45,23,23.02,5,400,18,18.02,-5,28.334,2,1.98,0.99,3.3339999999999996,25,20
168,1.99,0.01,25,24.75,24.5,0.0,99.0,9.95,4.95,24.95,-0.05,4.95,-15.05,0,100,5,25,0.05,5,-15,0,0,20,-5,-4.95,-20,400,15,15.05,20,15.707333333333333,5,4.95,0.99,15.707333333333333,0,20
169,1.99,0.01,1,0.99,0.98,0.0,0.99,1.99,0.99,1.99,-0.01,0.99,-0.01,0,1,1,2,0.01,1,0,0,0,1,-1,-0.99,-1,1,0,0.01,1,1.0,1,0.99,0.99,1.0,0,1
170,1.01,0.99,1,0.01,0.0,0.0,0.2,1.01,0.01,20.01,-0.99,0.01,-19.99,0,20,1,21,0.99,1,-19,0,0,20,-1,-0.01,-20,400,19,19.99,20,19.835333333333335,1,0.01,0.01,19.835333333333335,0,20
171,1.99,0.01,625,618.75,612.56,618.75,495.0,49.75,49.75,44.75,-0.25,-0.25,4.75,625,500,50,45,0.25,0,5,625,500,45,0,0.25,5,400,-5,-4.75,-5,351.8113333333333,25,24.75,0.99,326.8113333333333,25,20
172,1.99,0.01,1,0.99,0.98,0.0,0.0,1.99,0.99,0.99,-0.01,0.99,0.99,0,0,1,1,0.01,1,1,0,0,0,-1,-0.99,0,0,-1,-0.99,0,0.9893333333333333,1,0.99,0.99,0.9893333333333333,0,0
173,1.99,0.01,1,0.99,0.98,0.0,19.8,1.99,0.99,20.99,-0.01,0.99,-19.01,0,20,1,21,0.01,1,-19,0,0,20,-1,-0.99,-20,400,19,19.01,20,1.2533333333333334,1,0.99,0.99,1.2533333333333334,0,20
174,1.99,0.01,625,618.75,612.56,0.0,495.0,49.75,24.75,44.75,-0.25,24.75,4.75,0,500,25,45,0.25,25,5,0,0,20,-25,-24.75,-20,400,-5,-4.75,20,326.886,25,24.75,0.99,326.886,0,20
175,1.99,0.01,625,618.75,612.56,618.75,0.0,49.75,49.75,24.75,-0.25,-0.25,24.75,625,0,50,25,0.25,0,25,625,0,25,0,0.25,25,0,-25,-24.75,-25,346.45466666666664,25,24.75,0.99,321.45466666666664,25,0
176,1.99,0.01,625,618.75,612.56,0.0,0.0,49.75,24.75,24.75,-0.25,24.75,24.75,0,0,25,25,0.25,25,25,0,0,0,-25,-24.75,0,0,-25,-24.75,0,321.8093333333333,25,24.75,0.99,321.8093333333333,0,0
177,1.99,0.01,625,618.75,612.56,618.75,0.0,49.75,49.75,24.75,-0.25,-0.25,24.75,625,0,50,25,0.25,0,25,625,0,25,0,0.25,25,0,-25,-24.75,-25,346.53266666666667,25,24.75,0.99,321.53266666666667,25,0
178,1.99,0.01,1,0.99,0.98,0.0,19.8,1.99,0.99,20.99,-0.01,0.99,-19.01,0,20,1,21,0.01,1,-19,0,0,20,-1,-0.99,-20,400,19,19.01,20,1.152,1,0.99,0.99,1.152,0,20
179,1.99,0.01,625,618.75,612.56,0.0,495.0,49.75,24.75,44.75,-0.25,24.75,4.75,0,500,25,45,0.25,25,5,0,0,20,-25,-24.75,-20,400,-5,-4.75,20,326.48466666666667,25,24.75,0.99,326.48466666666667,0,20
180,1.99,0.01,625,618.75,612.56,0.0,0.0,49.75,24.75,24.75,-0.25,24.75,24.75,0,0,25,25,0.25,25,25,0,0,0,-25,-24.75,0,0,-25,-24.75,0,322.1,25,24.75,0.99,322.1,0,0
181,1.99,0.01,1,0.99,0.98,0.0,19.8,1.99,0.99,20.99,-0.01,0.99,-19.01,0,20,1,21,0.01,1,-19,0,0,20,-1,-0.99,-20,400,19,19.01,20,1.1266666666666667,1,0.99,0.99,1.1266666666666667,0,20
182,1.99,0.01,625,618.75,612.56,0.0,495.0,49.75,24.75,44.75,-0.25,24.75,4.75,0,500,25,45,0.25,25,5,0,0,20,-25,-24.75,-20,400,-5,-4.75,20,326.8546666666667,25,24.75,0.99,326.8546666666667,0,20
183,1.99,0.01,1,0.99,0.98,0.0,0.99,1.99,0.99,1.99,-0.01,0.99,-0.01,0,1,1,2,0.01,1,0,0,0,1,-1,-0.99,-1,1,0,0.01,1,1.0,1,0.99,0.99,1.0,0,1
184,1.99,0.01,1,0.99,0.98,0.0,0.0,1.99,0.99,0.99,-0.01,0.99,0.99,0,0,1,1,0.01,1,1,0,0,0,-1,-0.99,0,0,-1,-0.99,0,0.9893333333333333,1,0.99,0.99,0.9893333333333333,0,0
185,1.01,0.99,1,0.01,0.0,0.24,0.25,1.01,24.01,25.01,-0.99,-23.99,-24.99,24,25,25,26,0.99,-23,-24,576,600,49,23,23.99,-1,625,24,24.99,1,48.76,1,0.01,0.01,24.759999999999998,24,25
186,1.99,0.01,4,3.96,3.92,0.0,0.0,3.98,1.98,1.98,-0.02,1.98,1.98,0,0,2,2,0.02,2,2,0,0,0,-2,-1.98,0,0,-2,-1.98,0,2.966,2,1.98,0.99,2.966,0,0
187,1.99,0.01,1,0.99,0.98,0.0,0.0,1.99,0.99,0.99,-0.01,0.99,0.99,0,0,1,1,0.01,1,1,0,0,0,-1,-0.99,0,0,-1,-0.99,0,0.9833333333333333,1,0.99,0.99,0.9833333333333333,0,0
188,1.75,0.25,169,125.91,93.8,0.0,0.0,22.69,9.69,9.69,-3.31,9.69,9.69,0,0,13,13,3.31,13,13,0,0,0,-13,-9.69,0,0,-13,-9.69,0,68.02,13,9.69,0.7450002328308657,68.02,0,0
189,1.01,0.99,4,0.04,0.0,0.0,0.0,2.02,0.02,0.02,-1.98,0.02,0.02,0,0,2,2,1.98,2,2,0,0,0,-2,-0.02,0,0,-2,-0.02,0,0.029333333333333333,2,0.02,0.01,0.029333333333333333,0,0
190,1.99,0.01,1,0.99,0.98,0.0,0.0,1.99,0.99,0.99,-0.01,0.99,0.99,0,0,1,1,0.01,1,1,0,0,0,-1,-0.99,0,0,-1,-0.99,0,0.992,1,0.99,0.99,0.992,0,0
191,1.01,0.99,169,1.69,0.02,0.0,0.0,13.13,0.13,0.13,-12.87,0.13,0.13,0,0,13,13,12.87,13,13,0,0,0,-13,-0.13,0,0,-13,-0.13,0,0.9626666666666667,13,0.13,0.01,0.9626666666666667,0,0
192,1.99,0.01,4,3.96,3.92,49.5,39.6,3.98,26.98,21.98,-0.02,-23.02,-18.02,50,40,27,22,0.02,-23,-18,625,500,45,23,23.02,5,400,18,18.02,-5,28.334,2,1.98,0.99,3.3339999999999996,25,20
193,1.99,0.01,25,24.75,24.5,0.0,99.0,9.95,4.95,24.95,-0.05,4.95,-15.05,0,100,5,25,0.05,5,-15,0,0,20,-5,-4.95,-20,400,15,15.05,20,15.707333333333333,5,4.95,0.99,15.707333333333333,0,20
194,1.99,0.01,1,0.99,0.98,0.0,0.99,1.99,0.99,1.99,-0.01,0.99,-0.01,0,1,1,2,0.01,1,0,0,0,1,-1,-0.99,-1,1,0,0.01,1,1.0,1,0.99,0.99,1.0,0,1
195,1.01,0.99,1,0.01,0.0,0.0,0.2,1.01,0.01,20.01,-0.99,0.01,-19.99,0,20,1,21,0.99,1,-19,0,0,20,-1,-0.01,-20,400,19,19.99,20,19.835333333333335,1,0.01,0.01,19.835333333333335,0,20
196,1.99,0.01,625,618.75,612.56,618.75,495.0,49.75,49.75,44.75,-0.25,-0.25,4.75,625,500,50,45,0.25,0,5,625,500,45,0,0.25,5,400,-5,-4.75,-5,351.8113333333333,25,24.75,0.99,326.8113333333333,25,20
197,1.99,0.01,1,0.99,0.98,0.0,0.0,1.99,0.99,0.99,-0.01,0.99,0.99,0,0,1,1,0.01,1,1,0,0,0,-1,-0.99,0,0,-1,-0.99,0,0.9893333333333333,1,0.99,0.99,0.9893333333333333,0,0
198,1.99,0.01,1,0.99,0.98,0.0,19.8,1.99,0.99,20.99,-0.01,0.99,-19.01,0,20,1,21,0.01,1,-19,0,0,20,-1,-0.99,-20,400,19,19.01,20,1.2533333333333334,1,0.99,0.99,1.2533333333333334,0,20
199,1.99,0.01,625,618.75,612.56,0.0,495.0,49.75,24.75,44.75,-0.25,24.75,4.75,0,500,25,45,0.25,25,5,0,0,20,-25,-24.75,-20,400,-5,-4.75,20,326.886,25,24.75,0.99,326.886,0,20
200,1.99,0.01,625,618.75,612.56,618.75,0.0,49.75,49.75,24.75,-0.25,-0.25,24.75,625,0,50,25,0.25,0,25,625,0,25,0,0.25,25,0,-25,-24.75,-25,346.45466666666664,25,24.75,0.99,321.45466666666664,25,0
201,1.99,0.01,625,618.75,612.56,0.0,0.0,49.75,24.75,24.75,-0.25,24.75,24.75,0,0,25,25,0.25,25,25,0,0,0,-25,-24.75,0,0,-25,-24.75,0,321.8093333333333,25,24.75,0.99,321.8093333333333,0,0
202,1.99,0.01,625,618.75,612.56,618.75,0.0,49.75,49.75,24.75,-0.25,-0.25,24.75,625,0,50,25,0.25,0,25,625,0,25,0,0.25,25,0,-25,-24.75,-25,346.53266666666667,25,24.75,0.99,321.53266666666667,25,0
203,1.99,0.01,1,0.99,0.98,0.0,19.8,1.99,0.99,20.99,-0.01,0.99,-19.01,0,20,1,21,0.01,1,-19,0,0,20,-1,-0.99,-20,400,19,19.01,20,1.152,1,0.99,0.99,1.152,0,20
204,1.99,0.01,625,618.75,612.56,0.0,495.0,49.75,24.75,44.75,-0.25,24.75,4.75,0,500,25,45,0.25,25,5,0,0,20,-25,-24.75,-20,400,-5,-4.75,20,326.48466666666667,25,24.75,0.99,326.48466666666667,0,20
205,1.99,0.01,625,618.75,612.56,0.0,0.0,49.75,24.75,24.75,-0.25,24.75,24.75,0,0,25,25,0.25,25,25,0,0,0,-25,-24.75,0,0,-25,-24.75,0,322.1,25,24.75,0.99,322.1,0,0
206,1.99,0.01,1,0.99,0.98,0.0,19.8,1.99,0.99,20.99,-0.01,0.99,-19.01,0,20,1,21,0.01,1,-19,0,0,20,-1,-0.99,-20,400,19,19.01,20,1.1266666666666667,1,0.99,0.99,1.1266666666666667,0,20
207,1.99,0.01,625,618.75,612.56,0.0,495.0,49.75,24.75,44.75,-0.25,24.75,4.75,0,500,25,45,0.25,25,5,0,0,20,-25,-24.75,-20,400,-5,-4.75,20,326.8546666666667,25,24.75,0.99,326.8546666666667,0,20
208,1.99,0.01,1,0.99,0.98,0.0,0.99,1.99,0.99,1.99,-0.01,0.99,-0.01,0,1,1,2,0.01,1,0,0,0,1,-1,-0.99,-1,1,0,0.01,1,1.0,1,0.99,0.99,1.0,0,1
209,1.99,0.01,1,0.99,0.98,0.0,0.0,1.99,0.99,0.99,-0.01,0.99,0.99,0,0,1,1,0.01,1,1,0,0,0,-1,-0.99,0,0,-1,-0.99,0,0.9893333333333333,1,0.99,0.99,0.9893333333333333,0,0
210,1.01,0.99,1,0.01,0.0,0.24,0.25,1.01,24.01,25.01,-0.99,-23.99,-24.99,24,25,25,26,0.99,-23,-24,576,600,49,23,23.99,-1,625,24,24.99,1,48.76,1,0.01,0.01,24.759999999999998,24,25
211,1.99,0.01,4,3.96,3.92,0.0,0.0,3.98,1.98,1.98,-0.02,1.98,1.98,0,0,2,2,0.02,2,2,0,0,0,-2,-1.98,0,0,-2,-1.98,0,2.966,2,1.98,0.99,2.966,0,0
212,1.99,0.01,1,0.99,0.98,0.0,0.0,1.99,0.99,0.99,-0.01,0.99,0.99,0,0,1,1,0.01,1,1,0,0,0,-1,-0.99,0,0,-1,-0.99,0,0.9833333333333333,1,0.99,0.99,0.9833333333333333,0,0
213,1.75,0.25,169,125.91,93.8,0.0,0.0,22.69,9.69,9.69,-3.31,9.69,9.69,0,0,13,13,3.31,13,13,0,0,0,-13,-9.69,0,0,-13,-9.69,0,68.02,13,9.69,0.7450002328308657,68.02,0,0
214,1.01,0.99,4,0.04,0.0,0.0,0.0,2.02,0.02,0.02,-1.98,0.02,0.02,0,0,2,2,1.98,2,2,0,0,0,-2,-0.02,0,0,-2,-0.02,0,0.029333333333333333,2,0.02,0.01,0.029333333333333333,0,0
215,1.99,0.01,1,0.99,0.98,0.0,0.0,1.99,0.99,0.99,-0.01,0.99,0.99,0,0,1,1,0.01,1,1,0,0,0,-1,-0.99,0,0,-1,-0.99,0,0.992,1,0.99,0.99,0.992,0,0
216,1.01,0.99,169,1.69,0.02,0.0,0.0,13.13,0.13,0.13,-12.87,0.13,0.13,0,0,13,13,12.87,13,13,0,0,0,-13,-0.13,0,0,-13,-0.13,0,0.9626666666666667,13,0.13,0.01,0.9626666666666667,0,0
217,1.99,0.01,4,3.96,3.92,49.5,39.6,3.98,26.98,21.98,-0.02,-23.02,-18.02,50,40,27,22,0.02,-23,-18,625,500,45,23,23.02,5,400,18,18.02,-5,28.334,2,1.98,0.99,3.3339999999999996,25,20
218,1.99,0.01,25,24.75,24.5,0.0,99.0,9.95,4.95,24.95,-0.05,4.95,-15.05,0,100,5,25,0.05,5,-15,0,0,20,-5,-4.95,-20,400,15,15.05,20,15.707333333333333,5,4.95,0.99,15.707333333333333,0,20
219,1.99,0.01,1,0.99,0.98,0.0,0.99,1.99,0.99,1.99,-0.01,0.99,-0.01,0,1,1,2,0.01,1,0,0,0,1,-1,-0.99,-1,1,0,0.01,1,1.0,1,0.99,0.99,1.0,0,1
220,1.01,0.99,1,0.01,0.0,0.0,0.2,1.01,0.01,20.01,-0.99,0.01,-19.99,0,20,1,21,0.99,1,-19,0,0,20,-1,-0.01,-20,400,19,19.99,20,19.835333333333335,1,0.01,0.01,19.835333333333335,0,20
221,1.99,0.01,625,618.75,612.56,618.75,495.0,49.75,49.75,44.75,-0.25,-0.25,4.75,625,500,50,45,0.25,0,5,625,500,45,0,0.25,5,400,-5,-4.75,-5,351.8113333333333,25,24.75,0.99,326.8113333333333,25,20
222,1.99,0.01,1,0.99,0.98,0.0,0.0,1.99,0.99,0.99,-0.01,0.99,0.99,0,0,1,1,0.01,1,1,0,0,0,-1,-0.99,0,0,-1,-0.99,0,0.9893333333333333,1,0.99,0.99,0.9893333333333333,0,0
223,1.99,0.01,1,0.99,0.98,0.0,19.8,1.99,0.99,20.99,-0.01,0.99,-19.01,0,20,1,21,0.01,1,-19,0,0,20,-1,-0.99,-20,400,19,19.01,20,1.2533333333333334,1,0.99,0.99,1.2533333333333334,0,20
224,1.99,0.01,625,618.75,612.56,0.0,495.0,49.75,24.75,44.75,-0.25,24.75,4.75,0,500,25,45,0.25,25,5,0,0,20,-25,-24.75,-20,400,-5,-4.75,20,326.886,25,24.75,0.99,326.886,0,20
225,1.99,0.01,625,618.75,612.56,618.75,0.0,49.75,49.75,24.75,-0.25,-0.25,24.75,625,0,50,25,0.25,0,25,625,0,25,0,0.25,25,0,-25,-24.75,-25,346.45466666666664,25,24.75,0.99,321.45466666666664,25,0
226,1.99,0.01,625,618.75,612.56,0.0,0.0,49.75,24.75,24.75,-0.25,24.75,24.75,0,0,25,25,0.25,25,25,0,0,0,-25,-24.75,0,0,-25,-24.75,0,321.8093333333333,25,24.75,0.99,321.8093333333333,0,0
227,1.99,0.01,625,618.75,612.56,618.75,0.0,49.75,49.75,24.75,-0.25,-0.25,24.75,625,0,50,25,0.25,0,25,625,0,25,0,0.25,25,0,-25,-24.75,-25,346.53266666666667,25,24.75,0.99,321.53266666666667,25,0
228,1.99,0.01,1,0.99,0.98,0.0,19.8,1.99,0.99,20.99,-0.01,0.99,-19.01,0,20,1,21,0.01,1,-19,0,0,20,-1,-0.99,-20,400,19,19.01,20,1.152,1,0.99,0.99,1.152,0,20
229,1.99,0.01,625,618.75,612.56,0.0,495.0,49.75,24.75,44.75,-0.25,24.75,4.75,0,500,25,45,0.25,25,5,0,0,20,-25,-24.75,-20,400,-5,-4.75,20,326.48466666666667,25,24.75,0.99,326.48466666666667,0,20
230,1.99,0.01,625,618.75,612.56,0.0,0.0,49.75,24.75,24.75,-0.25,24.75,24.75,0,0,25,25,0.25,25,25,0,0,0,-25,-24.75,0,0,-25,-24.75,0,322.1,25,24.75,0.99,322.1,0,0
231,1.99,0.01,1,0.99,0.98,0.0,19.8,1.99,0.99,20.99,-0.01,0.99,-19.01,0,20,1,21,0.01,1,-19,0,0,20,-1,-0.99,-20,400,19,19.01,20,1.1266666666666667,1,0.99,0.99,1.1266666666666667,0,20
232,1.99,0.01,625,618.75,612.56,0.0,495.0,49.75,24.75,44.75,-0.25,24.75,4.75,0,500,25,45,0.25,25,5,0,0,20,-25,-24.75,-20,400,-5,-4.75,20,326.8546666666667,25,24.75,0.99,326.8546666666667,0,20
233,1.99,0.01,1,0.99,0.98,0.0,0.99,1.99,0.99,1.99,-0.01,0.99,-0.01,0,1,1,2,0.01,1,0,0,0,1,-1,-0.99,-1,1,0,0.01,1,1.0,1,0.99,0.99,1.0,0,1
234,1.99,0.01,1,0.99,0.98,0.0,0.0,1.99,0.99,0.99,-0.01,0.99,0.99,0,0,1,1,0.01,1,1,0,0,0,-1,-0.99,0,0,-1,-0.99,0,0.9893333333333333,1,0.99,0.99,0.9893333333333333,0,0
235,1.01,0.99,1,0.01,0.0,0.24,0.25,1.01,24.01,25.01,-0.99,-23.99,-24.99,24,25,25,26,0.99,-23,-24,576,600,49,23,23.99,-1,625,24,24.99,1,48.76,1,0.01,0.01,24.759999999999998,24,25
236,1.99,0.01,4,3.96,3.92,0.0,0.0,3.98,1.98,1.98,-0.02,1.98,1.98,0,0,2,2,0.02,2,2,0,0,0,-2,-1.98,0,0,-2,-1.98,0,2.966,2,1.98,0.99,2.966,0,0
237,1.99,0.01,1,0.99,0.98,0.0,0.0,1.99,0.99,0.99,-0.01,0.99,0.99,0,0,1,1,0.01,1,1,0,0,0,-1,-0.99,0,0,-1,-0.99,0,0.9833333333333333,1,0.99,0.99,0.9833333333333333,0,0
238,1.75,0.25,169,125.91,93.8,0.0,0.0,22.69,9.69,9.69,-3.31,9.69,9.69,0,0,13,13,3.31,13,13,0,0,0,-13,-9.69,0,0,-13,-9.69,0,68.02,13,9.69,0.7450002328308657,68.02,0,0
239,1.01,0.99,4,0.04,0.0,0.0,0.0,2.02,0.02,0.02,-1.98,0.02,0.02,0,0,2,2,1.98,2,2,0,0,0,-2,-0.02,0,0,-2,-0.02,0,0.029333333333333333,2,0.02,0.01,0.029333333333333333,0,0
240,1.99,0.01,1,0.99,0.98,0.0,0.0,1.99,0.99,0.99,-0.01,0.99,0.99,0,0,1,1,0.01,1,1,0,0,0,-1,-0.99,0,0,-1,-0.99,0,0.992,1,0.99,0.99,0.992,0,0
241,1.01,0.99,169,1.69,0.02,0.0,0.0,13.13,0.13,0.13,-12.87,0.13,0.13,0,0,13,13,12.87,13,13,0,0,0,-13,-0.13,0,0,-13,-0.13,0,0.9626666666666667,13,0.13,0.01,0.9626666666666667,0,0
242,1.99,0.01,4,3.96,3.92,49.5,39.6,3.98,26.98,21.98,-0.02,-23.02,-18.02,50,40,27,22,0.02,-23,-18,625,500,45,23,23.02,5,400,18,18.02,-5,28.334,2,1.98,0.99,3.3339999999999996,25,20
243,1.99,0.01,25,24.75,24.5,0.0,99.0,9.95,4.95,24.95,-0.05,4.95,-15.05,0,100,5,25,0.05,5,-15,0,0,20,-5,-4.95,-20,400,15,15.05,20,15.707333333333333,5,4.95,0.99,15.707333333333333,0,20
244,1.99,0.01,1,0.99,0.98,0.0,0.99,1.99,0.99,1.99,-0.01,0.99,-0.01,0,1,1,2,0.01,1,0,0,0,1,-1,-0.99,-1,1,0,0.01,1,1.0,1,0.99,0.99,1.0,0,1
245,1.01,0.99,1,0.01,0.0,0.0,0.2,1.01,0.01,20.01,-0.99,0.01,-19.99,0,20,1,21,0.99,1,-19,0,0,20,-1,-0.01,-20,400,19,19.99,20,19.835333333333335,1,0.01,0.01,19.835333333333335,0,20
246,1.99,0.01,625,618.75,612.56,618.75,495.0,49.75,49.75,44.75,-0.25,-0.25,4.75,625,500,50,45,0.25,0,5,625,500,45,0,0.25,5,400,-5,-4.75,-5,351.8113333333333,25,24.75,0.99,326.8113333333333,25,20
247,1.99,0.01,1,0.99,0.98,0.0,0.0,1.99,0.99,0.99,-0.01,0.99,0.99,0,0,1,1,0.01,1,1,0,0,0,-1,-0.99,0,0,-1,-0.99,0,0.9893333333333333,1,0.99,0.99,0.9893333333333333,0,0
248,1.99,0.01,1,0.99,0.98,0.0,19.8,1.99,0.99,20.99,-0.01,0.99,-19.01,0,20,1,21,0.01,1,-19,0,0,20,-1,-0.99,-20,400,19,19.01,20,1.2533333333333334,1,0.99,0.99,1.2533333333333334,0,20
249,1.99,0.01,625,618.75,612.56,0.0,495.0,49.75,24.75,44.75,-0.25,24.75,4.75,0,500,25,45,0.25,25,5,0,0,20,-25,-24.75,-20,400,-5,-4.75,20,326.886,25,24.75,0.99,326.886,0,20
250,1.99,0.01,625,618.75,612.56,618.75,0.0,49.75,49.75,24.75,-0.25,-0.25,24.75,625,0,50,25,0.25,0,25,625,0,25,0,0.25,25,0,-25,-24.75,-25,346.45466666666664,25,24.75,0.99,321.45466666666664,25,0
251,1.99,0.01,625,618.75,612.56,0.0,0.0,49.75,24.75,24.75,-0.25,24.75,24.75,0,0,25,25,0.25,25,25,0,0,0,-25,-24.75,0,0,-25,-24.75,0,321.8093333333333,25,24.75,0.99,321.8093333333333,0,0
252,1.99,0.01,625,618.75,612.56,618.75,0.0,49.75,49.75,24.75,-0.25,-0.25,24.75,625,0,50,25,0.25,0,25,625,0,25,0,0.25,25,0,-25,-24.75,-25,346.53266666666667,25,24.75,0.99,321.53266666666667,25,0
253,1.99,0.01,1,0.99,0.98,0.0,19.8,1.99,0.99,20.99,-0.01,0.99,-19.01,0,20,1,21,0.01,1,-19,0,0,20,-1,-0.99,-20,400,19,19.01,20,1.152,1,0.99,0.99,1.152,0,20
254,1.99,0.01,625,618.75,612.56,0.0,495.0,49.75,24.75,44.75,-0.25,24.75,4.75,0,500,25,45,0.25,25,5,0,0,20,-25,-24.75,-20,400,-5,-4.75,20,326.48466666666667,25,24.75,0.99,326.48466666666667,0,20
255,1.99,0.01,625,618.75,612.56,0.0,0.0,49.75,24.75,24.75,-0.25,24.75,24.75,0,0,25,25,0.25,25,25,0,0,0,-25,-24.75,0,0,-25,-24.75,0,322.1,25,24.75,0.99,322.1,0,0
256,1.99,0.01,1,0.99,0.98,0.0,19.8,1.99,0.99,20.99,-0.01,0.99,-19.01,0,20,1,21,0.01,1,-19,0,0,20,-1,-0.99,-20,400,19,19.01,20,1.1266666666666667,1,0.99,0.99,1.1266666666666667,0,20
257,1.99,0.01,625,618.75,612.56,0.0,495.0,49.75,24.75,44.75,-0.25,24.75,4.75,0,500,25,45,0.25,25,5,0,0,20,-25,-24.75,-20,400,-5,-4.75,20,326.8546666666667,25,24.75,0.99,326.8546666666667,0,20
258,1.99,0.01,1,0.99,0.98,0.0,0.99,1.99,0.99,1.99,-0.01,0.99,-0.01,0,1,1,2,0.01,1,0,0,0,1,-1,-0.99,-1,1,0,0.01,1,1.0,1,0.99,0.99,1.0,0,1
259,1.99,0.01,1,0.99,0.98,0.0,0.0,1.99,0.99,0.99,-0.01,0.99,0.99,0,0,1,1,0.01,1,1,0,0,0,-1,-0.99,0,0,-1,-0.99,0,0.9893333333333333,1,0.99,0.99,0.9893333333333333,0,0
260,1.01,0.99,1,0.01,0.0,0.24,0.25,1.01,24.01,25.01,-0.99,-23.99,-24.99,24,25,25,26,0.99,-23,-24,576,600,49,23,23.99,-1,625,24,24.99,1,48.76,1,0.01,0.01,24.759999999999998,24,25
261,1.99,0.01,4,3.96,3.92,0.0,0.0,3.98,1.98,1.98,-0.02,1.98,1.98,0,0,2,2,0.02,2,2,0,0,0,-2,-1.98,0,0,-2,-1.98,0,2.966,2,1.98,0.99,2.966,0,0
262,1.99,0.01,1,0.99,0.98,0.0,0.0,1.99,0.99,0.99,-0.01,0.99,0.99,0,0,1,1,0.01,1,1,0,0,0,-1,-0.99,0,0,-1,-0.99,0,0.9833333333333333,1,0.99,0.99,0.9833333333333333,0,0
263,1.75,0.25,169,125.91,93.8,0.0,0.0,22.69,9.69,9.69,-3.31,9.69,9.69,0,0,13,13,3.31,13,13,0,0,0,-13,-9.69,0,0,-13,-9.69,0,68.02,13,9.69,0.7450002328308657,68.02,0,0
264,1.01,0.99,4,0.04,0.0,0.0,0.0,2.02,0.02,0.02,-1.98,0.02,0.02,0,0,2,2,1.98,2,2,0,0,0,-2,-0.02,0,0,-2,-0.02,0,0.029333333333333333,2,0.02,0.01,0.029333333333333333,0,0
265,1.99,0.01,1,0.99,0.98,0.0,0.0,1.99,0.99,0.99,-0.01,0.99,0.99,0,0,1,1,0.01,1,1,0,0,0,-1,-0.99,0,0,-1,-0.99,0,0.992,1,0.99,0.99,0.992,0,0
266,1.01,0.99,169,1.69,0.02,0.0,0.0,13.13,0.13,0.13,-12.87,0.13,0.13,0,0,13,13,12.87,13,13,0,0,0,-13,-0.13,0,0,-13,-0.13,0,0.9626666666666667,13,0.13,0.01,0.9626666666666667,0,0
267,1.99,0.01,4,3.96,3.92,49.5,39.6,3.98,26.98,21.98,-0.02,-23.02,-18.02,50,40,27,22,0.02,-23,-18,625,500,45,23,23.02,5,400,18,18.02,-5,28.334,2,1.98,0.99,3.3339999999999996,25,20
268,1.99,0.01,25,24.75,24.5,0.0,99.0,9.95,4.95,24.95,-0.05,4.95,-15.05,0,100,5,25,0.05,5,-15,0,0,20,-5,-4.95,-20,400,15,15.05,20,15.707333333333333,5,4.95,0.99,15.707333333333333,0,20
269,1.99,0.01,1,0.99,0.98,0.0,0.99,1.99,0.99,1.99,-0.01,0.99,-0.01,0,1,1,2,0.01,1,0,0,0,1,-1,-0.99,-1,1,0,0.01,1,1.0,1,0.99,0.99,1.0,0,1
270,1.01,0.99,1,0.01,0.0,0.0,0.2,1.01,0.01,20.01,-0.99,0.01,-19.99,0,20,1,21,0.99,1,-19,0,0,20,-1,-0.01,-20,400,19,19.99,20,19.835333333333335,1,0.01,0.01,19.835333333333335,0,20
271,1.99,0.01,625,618.75,612.56,618.75,495.0,49.75,49.75,44.75,-0.25,-0.25,4.75,625,500,50,45,0.25,0,5,625,500,45,0,0.25,5,400,-5,-4.75,-5,351.8113333333333,25,24.75,0.99,326.8113333333333,25,20
272,1.99,0.01,1,0.99,0.98,0.0,0.0,1.99,0.99,0.99,-0.01,0.99,0.99,0,0,1,1,0.01,1,1,0,0,0,-1,-0.99,0,0,-1,-0.99,0,0.9893333333333333,1,0.99,0.99,0.9893333333333333,0,0
273,1.99,0.01,1,0.99,0.98,0.0,19.8,1.99,0.99,20.99,-0.01,0.99,-19.01,0,20,1,21,0.01,1,-19,0,0,20,-1,-0.99,-20,400,19,19.01,20,1.2533333333333334,1,0.99,0.99,1.2533333333333334,0,20
274,1.99,0.01,625,618.75,612.56,0.0,495.0,49.75,24.75,44.75,-0.25,24.75,4.75,0,500,25,45,0.25,25,5,0,0,20,-25,-24.75,-20,400,-5,-4.75,20,326.886,25,24.75,0.99,326.886,0,20
275,1.99,0.01,625,618.75,612.56,618.75,0.0,49.75,49.75,24.75,-0.25,-0.25,24.75,625,0,50,25,0.25,0,25,625,0,25,0,0.25,25,0,-25,-24.75,-25,346.45466666666664,25,24.75,0.99,321.45466666666664,25,0
276,1.99,0.01,625,618.75,612.56,0.0,0.0,49.75,24.75,24.75,-0.25,24.75,24.75,0,0,25,25,0.25,25,25,0,0,0,-25,-24.75,0,0,-25,-24.75,0,321.8093333333333,25,24.75,0.99,321.8093333333333,0,0
277,1.99,0.01,625,618.75,612.56,618.75,0.0,49.75,49.75,24.75,-0.25,-0.25,24.75,625,0,50,25,0.25,0,25,625,0,25,0,0.25,25,0,-25,-24.75,-25,346.53266666666667,25,24.75,0.99,321.53266666666667,25,0
278,1.99,0.01,1,0.99,0.98,0.0,19.8,1.99,0.99,20.99,-0.01,0.99,-19.01,0,20,1,21,0.01,1,-19,0,0,20,-1,-0.99,-20,400,19,19.01,20,1.152,1,0.99,0.99,1.152,0,20
279,1.99,0.01,625,618.75,612.56,0.0,495.0,49.75,24.75,44.75,-0.25,24.75,4.75,0,500,25,45,0.25,25,5,0,0,20,-25,-24.75,-20,400,-5,-4.75,20,326.48466666666667,25,24.75,0.99,326.48466666666667,0,20
280,1.99,0.01,625,618.75,612.56,0.0,0.0,49.75,24.75,24.75,-0.25,24.75,24.75,0,0,25,25,0.25,25,25,0,0,0,-25,-24.75,0,0,-25,-24.75,0,322.1,25,24.75,0.99,322.1,0,0
281,1.99,0.01,1,0.99,0.98,0.0,19.8,1.99,0.99,20.99,-0.01,0.99,-19.01,0,20,1,21,0.01,1,-19,0,0,20,-1,-0.99,-20,400,19,19.01,20,1.1266666666666667,1,0.99,0.99,1.1266666666666667,0,20
282,1.99,0.01,625,618.75,612.56,0.0,495.0,49.75,24.75,44.75,-0.25,24.75,4.75,0,500,25,45,0.25,25,5,0,0,20,-25,-24.75,-20,400,-5,-4.75,20,326.8546666666667,25,24.75,0.99,326.8546666666667,0,20
283,1.99,0.01,1,0.99,0.98,0.0,0.99,1.99,0.99,1.99,-0.01,0.99,-0.01,0,1,1,2,0.01,1,0,0,0,1,-1,-0.99,-1,1,0,0.01,1,1.0,1,0.99,0.99,1.0,0,1
284,1.99,0.01,1,0.99,0.98,0.0,0.0,1.99,0.99,0.99,-0.01,0.99,0.99,0,0,1,1,0.01,1,1,0,0,0,-1,-0.99,0,0,-1,-0.99,0,0.9893333333333333,1,0.99,0.99,0.9893333333333333,0,0
285,1.01,0.99,1,0.01,0.0,0.24,0.25,1.01,24.01,25.01,-0.99,-23.99,-24.99,24,25,25,26,0.99,-23,-24,576,600,49,23,23.99,-1,625,24,24.99,1,48.76,1,0.01,0.01,24.759999999999998,24,25
286,1.99,0.01,4,3.96,3.92,0.0,0.0,3.98,1.98,1.98,-0.02,1.98,1.98,0,0,2,2,0.02,2,2,0,0,0,-2,-1.98,0,0,-2,-1.98,0,2.966,2,1.98,0.99,2.966,0,0
287,1.99,0.01,1,0.99,0.98,0.0,0.0,1.99,0.99,0.99,-0.01,0.99,0.99,0,0,1,1,0.01,1,1,0,0,0,-1,-0.99,0,0,-1,-0.99,0,0.9833333333333333,1,0.99,0.99,0.9833333333333333,0,0
288,1.75,0.25,169,125.91,93.8,0.0,0.0,22.69,9.69,9.69,-3.31,9.69,9.69,0,0,13,13,3.31,13,13,0,0,0,-13,-9.69,0,0,-13,-9.69,0,68.02,13,9.69,0.7450002328308657,68.02,0,0
289,1.01,0.99,4,0.04,0.0,0.0,0.0,2.02,0.02,0.02,-1.98,0.02,0.02,0,0,2,2,1.98,2,2,0,0,0,-2,-0.02,0,0,-2,-0.02,0,0.029333333333333333,2,0.02,0.01,0.029333333333333333,0,0
290,1.99,0.01,1,0.99,0.98,0.0,0.0,1.99,0.99,0.99,-0.01,0.99,0.99,0,0,1,1,0.01,1,1,0,0,0,-1,-0.99,0,0,-1,-0.99,0,0.992,1,0.99,0.99,0.992,0,0
291,1.01,0.99,169,1.69,0.02,0.0,0.0,13.13,0.13,0.13,-12.87,0.13,0.13,0,0,13,13,12.87,13,13,0,0,0,-13,-0.13,0,0,-13,-0.13,0,0.9626666666666667,13,0.13,0.01,0.9626666666666667,0,0
292,1.99,0.01,4,3.96,3.92,49.5,39.6,3.98,26.98,21.98,-0.02,-23.02,-18.02,50,40,27,22,0.02,-23,-18,625,500,45,23,23.02,5,400,18,18.02,-5,28.334,2,1.98,0.99,3.3339999999999996,25,20
293,1.99,0.01,25,24.75,24.5,0.0,99.0,9.95,4.95,24.95,-0.05,4.95,-15.05,0,100,5,25,0.05,5,-15,0,0,20,-5,-4.95,-20,400,15,15.05,20,15.707333333333333,5,4.95,0.99,15.707333333333333,0,20
294,1.99,0.01,1,0.99,0.98,0.0,0.99,1.99,0.99,1.99,-0.01,0.99,-0.01,0,1,1,2,0.01,1,0,0,0,1,-1,-0.99,-1,1,0,0.01,1,1.0,1,0.99,0.99,1.0,0,1
295,1.01,0.99,1,0.01,0.0,0.0,0.2,1.01,0.01,20.01,-0.99,0.01,-19.99,0,20,1,21,0.99,1,-19,0,0,20,-1,-0.01,-20,400,19,19.99,20,19.835333333333335,1,0.01,0.01,19.835333333333335,0,20
296,1.99,0.01,625,618.75,612.56,618.75,495.0,49.75,49.75,44.75,-0.25,-0.25,4.75,625,500,50,45,0.25,0,5,625,500,45,0,0.25,5,400,-5,-4.75,-5,351.8113333333333,25,24.75,0.99,326.8113333333333,25,20
297,1.99,0.01,1,0.99,0.98,0.0,0.0,1.99,0.99,0.99,-0.01,0.99,0.99,0,0,1,1,0.01,1,1,0,0,0,-1,-0.99,0,0,-1,-0.99,0,0.9893333333333333,1,0.99,0.99,0.9893333333333333,0,0
298,1.99,0.01,1,0.99,0.98,0.0,19.8,1.99,0.99,20.99,-0.01,0.99,-19.01,0,20,1,21,0.01,1,-19,0,0,20,-1,-0.99,-20,400,19,19.01,20,1.2533333333333334,1,0.99,0.99,1.2533333333333334,0,20
299,1.99,0.01,625,618.75,612.56,0.0,495.0,49.75,24.75,44.75,-0.25,24.75,4.75,0,500,25,45,0.25,25,5,0,0,20,-25,-24.75,-20,400,-5,-4.75,20,326.886,25,24.75,0.99,326.886,0,20
300,1.99,0.01,625,618.75,612.56,618.75,0.0,49.75,49.75,24.75,-0.25,-0.25,24.75,625,0,50,25,0.25,0,25,625,0,25,0,0.25,25,0,-25,-24.75,-25,346.45466666666664,25,24.75,0.99,321.45466666666664,25,0
301,1.99,0.01,625,618.75,612.56,0.0,0.0,49.75,24.75,24.75,-0.25,24.75,24.75,0,0,25,25,0.25,25,25,0,0,0,-25,-24.75,0,0,-25,-24.75,0,321.8093333333333,25,24.75,0.99,321.8093333333333,0,0
302,1.99,0.01,625,618.75,612.56,618.75,0.0,49.75,49.75,24.75,-0.25,-0.25,24.75,625,0,50,25,0.25,0,25,625,0,25,0,0.25,25,0,-25,-24.75,-25,346.53266666666667,25,24.75,0.99,321.53266666666667,25,0
303,1.99,0.01,1,0.99,0.98,0.0,19.8,1.99,0.99,20.99,-0.01,0.99,-19.01,0,20,1,21,0.01,1,-19,0,0,20,-1,-0.99,-20,400,19,19.01,20,1.152,1,0.99,0.99,1.152,0,20
304,1.99,0.01,625,618.75,612.56,0.0,495.0,49.75,24.75,44.75,-0.25,24.75,4.75,0,500,25,45,0.25,25,5,0,0,20,-25,-24.75,-20,400,-5,-4.75,20,326.48466666666667,25,24.75,0.99,326.48466666666667,0,20
305,1.99,0.01,625,618.75,612.56,0.0,0.0,49.75,24.75,24.75,-0.25,24.75,24.75,0,0,25,25,0.25,25,25,0,0,0,-25,-24.75,0,0,-25,-24.75,0,322.1,25,24.75,0.99,322.1,0,0
306,1.99,0.01,1,0.99,0.98,0.0,19.8,1.99,0.99,20.99,-0.01,0.99,-19.01,0,20,1,21,0.01,1,-19,0,0,20,-1,-0.99,-20,400,19,19.01,20,1.1266666666666667,1,0.99,0.99,1.1266666666666667,0,20
307,1.99,0.01,625,618.75,612.56,0.0,495.0,49.75,24.75,44.75,-0.25,24.75,4.75,0,500,25,45,0.25,25,5,0,0,20,-25,-24.75,-20,400,-5,-4.75,20,326.8546666666667,25,24.75,0.99,326.8546666666667,0,20
308,1.99,0.01,1,0.99,0.98,0.0,0.99,1.99,0.99,1.99,-0.01,0.99,-0.01,0,1,1,2,0.01,1,0,0,0,1,-1,-0.99,-1,1,0,0.01,1,1.0,1,0.99,0.99,1.0,0,1
309,1.99,0.01,1,0.99,0.98,0.0,0.0,1.99,0.99,0.99,-0.01,0.99,0.99,0,0,1,1,0.01,1,1,0,0,0,-1,-0.99,0,0,-1,-0.99,0,0.9893333333333333,1,0.99,0.99,0.9893333333333333,0,0
310,1.01,0.99,1,0.01,0.0,0.24,0.25,1.01,24.01,25.01,-0.99,-23.99,-24.99,24,25,25,26,0.99,-23,-24,576,600,49,23,23.99,-1,625,24,24.99,1,48.76,1,0.01,0.01,24.759999999999998,24,25
311,1.99,0.01,4,3.96,3.92,0.0,0.0,3.98,1.98,1.98,-0.02,1.98,1.98,0,0,2,2,0.02,2,2,0,0,0,-2,-1.98,0,0,-2,-1.98,0,2.966,2,1.98,0.99,2.966,0,0
312,1.99,0.01,1,0.99,0.98,0.0,0.0,1.99,0.99,0.99,-0.01,0.99,0.99,0,0,1,1,0.01,1,1,0,0,0,-1,-0.99,0,0,-1,-0.99,0,0.9833333333333333,1,0.99,0.99,0.9833333333333333,0,0
313,1.75,0.25,169,125.91,93.8,0.0,0.0,22.69,9.69,9.69,-3.31,9.69,9.69,0,0,13,13,3.31,13,13,0,0,0,-13,-9.69,0,0,-13,-9.69,0,68.02,13,9.69,0.7450002328308657,68.02,0,0
314,1.01,0.99,4,0.04,0.0,0.0,0.0,2.02,0.02,0.02,-1.98,0.02,0.02,0,0,2,2,1.98,2,2,0,0,0,-2,-0.02,0,0,-2,-0.02,0,0.029333333333333333,2,0.02,0.01,0.029333333333333333,0,0
315,1.99,0.01,1,0.99,0.98,0.0,0.0,1.99,0.99,0.99,-0.01,0.99,0.99,0,0,1,1,0.01,1,1,0,0,0,-1,-0.99,0,0,-1,-0.99,0,0.992,1,0.99,0.99,0.992,0,0
316,1.01,0.99,169,1.69,0.02,0.0,0.0,13.13,0.13,0.13,-12.87,0.13,0.13,0,0,13,13,12.87,13,13,0,0,0,-13,-0.13,0,0,-13,-0.13,0,0.9626666666666667,13,0.13,0.01,0.9626666666666667,0,0
317,1.99,0.01,4,3.96,3.92,49.5,39.6,3.98,26.98,21.98,-0.02,-23.02,-18.02,50,40,27,22,0.02,-23,-18,625,500,45,23,23.02,5,400,18,18.02,-5,28.334,2,1.98,0.99,3.3339999999999996,25,20
318,1.99,0.01,25,24.75,24.5,0.0,99.0,9.95,4.95,24.95,-0.05,4.95,-15.05,0,100,5,25,0.05,5,-15,0,0,20,-5,-4.95,-20,400,15,15.05,20,15.707333333333333,5,4.95,0.99,15.707333333333333,0,20
319,1.99,0.01,1,0.99,0.98,0.0,0.99,1.99,0.99,1.99,-0.01,0.99,-0.01,0,1,1,2,0.01,1,0,0,0,1,-1,-0.99,-1,1,0,0.01,1,1.0,1,0.99,0.99,1.0,0,1
320,1.01,0.99,1,0.01,0.0,0.0,0.2,1.01,0.01,20.01,-0.99,0.01,-19.99,0,20,1,21,0.99,1,-19,0,0,20,-1,-0.01,-20,400,19,19.99,20,19.835333333333335,1,0.01,0.01,19.835333333333335,0,20
321,1.99,0.01,625,618.75,612.56,618.75,495.0,49.75,49.75,44.75,-0.25,-0.25,4.75,625,500,50,45,0.25,0,5,625,500,45,0,0.25,5,400,-5,-4.75,-5,351.8113333333333,25,24.75,0.99,326.8113333333333,25,20
322,1.99,0.01,1,0.99,0.98,0.0,0.0,1.99,0.99,0.99,-0.01,0.99,0.99,0,0,1,1,0.01,1,1,0,0,0,-1,-0.99,0,0,-1,-0.99,0,0.9893333333333333,1,0.99,0.99,0.9893333333333333,0,0
323,1.99,0.01,1,0.99,0.98,0.0,19.8,1.99,0.99,20.99,-0.01,0.99,-19.01,0,20,1,21,0.01,1,-19,0,0,20,-1,-0.99,-20,400,19,19.01,20,1.2533333333333334,1,0.99,0.99,1.2533333333333334,0,20
324,1.99,0.01,625,618.75,612.56,0.0,495.0,49.75,24.75,44.75,-0.25,24.75,4.75,0,500,25,45,0.25,25,5,0,0,20,-25,-24.75,-20,400,-5,-4.75,20,326.886,25,24.75,0.99,326.886,0,20
325,1.99,0.01,625,618.75,612.56,618.75,0.0,49.75,49.75,24.75,-0.25,-0.25,24.75,625,0,50,25,0.25,0,25,625,0,25,0,0.25,25,0,-25,-24.75,-25,346.45466666666664,25,24.75,0.99,321.45466666666664,25,0
326,1.99,0.01,625,618.75,612.56,0.0,0.0,49.75,24.75,24.75,-0.25,24.75,24.75,0,0,25,25,0.25,25,25,0,0,0,-25,-24.75,0,0,-25,-24.75,0,321.8093333333333,25,24.75,0.99,321.8093333333333,0,0
327,1.99,0.01,625,618.75,612.56,618.75,0.0,49.75,49.75,24.75,-0.25,-0.25,24.75,625,0,50,25,0.25,0,25,625,0,25,0,0.25,25,0,-25,-24.75,-25,346.53266666666667,25,24.75,0.99,321.53266666666667,25,0
328,1.99,0.01,1,0.99,0.98,0.0,19.8,1.99,0.99,20.99,-0.01,0.99,-19.01,0,20,1,21,0.01,1,-19,0,0,20,-1,-0.99,-20,400,19,19.01,20,1.152,1,0.99,0.99,1.152,0,20
329,1.99,0.01,625,618.75,612.56,0.0,495.0,49.75,24.75,44.75,-0.25,24.75,4.75,0,500,25,45,0.25,25,5,0,0,20,-25,-24.75,-20,400,-5,-4.75,20,326.48466666666667,25,24.75,0.99,326.48466666666667,0,20
330,1.99,0.01,625,618.75,612.56,0.0,0.0,49.75,24.75,24.75,-0.25,24.75,24.75,0,0,25,25,0.25,25,25,0,0,0,-25,-24.75,0,0,-25,-24.75,0,322.1,25,24.75,0.99,322.1,0,0
331,1.99,0.01,1,0.99,0.98,0.0,19.8,1.99,0.99,20.99,-0.01,0.99,-19.01,0,20,1,21,0.01,1,-19,0,0,20,-1,-0.99,-20,400,19,19.01,20,1.1266666666666667,1,0.99,0.99,1.1266666666666667,0,20
332,1.99,0.01,625,618.75,612.56,0.0,495.0,49.75,24.75,44.75,-0.25,24.75,4.75,0,500,25,45,0.25,25,5,0,0,20,-25,-24.75,-20,400,-5,-4.75,20,326.8546666666667,25,24.75,0.99,326.8546666666667,0,20
333,1.99,0.01,1,0.99,0.98,0.0,0.99,1.99,0.99,1.99,-0.01,0.99,-0.01,0,1,1,2,0.01,1,0,0,0,1,-1,-0.99,-1,1,0,0.01,1,1.0,1,0.99,0.99,1.0,0,1
334,1.99,0.01,1,0.99,0.98,0.0,0.0,1.99,0.99,0.99,-0.01,0.99,0.99,0,0,1,1,0.01,1,1,0,0,0,-1,-0.99,0,0,-1,-0.99,0,0.9893333333333333,1,0.99,0.99,0.9893333333333333,0,0
335,1.01,0.99,1,0.01,0.0,0.24,0.25,1.01,24.01,25.01,-0.99,-23.99,-24.99,24,25,25,26,0.99,-23,-24,576,600,49,23,23.99,-1,625,24,24.99,1,48.76,1,0.01,0.01,24.759999999999998,24,25
336,1.99,0.01,4,3.96,3.92,0.0,0.0,3.98,1.98,1.98,-0.02,1.98,1.98,0,0,2,2,0.02,2,2,0,0,0,-2,-1.98,0,0,-2,-1.98,0,2.966,2,1.98,0.99,2.966,0,0
337,1.99,0.01,1,0.99,0.98,0.0,0.0,1.99,0.99,0.99,-0.01,0.99,0.99,0,0,1,1,0.01,1,1,0,0,0,-1,-0.99,0,0,-1,-0.99,0,0.9833333333333333,1,0.99,0.99,0.9833333333333333,0,0
338,1.75,0.25,169,125.91,93.8,0.0,0.0,22.69,9.69,9.69,-3.31,9.69,9.69,0,0,13,13,3.31,13,13,0,0,0,-13,-9.69,0,0,-13,-9.69,0,68.02,13,9.69,0.7450002328308657,68.02,0,0
339,1.01,0.99,4,0.04,0.0,0.0,0.0,2.02,0.02,0.02,-1.98,0.02,0.02,0,0,2,2,1.98,2,2,0,0,0,-2,-0.02,0,0,-2,-0.02,0,0.029333333333333333,2,0.02,0.01,0.029333333333333333,0,0
340,1.99,0.01,1,0.99,0.98,0.0,0.0,1.99,0.99,0.99,-0.01,0.99,0.99,0,0,1,1,0.01,1,1,0,0,0,-1,-0.99,0,0,-1,-0.99,0,0.992,1,0.99,0.99,0.992,0,0
341,1.01,0.99,169,1.69,0.02,0.0,0.0,13.13,0.13,0.13,-12.87,0.13,0.13,0,0,13,13,12.87,13,13,0,0,0,-13,-0.13,0,0,-13,-0.13,0,0.9626666666666667,13,0.13,0.01,0.9626666666666667,0,0
342,1.99,0.01,4,3.96,3.92,49.5,39.6,3.98,26.98,21.98,-0.02,-23.02,-18.02,50,40,27,22,0.02,-23,-18,625,500,45,23,23.02,5,400,18,18.02,-5,28.334,2,1.98,0.99,3.3339999999999996,25,20
343,1.99,0.01,25,24.75,24.5,0.0,99.0,9.95,4.95,24.95,-0.05,4.95,-15.05,0,100,5,25,0.05,5,-15,0,0,20,-5,-4.95,-20,400,15,15.05,20,15.707333333333333,5,4.95,0.99,15.707333333333333,0,20
344,1.99,0.01,1,0.99,0.98,0.0,0.99,1.99,0.99,1.99,-0.01,0.99,-0.01,0,1,1,2,0.01,1,0,0,0,1,-1,-0.99,-1,1,0,0.01,1,1.0,1,0.99,0.99,1.0,0,1
345,1.01,0.99,1,0.01,0.0,0.0,0.2,1.01,0.01,20.01,-0.99,0.01,-19.99,0,20,1,21,0.99,1,-19,0,0,20,-1,-0.01,-20,400,19,19.99,20,19.835333333333335,1,0.01,0.01,19.835333333333335,0,20
346,1.99,0.01,625,618.75,612.56,618.75,495.0,49.75,49.75,44.75,-0.25,-0.25,4.75,625,500,50,45,0.25,0,5,625,500,45,0,0.25,5,400,-5,-4.75,-5,351.8113333333333,25,24.75,0.99,326.8113333333333,25,20
347,1.99,0.01,1,0.99,0.98,0.0,0.0,1.99,0.99,0.99,-0.01,0.99,0.99,0,0,1,1,0.01,1,1,0,0,0,-1,-0.99,0,0,-1,-0.99,0,0.9893333333333333,1,0.99,0.99,0.9893333333333333,0,0
348,1.99,0.01,1,0.99,0.98,0.0,19.8,1.99,0.99,20.99,-0.01,0.99,-19.01,0,20,1,21,0.01,1,-19,0,0,20,-1,-0.99,-20,400,19,19.01,20,1.2533333333333334,1,0.99,0.99,1.2533333333333334,0,20
349,1.99,0.01,625,618.75,612.56,0.0,495.0,49.75,24.75,44.75,-0.25,24.75,4.75,0,500,25,45,0.25,25,5,0,0,20,-25,-24.75,-20,400,-5,-4.75,20,326.886,25,24.75,0.99,326.886,0,20
350,1.99,0.01,625,618.75,612.56,618.75,0.0,49.75,49.75,24.75,-0.25,-0.25,24.75,625,0,50,25,0.25,0,25,625,0,25,0,0.25,25,0,-25,-24.75,-25,346.45466666666664,25,24.75,0.99,321.45466666666664,25,0
351,1.99,0.01,625,618.75,612.56,0.0,0.0,49.75,24.75,24.75,-0.25,24.75,24.75,0,0,25,25,0.25,25,25,0,0,0,-25,-24.75,0,0,-25,-24.75,0,321.8093333333333,25,24.75,0.99,321.8093333333333,0,0
352,1.99,0.01,625,618.75,612.56,618.75,0.0,49.75,49.75,24.75,-0.25,-0.25,24.75,625,0,50,25,0.25,0,25,625,0,25,0,0.25,25,0,-25,-24.75,-25,346.53266666666667,25,24.75,0.99,321.53266666666667,25,0
353,1.99,0.01,1,0.99,0.98,0.0,19.8,1.99,0.99,20.99,-0.01,0.99,-19.01,0,20,1,21,0.01,1,-19,0,0,20,-1,-0.99,-20,400,19,19.01,20,1.152,1,0.99,0.99,1.152,0,20
354,1.99,0.01,625,618.75,612.56,0.0,495.0,49.75,24.75,44.75,-0.25,24.75,4.75,0,500,25,45,0.25,25,5,0,0,20,-25,-24.75,-20,400,-5,-4.75,20,326.48466666666667,25,24.75,0.99,326.48466666666667,0,20
355,1.99,0.01,625,618.75,612.56,0.0,0.0,49.75,24.75,24.75,-0.25,24.75,24.75,0,0,25,25,0.25,25,25,0,0,0,-25,-24.75,0,0,-25,-24.75,0,322.1,25,24.75,0.99,322.1,0,0
356,1.99,0.01,1,0.99,0.98,0.0,19.8,1.99,0.99,20.99,-0.01,0.99,-19.01,0,20,1,21,0.01,1,-19,0,0,20,-1,-0.99,-20,400,19,19.01,20,1.1266666666666667,1,0.99,0.99,1.1266666666666667,0,20
357,1.99,0.01,625,618.75,612.56,0.0,495.0,49.75,24.75,44.75,-0.25,24.75,4.75,0,500,25,45,0.25,25,5,0,0,20,-25,-24.75,-20,400,-5,-4.75,20,326.8546666666667,25,24.75,0.99,326.8546666666667,0,20
358,1.99,0.01,1,0.99,0.98,0.0,0.99,1.99,0.99,1.99,-0.01,0.99,-0.01,0,1,1,2,0.01,1,0,0,0,1,-1,-0.99,-1,1,0,0.01,1,1.0,1,0.99,0.99,1.0,0,1
359,1.99,0.01,1,0.99,0.98,0.0,0.0,1.99,0.99,0.99,-0.01,0.99,0.99,0,0,1,1,0.01,1,1,0,0,0,-1,-0.99,0,0,-1,-0.99,0,0.9893333333333333,1,0.99,0.99,0.9893333333333333,0,0
360,1.01,0.99,1,0.01,0.0,0.24,0.25,1.01,24.01,25.01,-0.99,-23.99,-24.99,24,25,25,26,0.99,-23,-24,576,600,49,23,23.99,-1,625,24,24.99,1,48.76,1,0.01,0.01,24.759999999999998,24,25
361,1.99,0.01,4,3.96,3.92,0.0,0.0,3.98,1.98,1.98,-0.02,1.98,1.98,0,0,2,2,0.02,2,2,0,0,0,-2,-1.98,0,0,-2,-1.98,0,2.966,2,1.98,0.99,2.966,0,0
362,1.99,0.01,1,0.99,0.98,0.0,0.0,1.99,0.99,0.99,-0.01,0.99,0.99,0,0,1,1,0.01,1,1,0,0,0,-1,-0.99,0,0,-1,-0.99,0,0.9833333333333333,1,0.99,0.99,0.9833333333333333,0,0
363,1.75,0.25,169,125.91,93.8,0.0,0.0,22.69,9.69,9.69,-3.31,9.69,9.69,0,0,13,13,3.31,13,13,0,0,0,-13,-9.69,0,0,-13,-9.69,0,68.02,13,9.69,0.7450002328308657,68.02,0,0
364,1.01,0.99,4,0.04,0.0,0.0,0.0,2.02,0.02,0.02,-1.98,0.02,0.02,0,0,2,2,1.98,2,2,0,0,0,-2,-0.02,0,0,-2,-0.02,0,0.029333333333333333,2,0.02,0.01,0.029333333333333333,0,0
365,1.99,0.01,1,0.99,0.98,0.0,0.0,1.99,0.99,0.99,-0.01,0.99,0.99,0,0,1,1,0.01,1,1,0,0,0,-1,-0.99,0,0,-1,-0.99,0,0.992,1,0.99,0.99,0.992,0,0
366,1.01,0.99,169,1.69,0.02,0.0,0.0,13.13,0.13,0.13,-12.87,0.13,0.13,0,0,13,13,12.87,13,13,0,0,0,-13,-0.13,0,0,-13,-0.13,0,0.9626666666666667,13,0.13,0.01,0.9626666666666667,0,0
367,1.99,0.01,4,3.96,3.92,49.5,39.6,3.98,26.98,21.98,-0.02,-23.02,-18.02,50,40,27,22,0.02,-23,-18,625,500,45,23,23.02,5,400,18,18.02,-5,28.334,2,1.98,0.99,3.3339999999999996,25,20
368,1.99,0.01,25,24.75,24.5,0.0,99.0,9.95,4.95,24.95,-0.05,4.95,-15.05,0,100,5,25,0.05,5,-15,0,0,20,-5,-4.95,-20,400,15,15.05,20,15.707333333333333,5,4.95,0.99,15.707333333333333,0,20
369,1.99,0.01,1,0.99,0.98,0.0,0.99,1.99,0.99,1.99,-0.01,0.99,-0.01,0,1,1,2,0.01,1,0,0,0,1,-1,-0.99,-1,1,0,0.01,1,1.0,1,0.99,0.99,1.0,0,1
370,1.01,0.99,1,0.01,0.0,0.0,0.2,1.01,0.01,20.01,-0.99,0.01,-19.99,0,20,1,21,0.99,1,-19,0,0,20,-1,-0.01,-20,400,19,19.99,20,19.835333333333335,1,0.01,0.01,19.835333333333335,0,20
371,1.99,0.01,625,618.75,612.56,618.75,495.0,49.75,49.75,44.75,-0.25,-0.25,4.75,625,500,50,45,0.25,0,5,625,500,45,0,0.25,5,400,-5,-4.75,-5,351.8113333333333,25,24.75,0.99,326.8113333333333,25,20
372,1.99,0.01,1,0.99,0.98,0.0,0.0,1.99,0.99,0.99,-0.01,0.99,0.99,0,0,1,1,0.01,1,1,0,0,0,-1,-0.99,0,0,-1,-0.99,0,0.9893333333333333,1,0.99,0.99,0.9893333333333333,0,0
373,1.99,0.01,1,0.99,0.98,0.0,19.8,1.99,0.99,20.99,-0.01,0.99,-19.01,0,20,1,21,0.01,1,-19,0,0,20,-1,-0.99,-20,400,19,19.01,20,1.2533333333333334,1,0.99,0.99,1.2533333333333334,0,20
374,1.99,0.01,625,618.75,612.56,0.0,495.0,49.75,24.75,44.75,-0.25,24.75,4.75,0,500,25,45,0.25,25,5,0,0,20,-25,-24.75,-20,400,-5,-4.75,20,326.886,25,24.75,0.99,326.886,0,20
375,1.99,0.01,625,618.75,612.56,618.75,0.0,49.75,49.75,24.75,-0.25,-0.25,24.75,625,0,50,25,0.25,0,25,625,0,25,0,0.25,25,0,-25,-24.75,-25,346.45466666666664,25,24.75,0.99,321.45466666666664,25,0
376,1.99,0.01,625,618.75,612.56,0.0,0.0,49.75,24.75,24.75,-0.25,24.75,24.75,0,0,25,25,0.25,25,25,0,0,0,-25,-24.75,0,0,-25,-24.75,0,321.8093333333333,25,24.75,0.99,321.8093333333333,0,0
377,1.99,0.01,625,618.75,612.56,618.75,0.0,49.75,49.75,24.75,-0.25,-0.25,24.75,625,0,50,25,0.25,0,25,625,0,25,0,0.25,25,0,-25,-24.75,-25,346.53266666666667,25,24.75,0.99,321.53266666666667,25,0
378,1.99,0.01,1,0.99,0.98,0.0,19.8,1.99,0.99,20.99,-0.01,0.99,-19.01,0,20,1,21,0.01,1,-19,0,0,20,-1,-0.99,-20,400,19,19.01,20,1.152,1,0.99,0.99,1.152,0,20
379,1.99,0.01,625,618.75,612.56,0.0,495.0,49.75,24.75,44.75,-0.25,24.75,4.75,0,500,25,45,0.25,25,5,0,0,20,-25,-24.75,-20,400,-5,-4.75,20,326.48466666666667,25,24.75,0.99,326.48466666666667,0,20
380,1.99,0.01,625,618.75,612.56,0.0,0.0,49.75,24.75,24.75,-0.25,24.75,24.75,0,0,25,25,0.25,25,25,0,0,0,-25,-24.75,0,0,-25,-24.75,0,322.1,25,24.75,0.99,322.1,0,0
381,1.99,0.01,1,0.99,0.98,0.0,19.8,1.99,0.99,20.99,-0.01,0.99,-19.01,0,20,1,21,0.01,1,-19,0,0,20,-1,-0.99,-20,400,19,19.01,20,1.1266666666666667,1,0.99,0.99,1.1266666666666667,0,20
382,1.99,0.01,625,618.75,612.56,0.0,495.0,49.75,24.75,44.75,-0.25,24.75,4.75,0,500,25,45,0.25,25,5,0,0,20,-25,-24.75,-20,400,-5,-4.75,20,326.8546666666667,25,24.75,0.99,326.8546666666667,0,20
383,1.99,0.01,1,0.99,0.98,0.0,0.99,1.99,0.99,1.99,-0.01,0.99,-0.01,0,1,1,2,0.01,1,0,0,0,1,-1,-0.99,-1,1,0,0.01,1,1.0,1,0.99,0.99,1.0,0,1
384,1.99,0.01,1,0.99,0.98,0.0,0.0,1.99,0.99,0.99,-0.01,0.99,0.99,0,0,1,1,0.01,1,1,0,0,0,-1,-0.99,0,0,-1,-0.99,0,0.9893333333333333,1,0.99,0.99,0.9893333333333333,0,0
385,1.01,0.99,1,0.01,0.0,0.24,0.25,1.01,24.01,25.01,-0.99,-23.99,-24.99,24,25,25,26,0.99,-23,-24,576,600,49,23,23.99,-1,625,24,24.99,1,48.76,1,0.01,0.01,24.759999999999998,24,25
386,1.99,0.01,4,3.96,3.92,0.0,0.0,3.98,1.98,1.98,-0.02,1.98,1.98,0,0,2,2,0.02,2,2,0,0,0,-2,-1.98,0,0,-2,-1.98,0,2.966,2,1.98,0.99,2.966,0,0
387,1.99,0.01,1,0.99,0.98,0.0,0.0,1.99,0.99,0.99,-0.01,0.99,0.99,0,0,1,1,0.01,1,1,0,0,0,-1,-0.99,0,0,-1,-0.99,0,0.9833333333333333,1,0.99,0.99,0.9833333333333333,0,0
388,1.75,0.25,169,125.91,93.8,0.0,0.0,22.69,9.69,9.69,-3.31,9.69,9.69,0,0,13,13,3.31,13,13,0,0,0,-13,-9.69,0,0,-13,-9.69,0,68.02,13,9.69,0.7450002328308657,68.02,0,0
389,1.01,0.99,4,0.04,0.0,0.0,0.0,2.02,0.02,0.02,-1.98,0.02,0.02,0,0,2,2,1.98,2,2,0,0,0,-2,-0.02,0,0,-2,-0.02,0,0.029333333333333333,2,0.02,0.01,0.029333333333333333,0,0
390,1.99,0.01,1,0.99,0.98,0.0,0.0,1.99,0.99,0.99,-0.01,0.99,0.99,0,0,1,1,0.01,1,1,0,0,0,-1,-0.99,0,0,-1,-0.99,0,0.992,1,0.99,0.99,0.992,0,0
391,1.01,0.99,169,1.69,0.02,0.0,0.0,13.13,0.13,0.13,-12.87,0.13,0.13,0,0,13,13,12.87,13,13,0,0,0,-13,-0.13,0,0,-13,-0.13,0,0.9626666666666667,13,0.13,0.01,0.9626666666666667,0,0
392,1.99,0.01,4,3.96,3.92,49.5,39.6,3.98,26.98,21.98,-0.02,-23.02,-18.02,50,40,27,22,0.02,-23,-18,625,500,45,23,23.02,5,400,18,18.02,-5,28.334,2,1.98,0.99,3.3339999999999996,25,20
393,1.99,0.01,25,24.75,24.5,0.0,99.0,9.95,4.95,24.95,-0.05,4.95,-15.05,0,100,5,25,0.05,5,-15,0,0,20,-5,-4.95,-20,400,15,15.05,20,15.707333333333333,5,4.95,0.99,15.707333333333333,0,20
394,1.99,0.01,1,0.99,0.98,0.0,0.99,1.99,0.99,1.99,-0.01,0.99,-0.01,0,1,1,2,0.01,1,0,0,0,1,-1,-0.99,-1,1,0,0.01,1,1.0,1,0.99,0.99,1.0,0,1
395,1.01,0.99,1,0.01,0.0,0.0,0.2,1.01,0.01,20.01,-0.99,0.01,-19.99,0,20,1,21,0.99,1,-19,0,0,20,-1,-0.01,-20,400,19,19.99,20,19.835333333333335,1,0.01,0.01,19.835333333333335,0,20
396,1.99,0.01,625,618.75,612.56,618.75,495.0,49.75,49.75,44.75,-0.25,-0.25,4.75,625,500,50,45,0.25,0,5,625,500,45,0,0.25,5,400,-5,-4.75,-5,351.8113333333333,25,24.75,0.99,326.8113333333333,25,20
397,1.99,0.01,1,0.99,0.98,0.0,0.0,1.99,0.99,0.99,-0.01,0.99,0.99,0,0,1,1,0.01,1,1,0,0,0,-1,-0.99,0,0,-1,-0.99,0,0.9893333333333333,1,0.99,0.99,0.9893333333333333,0,0
398,1.99,0.01,1,0.99,0.98,0.0,19.8,1.99,0.99,20.99,-0.01,0.99,-19.01,0,20,1,21,0.01,1,-19,0,0,20,-1,-0.99,-20,400,19,19.01,20,1.2533333333333334,1,0.99,0.99,1.2533333333333334,0,20
399,1.99,0.01,625,618.75,612.56,0.0,495.0,49.75,24.75,44.75,-0.25,24.75,4.75,0,500,25,45,0.25,25,5,0,0,20,-25,-24.75,-20,400,-5,-4.75,20,326.886,25,24.75,0.99,326.886,0,20
400,1.99,0.01,625,618.75,612.56,618.75,0.0,49.75,49.75,24.75,-0.25,-0.25,24.75,625,0,50,25,0.25,0,25,625,0,25,0,0.25,25,0,-25,-24.75,-25,346.45466666666664,25,24.75,0.99,321.45466666666664,25,0
401,1.99,0.01,625,618.75,612.56,0.0,0.0,49.75,24.75,24.75,-0.25,24.75,24.75,0,0,25,25,0.25,25,25,0,0,0,-25,-24.75,0,0,-25,-24.75,0,321.8093333333333,25,24.75,0.99,321.8093333333333,0,0
402,1.99,0.01,625,618.75,612.56,618.75,0.0,49.75,49.75,24.75,-0.25,-0.25,24.75,625,0,50,25,0.25,0,25,625,0,25,0,0.25,25,0,-25,-24.75,-25,346.53266666666667,25,24.75,0.99,321.53266666666667,25,0
403,1.99,0.01,1,0.99,0.98,0.0,19.8,1.99,0.99,20.99,-0.01,0.99,-19.01,0,20,1,21,0.01,1,-19,0,0,20,-1,-0.99,-20,400,19,19.01,20,1.152,1,0.99,0.99,1.152,0,20
404,1.99,0.01,625,618.75,612.56,0.0,495.0,49.75,24.75,44.75,-0.25,24.75,4.75,0,500,25,45,0.25,25,5,0,0,20,-25,-24.75,-20,400,-5,-4.75,20,326.48466666666667,25,24.75,0.99,326.48466666666667,0,20
405,1.99,0.01,625,618.75,612.56,0.0,0.0,49.75,24.75,24.75,-0.25,24.75,24.75,0,0,25,25,0.25,25,25,0,0,0,-25,-24.75,0,0,-25,-24.75,0,322.1,25,24.75,0.99,322.1,0,0
406,1.99,0.01,1,0.99,0.98,0.0,19.8,1.99,0.99,20.99,-0.01,0.99,-19.01,0,20,1,21,0.01,1,-19,0,0,20,-1,-0.99,-20,400,19,19.01,20,1.1266666666666667,1,0.99,0.99,1.1266666666666667,0,20
407,1.99,0.01,625,618.75,612.56,0.0,495.0,49.75,24.75,44.75,-0.25,24.75,4.75,0,500,25,45,0.25,25,5,0,0,20,-25,-24.75,-20,400,-5,-4.75,20,326.8546666666667,25,24.75,0.99,326.8546666666667,0,20
408,1.99,0.01,1,0.99,0.98,0.0,0.99,1.99,0.99,1.99,-0.01,0.99,-0.01,0,1,1,2,0.01,1,0,0,0,1,-1,-0.99,-1,1,0,0.01,1,1.0,1,0.99,0.99,1.0,0,1
409,1.99,0.01,1,0.99,0.98,0.0,0.0,1.99,0.99,0.99,-0.01,0.99,0.99,0,0,1,1,0.01,1,1,0,0,0,-1,-0.99,0,0,-1,-0.99,0,0.9893333333333333,1,0.99,0.99,0.9893333333333333,0,0
410,1.01,0.99,1,0.01,0.0,0.24,0.25,1.01,24.01,25.01,-0.99,-23.99,-24.99,24,25,25,26,0.99,-23,-24,576,600,49,23,23.99,-1,625,24,24.99,1,48.76,1,0.01,0.01,24.759999999999998,24,25
411,1.99,0.01,4,3.96,3.92,0.0,0.0,3.98,1.98,1.98,-0.02,1.98,1.98,0,0,2,2,0.02,2,2,0,0,0,-2,-1.98,0,0,-2,-1.98,0,2.966,2,1.98,0.99,2.966,0,0
412,1.99,0.01,1,0.99,0.98,0.0,0.0,1.99,0.99,0.99,-0.01,0.99,0.99,0,0,1,1,0.01,1,1,0,0,0,-1,-0.99,0,0,-1,-0.99,0,0.9833333333333333,1,0.99,0.99,0.9833333333333333,0,0
413,1.75,0.25,169,125.91,93.8,0.0,0.0,22.69,9.69,9.69,-3.31,9.69,9.69,0,0,13,13,3.31,13,13,0,0,0,-13,-9.69,0,0,-13,-9.69,0,68.02,13,9.69,0.7450002328308657,68.02,0,0
414,1.01,0.99,4,0.04,0.0,0.0,0.0,2.02,0.02,0.02,-1.98,0.02,0.02,0,0,2,2,1.98,2,2,0,0,0,-2,-0.02,0,0,-2,-0.02,0,0.029333333333333333,2,0.02,0.01,0.029333333333333333,0,0
415,1.99,0.01,1,0.99,0.98,0.0,0.0,1.99,0.99,0.99,-0.01,0.99,0.99,0,0,1,1,0.01,1,1,0,0,0,-1,-0.99,0,0,-1,-0.99,0,0.992,1,0.99,0.99,0.992,0,0
416,1.01,0.99,169,1.69,0.02,0.0,0.0,13.13,0.13,0.13,-12.87,0.13,0.13,0,0,13,13,12.87,13,13,0,0,0,-13,-0.13,0,0,-13,-0.13,0,0.9626666666666667,13,0.13,0.01,0.9626666666666667,0,0
417,1.99,0.01,4,3.96,3.92,49.5,39.6,3.98,26.98,21.98,-0.02,-23.02,-18.02,50,40,27,22,0.02,-23,-18,625,500,45,23,23.02,5,400,18,18.02,-5,28.334,2,1.98,0.99,3.3339999999999996,25,20
418,1.99,0.01,25,24.75,24.5,0.0,99.0,9.95,4.95,24.95,-0.05,4.95,-15.05,0,100,5,25,0.05,5,-15,0,0,20,-5,-4.95,-20,400,15,15.05,20,15.707333333333333,5,4.95,0.99,15.707333333333333,0,20
419,1.99,0.01,1,0.99,0.98,0.0,0.99,1.99,0.99,1.99,-0.01,0.99,-0.01,0,1,1,2,0.01,1,0,0,0,1,-1,-0.99,-1,1,0,0.01,1,1.0,1,0.99,0.99,1.0,0,1
420,1.01,0.99,1,0.01,0.0,0.0,0.2,1.01,0.01,20.01,-0.99,0.01,-19.99,0,20,1,21,0.99,1,-19,0,0,20,-1,-0.01,-20,400,19,19.99,20,19.835333333333335,1,0.01,0.01,19.835333333333335,0,20
421,1.99,0.01,625,618.75,612.56,618.75,495.0,49.75,49.75,44.75,-0.25,-0.25,4.75,625,500,50,45,0.25,0,5,625,500,45,0,0.25,5,400,-5,-4.75,-5,351.8113333333333,25,24.75,0.99,326.8113333333333,25,20
422,1.99,0.01,1,0.99,0.98,0.0,0.0,1.99,0.99,0.99,-0.01,0.99,0.99,0,0,1,1,0.01,1,1,0,0,0,-1,-0.99,0,0,-1,-0.99,0,0.9893333333333333,1,0.99,0.99,0.9893333333333333,0,0
423,1.99,0.01,1,0.99,0.98,0.0,19.8,1.99,0.99,20.99,-0.01,0.99,-19.01,0,20,1,21,0.01,1,-19,0,0,20,-1,-0.99,-20,400,19,19.01,20,1.2533333333333334,1,0.99,0.99,1.2533333333333334,0,20
424,1.99,0.01,625,618.75,612.56,0.0,495.0,49.75,24.75,44.75,-0.25,24.75,4.75,0,500,25,45,0.25,25,5,0,0,20,-25,-24.75,-20,400,-5,-4.75,20,326.886,25,24.75,0.99,326.886,0,20
425,1.99,0.01,625,618.75,612.56,618.75,0.0,49.75,49.75,24.75,-0.25,-0.25,24.75,625,0,50,25,0.25,0,25,625,0,25,0,0.25,25,0,-25,-24.75,-25,346.45466666666664,25,24.75,0.99,321.45466666666664,25,0
426,1.99,0.01,625,618.75,612.56,0.0,0.0,49.75,24.75,24.75,-0.25,24.75,24.75,0,0,25,25,0.25,25,25,0,0,0,-25,-24.75,0,0,-25,-24.75,0,321.8093333333333,25,24.75,0.99,321.8093333333333,0,0
427,1.99,0.01,625,618.75,612.56,618.75,0.0,49.75,49.75,24.75,-0.25,-0.25,24.75,625,0,50,25,0.25,0,25,625,0,25,0,0.25,25,0,-25,-24.75,-25,346.53266666666667,25,24.75,0.99,321.53266666666667,25,0
428,1.99,0.01,1,0.99,0.98,0.0,19.8,1.99,0.99,20.99,-0.01,0.99,-19.01,0,20,1,21,0.01,1,-19,0,0,20,-1,-0.99,-20,400,19,19.01,20,1.152,1,0.99,0.99,1.152,0,20
429,1.99,0.01,625,618.75,612.56,0.0,495.0,49.75,24.75,44.75,-0.25,24.75,4.75,0,500,25,45,0.25,25,5,0,0,20,-25,-24.75,-20,400,-5,-4.75,20,326.48466666666667,25,24.75,0.99,326.48466666666667,0,20
430,1.99,0.01,625,618.75,612.56,0.0,0.0,49.75,24.75,24.75,-0.25,24.75,24.75,0,0,25,25,0.25,25,25,0,0,0,-25,-24.75,0,0,-25,-24.75,0,322.1,25,24.75,0.99,322.1,0,0
431,1.99,0.01,1,0.99,0.98,0.0,19.8,1.99,0.99,20.99,-0.01,0.99,-19.01,0,20,1,21,0.01,1,-19,0,0,20,-1,-0.99,-20,400,19,19.01,20,1.1266666666666667,1,0.99,0.99,1.1266666666666667,0,20
432,1.99,0.01,625,618.75,612.56,0.0,495.0,49.75,24.75,44.75,-0.25,24.75,4.75,0,500,25,45,0.25,25,5,0,0,20,-25,-24.75,-20,400,-5,-4.75,20,326.8546666666667,25,24.75,0.99,326.8546666666667,0,20
433,1.99,0.01,1,0.99,0.98,0.0,0.99,1.99,0.99,1.99,-0.01,0.99,-0.01,0,1,1,2,0.01,1,0,0,0,1,-1,-0.99,-1,1,0,0.01,1,1.0,1,0.99,0.99,1.0,0,1
434,1.99,0.01,1,0.99,0.98,0.0,0.0,1.99,0.99,0.99,-0.01,0.99,0.99,0,0,1,1,0.01,1,1,0,0,0,-1,-0.99,0,0,-1,-0.99,0,0.9893333333333333,1,0.99,0.99,0.9893333333333333,0,0
435,1.01,0.99,1,0.01,0.0,0.24,0.25,1.01,24.01,25.01,-0.99,-23.99,-24.99,24,25,25,26,0.99,-23,-24,576,600,49,23,23.99,-1,625,24,24.99,1,48.76,1,0.01,0.01,24.759999999999998,24,25
436,1.99,0.01,4,3.96,3.92,0.0,0.0,3.98,1.98,1.98,-0.02,1.98,1.98,0,0,2,2,0.02,2,2,0,0,0,-2,-1.98,0,0,-2,-1.98,0,2.966,2,1.98,0.99,2.966,0,0
437,1.99,0.01,1,0.99,0.98,0.0,0.0,1.99,0.99,0.99,-0.01,0.99,0.99,0,0,1,1,0.01,1,1,0,0,0,-1,-0.99,0,0,-1,-0.99,0,0.9833333333333333,1,0.99,0.99,0.9833333333333333,0,0
438,1.75,0.25,169,125.91,93.8,0.0,0.0,22.69,9.69,9.69,-3.31,9.69,9.69,0,0,13,13,3.31,13,13,0,0,0,-13,-9.69,0,0,-13,-9.69,0,68.02,13,9.69,0.7450002328308657,68.02,0,0
439,1.01,0.99,4,0.04,0.0,0.0,0.0,2.02,0.02,0.02,-1.98,0.02,0.02,0,0,2,2,1.98,2,2,0,0,0,-2,-0.02,0,0,-2,-0.02,0,0.029333333333333333,2,0.02,0.01,0.029333333333333333,0,0
440,1.99,0.01,1,0.99,0.98,0.0,0.0,1.99,0.99,0.99,-0.01,0.99,0.99,0,0,1,1,0.01,1,1,0,0,0,-1,-0.99,0,0,-1,-0.99,0,0.992,1,0.99,0.99,0.992,0,0
441,1.01,0.99,169,1.69,0.02,0.0,0.0,13.13,0.13,0.13,-12.87,0.13,0.13,0,0,13,13,12.87,13,13,0,0,0,-13,-0.13,0,0,-13,-0.13,0,0.9626666666666667,13,0.13,0.01,0.9626666666666667,0,0
442,1.99,0.01,4,3.96,3.92,49.5,39.6,3.98,26.98,21.98,-0.02,-23.02,-18.02,50,40,27,22,0.02,-23,-18,625,500,45,23,23.02,5,400,18,18.02,-5,28.334,2,1.98,0.99,3.3339999999999996,25,20
443,1.99,0.01,25,24.75,24.5,0.0,99.0,9.95,4.95,24.95,-0.05,4.95,-15.05,0,100,5,25,0.05,5,-15,0,0,20,-5,-4.95,-20,400,15,15.05,20,15.707333333333333,5,4.95,0.99,15.707333333333333,0,20
444,1.99,0.01,1,0.99,0.98,0.0,0.99,1.99,0.99,1.99,-0.01,0.99,-0.01,0,1,1,2,0.01,1,0,0,0,1,-1,-0.99,-1,1,0,0.01,1,1.0,1,0.99,0.99,1.0,0,1
445,1.01,0.99,1,0.01,0.0,0.0,0.2,1.01,0.01,20.01,-0.99,0.01,-19.99,0,20,1,21,0.99,1,-19,0,0,20,-1,-0.01,-20,400,19,19.99,20,19.835333333333335,1,0.01,0.01,19.835333333333335,0,20
446,1.99,0.01,625,618.75,612.56,618.75,495.0,49.75,49.75,44.75,-0.25,-0.25,4.75,625,500,50,45,0.25,0,5,625,500,45,0,0.25,5,400,-5,-4.75,-5,351.8113333333333,25,24.75,0.99,326.8113333333333,25,20
447,1.99,0.01,1,0.99,0.98,0.0,0.0,1.99,0.99,0.99,-0.01,0.99,0.99,0,0,1,1,0.01,1,1,0,0,0,-1,-0.99,0,0,-1,-0.99,0,0.9893333333333333,1,0.99,0.99,0.9893333333333333,0,0
448,1.99,0.01,1,0.99,0.98,0.0,19.8,1.99,0.99,20.99,-0.01,0.99,-19.01,0,20,1,21,0.01,1,-19,0,0,20,-1,-0.99,-20,400,19,19.01,20,1.2533333333333334,1,0.99,0.99,1.2533333333333334,0,20
449,1.99,0.01,625,618.75,612.56,0.0,495.0,49.75,24.75,44.75,-0.25,24.75,4.75,0,500,25,45,0.25,25,5,0,0,20,-25,-24.75,-20,400,-5,-4.75,20,326.886,25,24.75,0.99,326.886,0,20
450,1.99,0.01,625,618.75,612.56,618.75,0.0,49.75,49.75,24.75,-0.25,-0.25,24.75,625,0,50,25,0.25,0,25,625,0,25,0,0.25,25,0,-25,-24.75,-25,346.45466666666664,25,24.75,0.99,321.45466666666664,25,0
451,1.99,0.01,625,618.75,612.56,0.0,0.0,49.75,24.75,24.75,-0.25,24.75,24.75,0,0,25,25,0.25,25,25,0,0,0,-25,-24.75,0,0,-25,-24.75,0,321.8093333333333,25,24.75,0.99,321.8093333333333,0,0
452,1.99,0.01,625,618.75,612.56,618.75,0.0,49.75,49.75,24.75,-0.25,-0.25,24.75,625,0,50,25,0.25,0,25,625,0,25,0,0.25,25,0,-25,-24.75,-25,346.53266666666667,25,24.75,0.99,321.53266666666667,25,0
453,1.99,0.01,1,0.99,0.98,0.0,19.8,1.99,0.99,20.99,-0.01,0.99,-19.01,0,20,1,21,0.01,1,-19,0,0,20,-1,-0.99,-20,400,19,19.01,20,1.152,1,0.99,0.99,1.152,0,20
454,1.99,0.01,625,618.75,612.56,0.0,495.0,49.75,24.75,44.75,-0.25,24.75,4.75,0,500,25,45,0.25,25,5,0,0,20,-25,-24.75,-20,400,-5,-4.75,20,326.48466666666667,25,24.75,0.99,326.48466666666667,0,20
455,1.99,0.01,625,618.75,612.56,0.0,0.0,49.75,24.75,24.75,-0.25,24.75,24.75,0,0,25,25,0.25,25,25,0,0,0,-25,-24.75,0,0,-25,-24.75,0,322.1,25,24.75,0.99,322.1,0,0
456,1.99,0.01,1,0.99,0.98,0.0,19.8,1.99,0.99,20.99,-0.01,0.99,-19.01,0,20,1,21,0.01,1,-19,0,0,20,-1,-0.99,-20,400,19,19.01,20,1.1266666666666667,1,0.99,0.99,1.1266666666666667,0,20
457,1.99,0.01,625,618.75,612.56,0.0,495.0,49.75,24.75,44.75,-0.25,24.75,4.75,0,500,25,45,0.25,25,5,0,0,20,-25,-24.75,-20,400,-5,-4.75,20,326.8546666666667,25,24.75,0.99,326.8546666666667,0,20
458,1.99,0.01,1,0.99,0.98,0.0,0.99,1.99,0.99,1.99,-0.01,0.99,-0.01,0,1,1,2,0.01,1,0,0,0,1,-1,-0.99,-1,1,0,0.01,1,1.0,1,0.99,0.99,1.0,0,1
459,1.99,0.01,1,0.99,0.98,0.0,0.0,1.99,0.99,0.99,-0.01,0.99,0.99,0,0,1,1,0.01,1,1,0,0,0,-1,-0.99,0,0,-1,-0.99,0,0.9893333333333333,1,0.99,0.99,0.9893333333333333,0,0
460,1.01,0.99,1,0.01,0.0,0.24,0.25,1.01,24.01,25.01,-0.99,-23.99,-24.99,24,25,25,26,0.99,-23,-24,576,600,49,23,23.99,-1,625,24,24.99,1,48.76,1,0.01,0.01,24.759999999999998,24,25
461,1.99,0.01,4,3.96,3.92,0.0,0.0,3.98,1.98,1.98,-0.02,1.98,1.98,0,0,2,2,0.02,2,2,0,0,0,-2,-1.98,0,0,-2,-1.98,0,2.966,2,1.98,0.99,2.966,0,0
462,1.99,0.01,1,0.99,0.98,0.0,0.0,1.99,0.99,0.99,-0.01,0.99,0.99,0,0,1,1,0.01,1,1,0,0,0,-1,-0.99,0,0,-1,-0.99,0,0.9833333333333333,1,0.99,0.99,0.9833333333333333,0,0
463,1.75,0.25,169,125.91,93.8,0.0,0.0,22.69,9.69,9.69,-3.31,9.69,9.69,0,0,13,13,3.31,13,13,0,0,0,-13,-9.69,0,0,-13,-9.69,0,68.02,13,9.69,0.7450002328308657,68.02,0,0
464,1.01,0.99,4,0.04,0.0,0.0,0.0,2.02,0.02,0.02,-1.98,0.02,0.02,0,0,2,2,1.98,2,2,0,0,0,-2,-0.02,0,0,-2,-0.02,0,0.029333333333333333,2,0.02,0.01,0.029333333333333333,0,0
465,1.99,0.01,1,0.99,0.98,0.0,0.0,1.99,0.99,0.99,-0.01,0.99,0.99,0,0,1,1,0.01,1,1,0,0,0,-1,-0.99,0,0,-1,-0.99,0,0.992,1,0.99,0.99,0.992,0,0
466,1.01,0.99,169,1.69,0.02,0.0,0.0,13.13,0.13,0.13,-12.87,0.13,0.13,0,0,13,13,12.87,13,13,0,0,0,-13,-0.13,0,0,-13,-0.13,0,0.9626666666666667,13,0.13,0.01,0.9626666666666667,0,0
467,1.99,0.01,4,3.96,3.92,49.5,39.6,3.98,26.98,21.98,-0.02,-23.02,-18.02,50,40,27,22,0.02,-23,-18,625,500,45,23,23.02,5,400,18,18.02,-5,28.334,2,1.98,0.99,3.3339999999999996,25,20
468,1.99,0.01,25,24.75,24.5,0.0,99.0,9.95,4.95,24.95,-0.05,4.95,-15.05,0,100,5,25,0.05,5,-15,0,0,20,-5,-4.95,-20,400,15,15.05,20,15.707333333333333,5,4.95,0.99,15.707333333333333,0,20
469,1.99,0.01,1,0.99,0.98,0.0,0.99,1.99,0.99,1.99,-0.01,0.99,-0.01,0,1,1,2,0.01,1,0,0,0,1,-1,-0.99,-1,1,0,0.01,1,1.0,1,0.99,0.99,1.0,0,1
470,1.01,0.99,1,0.01,0.0,0.0,0.2,1.01,0.01,20.01,-0.99,0.01,-19.99,0,20,1,21,0.99,1,-19,0,0,20,-1,-0.01,-20,400,19,19.99,20,19.835333333333335,1,0.01,0.01,19.835333333333335,0,20
471,1.99,0.01,625,618.75,612.56,618.75,495.0,49.75,49.75,44.75,-0.25,-0.25,4.75,625,500,50,45,0.25,0,5,625,500,45,0,0.25,5,400,-5,-4.75,-5,351.8113333333333,25,24.75,0.99,326.8113333333333,25,20
472,1.99,0.01,1,0.99,0.98,0.0,0.0,1.99,0.99,0.99,-0.01,0.99,0.99,0,0,1,1,0.01,1,1,0,0,0,-1,-0.99,0,0,-1,-0.99,0,0.9893333333333333,1,0.99,0.99,0.9893333333333333,0,0
473,1.99,0.01,1,0.99,0.98,0.0,19.8,1.99,0.99,20.99,-0.01,0.99,-19.01,0,20,1,21,0.01,1,-19,0,0,20,-1,-0.99,-20,400,19,19.01,20,1.2533333333333334,1,0.99,0.99,1.2533333333333334,0,20
474,1.99,0.01,625,618.75,612.56,0.0,495.0,49.75,24.75,44.75,-0.25,24.75,4.75,0,500,25,45,0.25,25,5,0,0,20,-25,-24.75,-20,400,-5,-4.75,20,326.886,25,24.75,0.99,326.886,0,20
475,1.99,0.01,625,618.75,612.56,618.75,0.0,49.75,49.75,24.75,-0.25,-0.25,24.75,625,0,50,25,0.25,0,25,625,0,25,0,0.25,25,0,-25,-24.75,-25,346.45466666666664,25,24.75,0.99,321.45466666666664,25,0
476,1.99,0.01,625,618.75,612.56,0.0,0.0,49.75,24.75,24.75,-0.25,24.75,24.75,0,0,25,25,0.25,25,25,0,0,0,-25,-24.75,0,0,-25,-24.75,0,321.8093333333333,25,24.75,0.99,321.8093333333333,0,0
477,1.99,0.01,625,618.75,612.56,618.75,0.0,49.75,49.75,24.75,-0.25,-0.25,24.75,625,0,50,25,0.25,0,25,625,0,25,0,0.25,25,0,-25,-24.75,-25,346.53266666666667,25,24.75,0.99,321.53266666666667,25,0
478,1.99,0.01,1,0.99,0.98,0.0,19.8,1.99,0.99,20.99,-0.01,0.99,-19.01,0,20,1,21,0.01,1,-19,0,0,20,-1,-0.99,-20,400,19,19.01,20,1.152,1,0.99,0.99,1.152,0,20
479,1.99,0.01,625,618.75,612.56,0.0,495.0,49.75,24.75,44.75,-0.25,24.75,4.75,0,500,25,45,0.25,25,5,0,0,20,-25,-24.75,-20,400,-5,-4.75,20,326.48466666666667,25,24.75,0.99,326.48466666666667,0,20
480,1.99,0.01,625,618.75,612.56,0.0,0.0,49.75,24.75,24.75,-0.25,24.75,24.75,0,0,25,25,0.25,25,25,0,0,0,-25,-24.75,0,0,-25,-24.75,0,322.1,25,24.75,0.99,322.1,0,0
481,1.99,0.01,1,0.99,0.98,0.0,19.8,1.99,0.99,20.99,-0.01,0.99,-19.01,0,20,1,21,0.01,1,-19,0,0,20,-1,-0.99,-20,400,19,19.01,20,1.1266666666666667,1,0.99,0.99,1.1266666666666667,0,20
482,1.99,0.01,625,618.75,612.56,0.0,495.0,49.75,24.75,44.75,-0.25,24.75,4.75,0,500,25,45,0.25,25,5,0,0,20,-25,-24.75,-20,400,-5,-4.75,20,326.8546666666667,25,24.75,0.99,326.8546666666667,0,20
483,1.99,0.01,1,0.99,0.98,0.0,0.99,1.99,0.99,1.99,-0.01,0.99,-0.01,0,1,1,2,0.01,1,0,0,0,1,-1,-0.99,-1,1,0,0.01,1,1.0,1,0.99,0.99,1.0,0,1
484,1.99,0.01,1,0.99,0.98,0.0,0.0,1.99,0.99,0.99,-0.01,0.99,0.99,0,0,1,1,0.01,1,1,0,0,0,-1,-0.99,0,0,-1,-0.99,0,0.9893333333333333,1,0.99,0.99,0.9893333333333333,0,0
485,1.01,0.99,1,0.01,0.0,0.24,0.25,1.01,24.01,25.01,-0.99,-23.99,-24.99,24,25,25,26,0.99,-23,-24,576,600,49,23,23.99,-1,625,24,24.99,1,48.76,1,0.01,0.01,24.759999999999998,24,25
486,1.99,0.01,4,3.96,3.92,0.0,0.0,3.98,1.98,1.98,-0.02,1.98,1.98,0,0,2,2,0.02,2,2,0,0,0,-2,-1.98,0,0,-2,-1.98,0,2.966,2,1.98,0.99,2.966,0,0
487,1.99,0.01,1,0.99,0.98,0.0,0.0,1.99,0.99,0.99,-0.01,0.99,0.99,0,0,1,1,0.01,1,1,0,0,0,-1,-0.99,0,0,-1,-0.99,0,0.9833333333333333,1,0.99,0.99,0.9833333333333333,0,0
488,1.75,0.25,169,125.91,93.8,0.0,0.0,22.69,9.69,9.69,-3.31,9.69,9.69,0,0,13,13,3.31,13,13,0,0,0,-13,-9.69,0,0,-13,-9.69,0,68.02,13,9.69,0.7450002328308657,68.02,0,0
489,1.01,0.99,4,0.04,0.0,0.0,0.0,2.02,0.02,0.02,-1.98,0.02,0.02,0,0,2,2,1.98,2,2,0,0,0,-2,-0.02,0,0,-2,-0.02,0,0.029333333333333333,2,0.02,0.01,0.029333333333333333,0,0
490,1.99,0.01,1,0.99,0.98,0.0,0.0,1.99,0.99,0.99,-0.01,0.99,0.99,0,0,1,1,0.01,1,1,0,0,0,-1,-0.99,0,0,-1,-0.99,0,0.992,1,0.99,0.99,0.992,0,0
491,1.01,0.99,169,1.69,0.02,0.0,0.0,13.13,0.13,0.13,-12.87,0.13,0.13,0,0,13,13,12.87,13,13,0,0,0,-13,-0.13,0,0,-13,-0.13,0,0.9626666666666667,13,0.13,0.01,0.9626666666666667,0,0
492,1.99,0.01,4,3.96,3.92,49.5,39.6,3.98,26.98,21.98,-0.02,-23.02,-18.02,50,40,27,22,0.02,-23,-18,625,500,45,23,23.02,5,400,18,18.02,-5,28.334,2,1.98,0.99,3.3339999999999996,25,20
493,1.99,0.01,25,24.75,24.5,0.0,99.0,9.95,4.95,24.95,-0.05,4.95,-15.05,0,100,5,25,0.05,5,-15,0,0,20,-5,-4.95,-20,400,15,15.05,20,15.707333333333333,5,4.95,0.99,15.707333333333333,0,20
494,1.99,0.01,1,0.99,0.98,0.0,0.99,1.99,0.99,1.99,-0.01,0.99,-0.01,0,1,1,2,0.01,1,0,0,0,1,-1,-0.99,-1,1,0,0.01,1,1.0,1,0.99,0.99,1.0,0,1
495,1.01,0.99,1,0.01,0.0,0.0,0.2,1.01,0.01,20.01,-0.99,0.01,-19.99,0,20,1,21,0.99,1,-19,0,0,20,-1,-0.01,-20,400,19,19.99,20,19.835333333333335,1,0.01,0.01,19.835333333333335,0,20
496,1.99,0.01,625,618.75,612.56,618.75,495.0,49.75,49.75,44.75,-0.25,-0.25,4.75,625,500,50,45,0.25,0,5,625,500,45,0,0.25,5,400,-5,-4.75,-5,351.8113333333333,25,24.75,0.99,326.8113333333333,25,20
497,1.99,0.01,1,0.99,0.98,0.0,0.0,1.99,0.99,0.99,-0.01,0.99,0.99,0,0,1,1,0.01,1,1,0,0,0,-1,-0.99,0,0,-1,-0.99,0,0.9893333333333333,1,0.99,0.99,0.9893333333333333,0,0
498,1.99,0.01,1,0.99,0.98,0.0,19.8,1.99,0.99,20.99,-0.01,0.99,-19.01,0,20,1,21,0.01,1,-19,0,0,20,-1,-0.99,-20,400,19,19.01,20,1.2533333333333334,1,0.99,0.99,1.2533333333333334,0,20
499,1.99,0.01,625,618.75,612.56,0.0,495.0,49.75,24.75,44.75,-0.25,24.75,4.75,0,500,25,45,0.25,25,5,0,0,20,-25,-24.75,-20,400,-5,-4.75,20,326.886,25,24.75,0.99,326.886,0,20
500,1.99,0.01,625,618.75,612.56,618.75,0.0,49.75,49.75,24.75,-0.25,-0.25,24.75,625,0,50,25,0.25,0,25,625,0,25,0,0.25,25,0,-25,-24.75,-25,346.45466666666664,25,24.75,0.99,321.45466666666664,25,0
501,1.99,0.01,625,618.75,612.56,0.0,0.0,49.75,24.75,24.75,-0.25,24.75,24.75,0,0,25,25,0.25,25,25,0,0,0,-25,-24.75,0,0,-25,-24.75,0,321.8093333333333,25,24.75,0.99,321.8093333333333,0,0
502,1.99,0.01,625,618.75,612.56,618.75,0.0,49.75,49.75,24.75,-0.25,-0.25,24.75,625,0,50,25,0.25,0,25,625,0,25,0,0.25,25,0,-25,-24.75,-25,346.53266666666667,25,24.75,0.99,321.53266666666667,25,0
503,1.99,0.01,1,0.99,0.98,0.0,19.8,1.99,0.99,20.99,-0.01,0.99,-19.01,0,20,1,21,0.01,1,-19,0,0,20,-1,-0.99,-20,400,19,19.01,20,1.152,1,0.99,0.99,1.152,0,20
504,1.99,0.01,625,618.75,612.56,0.0,495.0,49.75,24.75,44.75,-0.25,24.75,4.75,0,500,25,45,0.25,25,5,0,0,20,-25,-24.75,-20,400,-5,-4.75,20,326.48466666666667,25,24.75,0.99,326.48466666666667,0,20
505,1.99,0.01,625,618.75,612.56,0.0,0.0,49.75,24.75,24.75,-0.25,24.75,24.75,0,0,25,25,0.25,25,25,0,0,0,-25,-24.75,0,0,-25,-24.75,0,322.1,25,24.75,0.99,322.1,0,0
506,1.99,0.01,1,0.99,0.98,0.0,19.8,1.99,0.99,20.99,-0.01,0.99,-19.01,0,20,1,21,0.01,1,-19,0,0,20,-1,-0.99,-20,400,19,19.01,20,1.1266666666666667,1,0.99,0.99,1.1266666666666667,0,20
507,1.99,0.01,625,618.75,612.56,0.0,495.0,49.75,24.75,44.75,-0.25,24.75,4.75,0,500,25,45,0.25,25,5,0,0,20,-25,-24.75,-20,400,-5,-4.75,20,326.8546666666667,25,24.75,0.99,326.8546666666667,0,20
508,1.99,0.01,1,0.99,0.98,0.0,0.99,1.99,0.99,1.99,-0.01,0.99,-0.01,0,1,1,2,0.01,1,0,0,0,1,-1,-0.99,-1,1,0,0.01,1,1.0,1,0.99,0.99,1.0,0,1
509,1.99,0.01,1,0.99,0.98,0.0,0.0,1.99,0.99,0.99,-0.01,0.99,0.99,0,0,1,1,0.01,1,1,0,0,0,-1,-0.99,0,0,-1,-0.99,0,0.9893333333333333,1,0.99,0.99,0.9893333333333333,0,0
510,1.01,0.99,1,0.01,0.0,0.24,0.25,1.01,24.01,25.01,-0.99,-23.99,-24.99,24,25,25,26,0.99,-23,-24,576,600,49,23,23.99,-1,625,24,24.99,1,48.76,1,0.01,0.01,24.759999999999998,24,25
511,1.99,0.01,4,3.96,3.92,0.0,0.0,3.98,1.98,1.98,-0.02,1.98,1.98,0,0,2,2,0.02,2,2,0,0,0,-2,-1.98,0,0,-2,-1.98,0,2.966,2,1.98,0.99,2.966,0,0
512,1.99,0.01,1,0.99,0.98,0.0,0.0,1.99,0.99,0.99,-0.01,0.99,0.99,0,0,1,1,0.01,1,1,0,0,0,-1,-0.99,0,0,-1,-0.99,0,0.9833333333333333,1,0.99,0.99,0.9833333333333333,0,0
513,1.75,0.25,169,125.91,93.8,0.0,0.0,22.69,9.69,9.69,-3.31,9.69,9.69,0,0,13,13,3.31,13,13,0,0,0,-13,-9.69,0,0,-13,-9.69,0,68.02,13,9.69,0.7450002328308657,68.02,0,0
514,1.01,0.99,4,0.04,0.0,0.0,0.0,2.02,0.02,0.02,-1.98,0.02,0.02,0,0,2,2,1.98,2,2,0,0,0,-2,-0.02,0,0,-2,-0.02,0,0.029333333333333333,2,0.02,0.01,0.029333333333333333,0,0
515,1.99,0.01,1,0.99,0.98,0.0,0.0,1.99,0.99,0.99,-0.01,0.99,0.99,0,0,1,1,0.01,1,1,0,0,0,-1,-0.99,0,0,-1,-0.99,0,0.992,1,0.99,0.99,0.992,0,0
516,1.01,0.99,169,1.69,0.02,0.0,0.0,13.13,0.13,0.13,-12.87,0.13,0.13,0,0,13,13,12.87,13,13,0,0,0,-13,-0.13,0,0,-13,-0.13,0,0.9626666666666667,13,0.13,0.01,0.9626666666666667,0,0
517,1.99,0.01,4,3.96,3.92,49.5,39.6,3.98,26.98,21.98,-0.02,-23.02,-18.02,50,40,27,22,0.02,-23,-18,625,500,45,23,23.02,5,400,18,18.02,-5,28.334,2,1.98,0.99,3.3339999999999996,25,20
518,1.99,0.01,25,24.75,24.5,0.0,99.0,9.95,4.95,24.95,-0.05,4.95,-15.05,0,100,5,25,0.05,5,-15,0,0,20,-5,-4.95,-20,400,15,15.05,20,15.707333333333333,5,4.95,0.99,15.707333333333333,0,20
519,1.99,0.01,1,0.99,0.98,0.0,0.99,1.99,0.99,1.99,-0.01,0.99,-0.01,0,1,1,2,0.01,1,0,0,0,1,-1,-0.99,-1,1,0,0.01,1,1.0,1,0.99,0.99,1.0,0,1
520,1.01,0.99,1,0.01,0.0,0.0,0.2,1.01,0.01,20.01,-0.99,0.01,-19.99,0,20,1,21,0.99,1,-19,0,0,20,-1,-0.01,-20,400,19,19.99,20,19.835333333333335,1,0.01,0.01,19.835333333333335,0,20
521,1.99,0.01,625,618.75,612.56,618.75,495.0,49.75,49.75,44.75,-0.25,-0.25,4.75,625,500,50,45,0.25,0,5,625,500,45,0,0.25,5,400,-5,-4.75,-5,351.8113333333333,25,24.75,0.99,326.8113333333333,25,20
522,1.99,0.01,1,0.99,0.98,0.0,0.0,1.99,0.99,0.99,-0.01,0.99,0.99,0,0,1,1,0.01,1,1,0,0,0,-1,-0.99,0,0,-1,-0.99,0,0.9893333333333333,1,0.99,0.99,0.9893333333333333,0,0
523,1.99,0.01,1,0.99,0.98,0.0,19.8,1.99,0.99,20.99,-0.01,0.99,-19.01,0,20,1,21,0.01,1,-19,0,0,20,-1,-0.99,-20,400,19,19.01,20,1.2533333333333334,1,0.99,0.99,1.2533333333333334,0,20
524,1.99,0.01,625,618.75,612.56,0.0,495.0,49.75,24.75,44.75,-0.25,24.75,4.75,0,500,25,45,0.25,25,5,0,0,20,-25,-24.75,-20,400,-5,-4.75,20,326.886,25,24.75,0.99,326.886,0,20
525,1.99,0.01,625,618.75,612.56,618.75,0.0,49.75,49.75,24.75,-0.25,-0.25,24.75,625,0,50,25,0.25,0,25,625,0,25,0,0.25,25,0,-25,-24.75,-25,346.45466666666664,25,24.75,0.99,321.45466666666664,25,0
526,1.99,0.01,625,618.75,612.56,0.0,0.0,49.75,24.75,24.75,-0.25,24.75,24.75,0,0,25,25,0.25,25,25,0,0,0,-25,-24.75,0,0,-25,-24.75,0,321.8093333333333,25,24.75,0.99,321.8093333333333,0,0
527,1.99,0.01,625,618.75,612.56,618.75,0.0,49.75,49.75,24.75,-0.25,-0.25,24.75,625,0,50,25,0.25,0,25,625,0,25,0,0.25,25,0,-25,-24.75,-25,346.53266666666667,25,24.75,0.99,321.53266666666667,25,0
528,1.99,0.01,1,0.99,0.98,0.0,19.8,1.99,0.99,20.99,-0.01,0.99,-19.01,0,20,1,21,0.01,1,-19,0,0,20,-1,-0.99,-20,400,19,19.01,20,1.152,1,0.99,0.99,1.152,0,20
529,1.99,0.01,625,618.75,612.56,0.0,495.0,49.75,24.75,44.75,-0.25,24.75,4.75,0,500,25,45,0.25,25,5,0,0,20,-25,-24.75,-20,400,-5,-4.75,20,326.48466666666667,25,24.75,0.99,326.48466666666667,0,20
530,1.99,0.01,625,618.75,612.56,0.0,0.0,49.75,24.75,24.75,-0.25,24.75,24.75,0,0,25,25,0.25,25,25,0,0,0,-25,-24.75,0,0,-25,-24.75,0,322.1,25,24.75,0.99,322.1,0,0
531,1.99,0.01,1,0.99,0.98,0.0,19.8,1.99,0.99,20.99,-0.01,0.99,-19.01,0,20,1,21,0.01,1,-19,0,0,20,-1,-0.99,-20,400,19,19.01,20,1.1266666666666667,1,0.99,0.99,1.1266666666666667,0,20
532,1.99,0.01,625,618.75,612.56,0.0,495.0,49.75,24.75,44.75,-0.25,24.75,4.75,0,500,25,45,0.25,25,5,0,0,20,-25,-24.75,-20,400,-5,-4.75,20,326.8546666666667,25,24.75,0.99,326.8546666666667,0,20
533,1.99,0.01,1,0.99,0.98,0.0,0.99,1.99,0.99,1.99,-0.01,0.99,-0.01,0,1,1,2,0.01,1,0,0,0,1,-1,-0.99,-1,1,0,0.01,1,1.0,1,0.99,0.99,1.0,0,1
534,1.99,0.01,1,0.99,0.98,0.0,0.0,1.99,0.99,0.99,-0.01,0.99,0.99,0,0,1,1,0.01,1,1,0,0,0,-1,-0.99,0,0,-1,-0.99,0,0.9893333333333333,1,0.99,0.99,0.9893333333333333,0,0
535,1.01,0.99,1,0.01,0.0,0.24,0.25,1.01,24.01,25.01,-0.99,-23.99,-24.99,24,25,25,26,0.99,-23,-24,576,600,49,23,23.99,-1,625,24,24.99,1,48.76,1,0.01,0.01,24.759999999999998,24,25
536,1.99,0.01,4,3.96,3.92,0.0,0.0,3.98,1.98,1.98,-0.02,1.98,1.98,0,0,2,2,0.02,2,2,0,0,0,-2,-1.98,0,0,-2,-1.98,0,2.966,2,1.98,0.99,2.966,0,0
537,1.99,0.01,1,0.99,0.98,0.0,0.0,1.99,0.99,0.99,-0.01,0.99,0.99,0,0,1,1,0.01,1,1,0,0,0,-1,-0.99,0,0,-1,-0.99,0,0.9833333333333333,1,0.99,0.99,0.9833333333333333,0,0
538,1.75,0.25,169,125.91,93.8,0.0,0.0,22.69,9.69,9.69,-3.31,9.69,9.69,0,0,13,13,3.31,13,13,0,0,0,-13,-9.69,0,0,-13,-9.69,0,68.02,13,9.69,0.7450002328308657,68.02,0,0
539,1.01,0.99,4,0.04,0.0,0.0,0.0,2.02,0.02,0.02,-1.98,0.02,0.02,0,0,2,2,1.98,2,2,0,0,0,-2,-0.02,0,0,-2,-0.02,0,0.029333333333333333,2,0.02,0.01,0.029333333333333333,0,0
540,1.99,0.01,1,0.99,0.98,0.0,0.0,1.99,0.99,0.99,-0.01,0.99,0.99,0,0,1,1,0.01,1,1,0,0,0,-1,-0.99,0,0,-1,-0.99,0,0.992,1,0.99,0.99,0.992,0,0
541,1.01,0.99,169,1.69,0.02,0.0,0.0,13.13,0.13,0.13,-12.87,0.13,0.13,0,0,13,13,12.87,13,13,0,0,0,-13,-0.13,0,0,-13,-0.13,0,0.9626666666666667,13,0.13,0.01,0.9626666666666667,0,0
542,1.99,0.01,4,3.96,3.92,49.5,39.6,3.98,26.98,21.98,-0.02,-23.02,-18.02,50,40,27,22,0.02,-23,-18,625,500,45,23,23.02,5,400,18,18.02,-5,28.334,2,1.98,0.99,3.3339999999999996,25,20
543,1.99,0.01,25,24.75,24.5,0.0,99.0,9.95,4.95,24.95,-0.05,4.95,-15.05,0,100,5,25,0.05,5,-15,0,0,20,-5,-4.95,-20,400,15,15.05,20,15.707333333333333,5,4.95,0.99,15.707333333333333,0,20
544,1.99,0.01,1,0.99,0.98,0.0,0.99,1.99,0.99,1.99,-0.01,0.99,-0.01,0,1,1,2,0.01,1,0,0,0,1,-1,-0.99,-1,1,0,0.01,1,1.0,1,0.99,0.99,1.0,0,1
545,1.01,0.99,1,0.01,0.0,0.0,0.2,1.01,0.01,20.01,-0.99,0.01,-19.99,0,20,1,21,0.99,1,-19,0,0,20,-1,-0.01,-20,400,19,19.99,20,19.835333333333335,1,0.01,0.01,19.835333333333335,0,20
546,1.99,0.01,625,618.75,612.56,618.75,495.0,49.75,49.75,44.75,-0.25,-0.25,4.75,625,500,50,45,0.25,0,5,625,500,45,0,0.25,5,400,-5,-4.75,-5,351.8113333333333,25,24.75,0.99,326.8113333333333,25,20
547,1.99,0.01,1,0.99,0.98,0.0,0.0,1.99,0.99,0.99,-0.01,0.99,0.99,0,0,1,1,0.01,1,1,0,0,0,-1,-0.99,0,0,-1,-0.99,0,0.9893333333333333,1,0.99,0.99,0.9893333333333333,0,0
548,1.99,0.01,1,0.99,0.98,0.0,19.8,1.99,0.99,20.99,-0.01,0.99,-19.01,0,20,1,21,0.01,1,-19,0,0,20,-1,-0.99,-20,400,19,19.01,20,1.2533333333333334,1,0.99,0.99,1.2533333333333334,0,20
549,1.99,0.01,625,618.75,612.56,0.0,495.0,49.75,24.75,44.75,-0.25,24.75,4.75,0,500,25,45,0.25,25,5,0,0,20,-25,-24.75,-20,400,-5,-4.75,20,326.886,25,24.75,0.99,326.886,0,20
550,1.99,0.01,625,618.75,612.56,618.75,0.0,49.75,49.75,24.75,-0.25,-0.25,24.75,625,0,50,25,0.25,0,25,625,0,25,0,0.25,25,0,-25,-24.75,-25,346.45466666666664,25,24.75,0.99,321.45466666666664,25,0
551,1.99,0.01,625,618.75,612.56,0.0,0.0,49.75,24.75,24.75,-0.25,24.75,24.75,0,0,25,25,0.25,25,25,0,0,0,-25,-24.75,0,0,-25,-24.75,0,321.8093333333333,25,24.75,0.99,321.8093333333333,0,0
552,1.99,0.01,625,618.75,612.56,618.75,0.0,49.75,49.75,24.75,-0.25,-0.25,24.75,625,0,50,25,0.25,0,25,625,0,25,0,0.25,25,0,-25,-24.75,-25,346.53266666666667,25,24.75,0.99,321.53266666666667,25,0
553,1.99,0.01,1,0.99,0.98,0.0,19.8,1.99,0.99,20.99,-0.01,0.99,-19.01,0,20,1,21,0.01,1,-19,0,0,20,-1,-0.99,-20,400,19,19.01,20,1.152,1,0.99,0.99,1.152,0,20
554,1.99,0.01,625,618.75,612.56,0.0,495.0,49.75,24.75,44.75,-0.25,24.75,4.75,0,500,25,45,0.25,25,5,0,0,20,-25,-24.75,-20,400,-5,-4.75,20,326.48466666666667,25,24.75,0.99,326.48466666666667,0,20
555,1.99,0.01,625,618.75,612.56,0.0,0.0,49.75,24.75,24.75,-0.25,24.75,24.75,0,0,25,25,0.25,25,25,0,0,0,-25,-24.75,0,0,-25,-24.75,0,322.1,25,24.75,0.99,322.1,0,0
556,1.99,0.01,1,0.99,0.98,0.0,19.8,1.99,0.99,20.99,-0.01,0.99,-19.01,0,20,1,21,0.01,1,-19,0,0,20,-1,-0.99,-20,400,19,19.01,20,1.1266666666666667,1,0.99,0.99,1.1266666666666667,0,20
557,1.99,0.01,625,618.75,612.56,0.0,495.0,49.75,24.75,44.75,-0.25,24.75,4.75,0,500,25,45,0.25,25,5,0,0,20,-25,-24.75,-20,400,-5,-4.75,20,326.8546666666667,25,24.75,0.99,326.8546666666667,0,20
558,1.99,0.01,1,0.99,0.98,0.0,0.99,1.99,0.99,1.99,-0.01,0.99,-0.01,0,1,1,2,0.01,1,0,0,0,1,-1,-0.99,-1,1,0,0.01,1,1.0,1,0.99,0.99,1.0,0,1
559,1.99,0.01,1,0.99,0.98,0.0,0.0,1.99,0.99,0.99,-0.01,0.99,0.99,0,0,1,1,0.01,1,1,0,0,0,-1,-0.99,0,0,-1,-0.99,0,0.9893333333333333,1,0.99,0.99,0.9893333333333333,0,0
560,1.01,0.99,1,0.01,0.0,0.24,0.25,1.01,24.01,25.01,-0.99,-23.99,-24.99,24,25,25,26,0.99,-23,-24,576,600,49,23,23.99,-1,625,24,24.99,1,48.76,1,0.01,0.01,24.759999999999998,24,25
561,1.99,0.01,4,3.96,3.92,0.0,0.0,3.98,1.98,1.98,-0.02,1.98,1.98,0,0,2,2,0.02,2,2,0,0,0,-2,-1.98,0,0,-2,-1.98,0,2.966,2,1.98,0.99,2.966,0,0
562,1.99,0.01,1,0.99,0.98,0.0,0.0,1.99,0.99,0.99,-0.01,0.99,0.99,0,0,1,1,0.01,1,1,0,0,0,-1,-0.99,0,0,-1,-0.99,0,0.9833333333333333,1,0.99,0.99,0.9833333333333333,0,0
563,1.75,0.25,169,125.91,93.8,0.0,0.0,22.69,9.69,9.69,-3.31,9.69,9.69,0,0,13,13,3.31,13,13,0,0,0,-13,-9.69,0,0,-13,-9.69,0,68.02,13,9.69,0.7450002328308657,68.02,0,0
564,1.01,0.99,4,0.04,0.0,0.0,0.0,2.02,0.02,0.02,-1.98,0.02,0.02,0,0,2,2,1.98,2,2,0,0,0,-2,-0.02,0,0,-2,-0.02,0,0.029333333333333333,2,0.02,0.01,0.029333333333333333,0,0
565,1.99,0.01,1,0.99,0.98,0.0,0.0,1.99,0.99,0.99,-0.01,0.99,0.99,0,0,1,1,0.01,1,1,0,0,0,-1,-0.99,0,0,-1,-0.99,0,0.992,1,0.99,0.99,0.992,0,0
566,1.01,0.99,169,1.69,0.02,0.0,0.0,13.13,0.13,0.13,-12.87,0.13,0.13,0,0,13,13,12.87,13,13,0,0,0,-13,-0.13,0,0,-13,-0.13,0,0.9626666666666667,13,0.13,0.01,0.9626666666666667,0,0
567,1.99,0.01,4,3.96,3.92,49.5,39.6,3.98,26.98,21.98,-0.02,-23.02,-18.02,50,40,27,22,0.02,-23,-18,625,500,45,23,23.02,5,400,18,18.02,-5,28.334,2,1.98,0.99,3.3339999999999996,25,20
568,1.99,0.01,25,24.75,24.5,0.0,99.0,9.95,4.95,24.95,-0.05,4.95,-15.05,0,100,5,25,0.05,5,-15,0,0,20,-5,-4.95,-20,400,15,15.05,20,15.707333333333333,5,4.95,0.99,15.707333333333333,0,20
569,1.99,0.01,1,0.99,0.98,0.0,0.99,1.99,0.99,1.99,-0.01,0.99,-0.01,0,1,1,2,0.01,1,0,0,0,1,-1,-0.99,-1,1,0,0.01,1,1.0,1,0.99,0.99,1.0,0,1
570,1.01,0.99,1,0.01,0.0,0.0,0.2,1.01,0.01,20.01,-0.99,0.01,-19.99,0,20,1,21,0.99,1,-19,0,0,20,-1,-0.01,-20,400,19,19.99,20,19.835333333333335,1,0.01,0.01,19.835333333333335,0,20
571,1.99,0.01,625,618.75,612.56,618.75,495.0,49.75,49.75,44.75,-0.25,-0.25,4.75,625,500,50,45,0.25,0,5,625,500,45,0,0.25,5,400,-5,-4.75,-5,351.8113333333333,25,24.75,0.99,326.8113333333333,25,20
572,1.99,0.01,1,0.99,0.98,0.0,0.0,1.99,0.99,0.99,-0.01,0.99,0.99,0,0,1,1,0.01,1,1,0,0,0,-1,-0.99,0,0,-1,-0.99,0,0.9893333333333333,1,0.99,0.99,0.9893333333333333,0,0
573,1.99,0.01,1,0.99,0.98,0.0,19.8,1.99,0.99,20.99,-0.01,0.99,-19.01,0,20,1,21,0.01,1,-19,0,0,20,-1,-0.99,-20,400,19,19.01,20,1.2533333333333334,1,0.99,0.99,1.2533333333333334,0,20
574,1.99,0.01,625,618.75,612.56,0.0,495.0,49.75,24.75,44.75,-0.25,24.75,4.75,0,500,25,45,0.25,25,5,0,0,20,-25,-24.75,-20,400,-5,-4.75,20,326.886,25,24.75,0.99,326.886,0,20
575,1.99,0.01,625,618.75,612.56,618.75,0.0,49.75,49.75,24.75,-0.25,-0.25,24.75,625,0,50,25,0.25,0,25,625,0,25,0,0.25,25,0,-25,-24.75,-25,346.45466666666664,25,24.75,0.99,321.45466666666664,25,0
576,1.99,0.01,625,618.75,612.56,0.0,0.0,49.75,24.75,24.75,-0.25,24.75,24.75,0,0,25,25,0.25,25,25,0,0,0,-25,-24.75,0,0,-25,-24.75,0,321.8093333333333,25,24.75,0.99,321.8093333333333,0,0
577,1.99,0.01,625,618.75,612.56,618.75,0.0,49.75,49.75,24.75,-0.25,-0.25,24.75,625,0,50,25,0.25,0,25,625,0,25,0,0.25,25,0,-25,-24.75,-25,346.53266666666667,25,24.75,0.99,321.53266666666667,25,0
578,1.99,0.01,1,0.99,0.98,0.0,19.8,1.99,0.99,20.99,-0.01,0.99,-19.01,0,20,1,21,0.01,1,-19,0,0,20,-1,-0.99,-20,400,19,19.01,20,1.152,1,0.99,0.99,1.152,0,20
579,1.99,0.01,625,618.75,612.56,0.0,495.0,49.75,24.75,44.75,-0.25,24.75,4.75,0,500,25,45,0.25,25,5,0,0,20,-25,-24.75,-20,400,-5,-4.75,20,326.48466666666667,25,24.75,0.99,326.48466666666667,0,20
580,1.99,0.01,625,618.75,612.56,0.0,0.0,49.75,24.75,24.75,-0.25,24.75,24.75,0,0,25,25,0.25,25,25,0,0,0,-25,-24.75,0,0,-25,-24.75,0,322.1,25,24.75,0.99,322.1,0,0
581,1.99,0.01,1,0.99,0.98,0.0,19.8,1.99,0.99,20.99,-0.01,0.99,-19.01,0,20,1,21,0.01,1,-19,0,0,20,-1,-0.99,-20,400,19,19.01,20,1.1266666666666667,1,0.99,0.99,1.1266666666666667,0,20
582,1.99,0.01,625,618.75,612.56,0.0,495.0,49.75,24.75,44.75,-0.25,24.75,4.75,0,500,25,45,0.25,25,5,0,0,20,-25,-24.75,-20,400,-5,-4.75,20,326.8546666666667,25,24.75,0.99,326.8546666666667,0,20
583,1.99,0.01,1,0.99,0.98,0.0,0.99,1.99,0.99,1.99,-0.01,0.99,-0.01,0,1,1,2,0.01,1,0,0,0,1,-1,-0.99,-1,1,0,0.01,1,1.0,1,0.99,0.99,1.0,0,1
584,1.99,0.01,1,0.99,0.98,0.0,0.0,1.99,0.99,0.99,-0.01,0.99,0.99,0,0,1,1,0.01,1,1,0,0,0,-1,-0.99,0,0,-1,-0.99,0,0.9893333333333333,1,0.99,0.99,0.9893333333333333,0,0
585,1.01,0.99,1,0.01,0.0,0.24,0.25,1.01,24.01,25.01,-0.99,-23.99,-24.99,24,25,25,26,0.99,-23,-24,576,600,49,23,23.99,-1,625,24,24.99,1,48.76,1,0.01,0.01,24.759999999999998,24,25
586,1.99,0.01,4,3.96,3.92,0.0,0.0,3.98,1.98,1.98,-0.02,1.98,1.98,0,0,2,2,0.02,2,2,0,0,0,-2,-1.98,0,0,-2,-1.98,0,2.966,2,1.98,0.99,2.966,0,0
587,1.99,0.01,1,0.99,0.98,0.0,0.0,1.99,0.99,0.99,-0.01,0.99,0.99,0,0,1,1,0.01,1,1,0,0,0,-1,-0.99,0,0,-1,-0.99,0,0.9833333333333333,1,0.99,0.99,0.9833333333333333,0,0
588,1.75,0.25,169,125.91,93.8,0.0,0.0,22.69,9.69,9.69,-3.31,9.69,9.69,0,0,13,13,3.31,13,13,0,0,0,-13,-9.69,0,0,-13,-9.69,0,68.02,13,9.69,0.7450002328308657,68.02,0,0
589,1.01,0.99,4,0.04,0.0,0.0,0.0,2.02,0.02,0.02,-1.98,0.02,0.02,0,0,2,2,1.98,2,2,0,0,0,-2,-0.02,0,0,-2,-0.02,0,0.029333333333333333,2,0.02,0.01,0.029333333333333333,0,0
590,1.99,0.01,1,0.99,0.98,0.0,0.0,1.99,0.99,0.99,-0.01,0.99,0.99,0,0,1,1,0.01,1,1,0,0,0,-1,-0.99,0,0,-1,-0.99,0,0.992,1,0.99,0.99,0.992,0,0
591,1.01,0.99,169,1.69,0.02,0.0,0.0,13.13,0.13,0.13,-12.87,0.13,0.13,0,0,13,13,12.87,13,13,0,0,0,-13,-0.13,0,0,-13,-0.13,0,0.9626666666666667,13,0.13,0.01,0.9626666666666667,0,0
592,1.99,0.01,4,3.96,3.92,49.5,39.6,3.98,26.98,21.98,-0.02,-23.02,-18.02,50,40,27,22,0.02,-23,-18,625,500,45,23,23.02,5,400,18,18.02,-5,28.334,2,1.98,0.99,3.3339999999999996,25,20
593,1.99,0.01,25,24.75,24.5,0.0,99.0,9.95,4.95,24.95,-0.05,4.95,-15.05,0,100,5,25,0.05,5,-15,0,0,20,-5,-4.95,-20,400,15,15.05,20,15.707333333333333,5,4.95,0.99,15.707333333333333,0,20
594,1.99,0.01,1,0.99,0.98,0.0,0.99,1.99,0.99,1.99,-0.01,0.99,-0.01,0,1,1,2,0.01,1,0,0,0,1,-1,-0.99,-1,1,0,0.01,1,1.0,1,0.99,0.99,1.0,0,1
595,1.01,0.99,1,0.01,0.0,0.0,0.2,1.01,0.01,20.01,-0.99,0.01,-19.99,0,20,1,21,0.99,1,-19,0,0,20,-1,-0.01,-20,400,19,19.99,20,19.835333333333335,1,0.01,0.01,19.835333333333335,0,20
596,1.99,0.01,625,618.75,612.56,618.75,495.0,49.75,49.75,44.75,-0.25,-0.25,4.75,625,500,50,45,0.25,0,5,625,500,45,0,0.25,5,400,-5,-4.75,-5,351.8113333333333,25,24.75,0.99,326.8113333333333,25,20
597,1.99,0.01,1,0.99,0.98,0.0,0.0,1.99,0.99,0.99,-0.01,0.99,0.99,0,0,1,1,0.01,1,1,0,0,0,-1,-0.99,0,0,-1,-0.99,0,0.9893333333333333,1,0.99,0.99,0.9893333333333333,0,0
598,1.99,0.01,1,0.99,0.98,0.0,19.8,1.99,0.99,20.99,-0.01,0.99,-19.01,0,20,1,21,0.01,1,-19,0,0,20,-1,-0.99,-20,400,19,19.01,20,1.2533333333333334,1,0.99,0.99,1.2533333333333334,0,20
599,1.99,0.01,625,618.75,612.56,0.0,495.0,49.75,24.75,44.75,-0.25,24.75,4.75,0,500,25,45,0.25,25,5,0,0,20,-25,-24.75,-20,400,-5,-4.75,20,326.886,25,24.75,0.99,326.886,0,20
600,1.99,0.01,625,618.75,612.56,618.75,0.0,49.75,49.75,24.75,-0.25,-0.25,24.75,625,0,50,25,0.25,0,25,625,0,25,0,0.25,25,0,-25,-24.75,-25,346.45466666666664,25,24.75,0.99,321.45466666666664,25,0
601,1.99,0.01,625,618.75,612.56,0.0,0.0,49.75,24.75,24.75,-0.25,24.75,24.75,0,0,25,25,0.25,25,25,0,0,0,-25,-24.75,0,0,-25,-24.75,0,321.8093333333333,25,24.75,0.99,321.8093333333333,0,0
602,1.99,0.01,625,618.75,612.56,618.75,0.0,49.75,49.75,24.75,-0.25,-0.25,24.75,625,0,50,25,0.25,0,25,625,0,25,0,0.25,25,0,-25,-24.75,-25,346.53266666666667,25,24.75,0.99,321.53266666666667,25,0
603,1.99,0.01,1,0.99,0.98,0.0,19.8,1.99,0.99,20.99,-0.01,0.99,-19.01,0,20,1,21,0.01,1,-19,0,0,20,-1,-0.99,-20,400,19,19.01,20,1.152,1,0.99,0.99,1.152,0,20
604,1.99,0.01,625,618.75,612.56,0.0,495.0,49.75,24.75,44.75,-0.25,24.75,4.75,0,500,25,45,0.25,25,5,0,0,20,-25,-24.75,-20,400,-5,-4.75,20,326.48466666666667,25,24.75,0.99,326.48466666666667,0,20
605,1.99,0.01,625,618.75,612.56,0.0,0.0,49.75,24.75,24.75,-0.25,24.75,24.75,0,0,25,25,0.25,25,25,0,0,0,-25,-24.75,0,0,-25,-24.75,0,322.1,25,24.75,0.99,322.1,0,0
606,1.99,0.01,1,0.99,0.98,0.0,19.8,1.99,0.99,20.99,-0.01,0.99,-19.01,0,20,1,21,0.01,1,-19,0,0,20,-1,-0.99,-20,400,19,19.01,20,1.1266666666666667,1,0.99,0.99,1.1266666666666667,0,20
607,1.99,0.01,625,618.75,612.56,0.0,495.0,49.75,24.75,44.75,-0.25,24.75,4.75,0,500,25,45,0.25,25,5,0,0,20,-25,-24.75,-20,400,-5,-4.75,20,326.8546666666667,25,24.75,0.99,326.8546666666667,0,20
608,1.99,0.01,1,0.99,0.98,0.0,0.99,1.99,0.99,1.99,-0.01,0.99,-0.01,0,1,1,2,0.01,1,0,0,0,1,-1,-0.99,-1,1,0,0.01,1,1.0,1,0.99,0.99,1.0,0,1
609,1.99,0.01,1,0.99,0.98,0.0,0.0,1.99,0.99,0.99,-0.01,0.99,0.99,0,0,1,1,0.01,1,1,0,0,0,-1,-0.99,0,0,-1,-0.99,0,0.9893333333333333,1,0.99,0.99,0.9893333333333333,0,0
610,1.01,0.99,1,0.01,0.0,0.24,0.25,1.01,24.01,25.01,-0.99,-23.99,-24.99,24,25,25,26,0.99,-23,-24,576,600,49,23,23.99,-1,625,24,24.99,1,48.76,1,0.01,0.01,24.759999999999998,24,25
611,1.99,0.01,4,3.96,3.92,0.0,0.0,3.98,1.98,1.98,-0.02,1.98,1.98,0,0,2,2,0.02,2,2,0,0,0,-2,-1.98,0,0,-2,-1.98,0,2.966,2,1.98,0.99,2.966,0,0
612,1.99,0.01,1,0.99,0.98,0.0,0.0,1.99,0.99,0.99,-0.01,0.99,0.99,0,0,1,1,0.01,1,1,0,0,0,-1,-0.99,0,0,-1,-0.99,0,0.9833333333333333,1,0.99,0.99,0.9833333333333333,0,0
613,1.75,0.25,169,125.91,93.8,0.0,0.0,22.69,9.69,9.69,-3.31,9.69,9.69,0,0,13,13,3.31,13,13,0,0,0,-13,-9.69,0,0,-13,-9.69,0,68.02,13,9.69,0.7450002328308657,68.02,0,0
614,1.01,0.99,4,0.04,0.0,0.0,0.0,2.02,0.02,0.02,-1.98,0.02,0.02,0,0,2,2,1.98,2,2,0,0,0,-2,-0.02,0,0,-2,-0.02,0,0.029333333333333333,2,0.02,0.01,0.029333333333333333,0,0
615,1.99,0.01,1,0.99,0.98,0.0,0.0,1.99,0.99,0.99,-0.01,0.99,0.99,0,0,1,1,0.01,1,1,0,0,0,-1,-0.99,0,0,-1,-0.99,0,0.992,1,0.99,0.99,0.992,0,0
616,1.01,0.99,169,1.69,0.02,0.0,0.0,13.13,0.13,0.13,-12.87,0.13,0.13,0,0,13,13,12.87,13,13,0,0,0,-13,-0.13,0,0,-13,-0.13,0,0.9626666666666667,13,0.13,0.01,0.9626666666666667,0,0
617,1.99,0.01,4,3.96,3.92,49.5,39.6,3.98,26.98,21.98,-0.02,-23.02,-18.02,50,40,27,22,0.02,-23,-18,625,500,45,23,23.02,5,400,18,18.02,-5,28.334,2,1.98,0.99,3.3339999999999996,25,20
618,1.99,0.01,25,24.75,24.5,0.0,99.0,9.95,4.95,24.95,-0.05,4.95,-15.05,0,100,5,25,0.05,5,-15,0,0,20,-5,-4.95,-20,400,15,15.05,20,15.707333333333333,5,4.95,0.99,15.707333333333333,0,20
619,1.99,0.01,1,0.99,0.98,0.0,0.99,1.99,0.99,1.99,-0.01,0.99,-0.01,0,1,1,2,0.01,1,0,0,0,1,-1,-0.99,-1,1,0,0.01,1,1.0,1,0.99,0.99,1.0,0,1
620,1.01,0.99,1,0.01,0.0,0.0,0.2,1.01,0.01,20.01,-0.99,0.01,-19.99,0,20,1,21,0.99,1,-19,0,0,20,-1,-0.01,-20,400,19,19.99,20,19.835333333333335,1,0.01,0.01,19.835333333333335,0,20
621,1.99,0.01,625,618.75,612.56,618.75,495.0,49.75,49.75,44.75,-0.25,-0.25,4.75,625,500,50,45,0.25,0,5,625,500,45,0,0.25,5,400,-5,-4.75,-5,351.8113333333333,25,24.75,0.99,326.8113333333333,25,20
622,1.99,0.01,1,0.99,0.98,0.0,0.0,1.99,0.99,0.99,-0.01,0.99,0.99,0,0,1,1,0.01,1,1,0,0,0,-1,-0.99,0,0,-1,-0.99,0,0.9893333333333333,1,0.99,0.99,0.9893333333333333,0,0
623,1.99,0.01,1,0.99,0.98,0.0,19.8,1.99,0.99,20.99,-0.01,0.99,-19.01,0,20,1,21,0.01,1,-19,0,0,20,-1,-0.99,-20,400,19,19.01,20,1.2533333333333334,1,0.99,0.99,1.2533333333333334,0,20
624,1.99,0.01,625,618.75,612.56,0.0,495.0,49.75,24.75,44.75,-0.25,24.75,4.75,0,500,25,45,0.25,25,5,0,0,20,-25,-24.75,-20,400,-5,-4.75,20,326.886,25,24.75,0.99,326.886,0,20
625,1.99,0.01,625,618.75,612.56,618.75,0.0,49.75,49.75,24.75,-0.25,-0.25,24.75,625,0,50,25,0.25,0,25,625,0,25,0,0.25,25,0,-25,-24.75,-25,346.45466666666664,25,24.75,0.99,321.45466666666664,25,0
626,1.99,0.01,625,618.75,612.56,0.0,0.0,49.75,24.75,24.75,-0.25,24.75,24.75,0,0,25,25,0.25,25,25,0,0,0,-25,-24.75,0,0,-25,-24.75,0,321.8093333333333,25,24.75,0.99,321.8093333333333,0,0
627,1.99,0.01,625,618.75,612.56,618.75,0.0,49.75,49.75,24.75,-0.25,-0.25,24.75,625,0,50,25,0.25,0,25,625,0,25,0,0.25,25,0,-25,-24.75,-25,346.53266666666667,25,24.75,0.99,321.53266666666667,25,0
628,1.99,0.01,1,0.99,0.98,0.0,19.8,1.99,0.99,20.99,-0.01,0.99,-19.01,0,20,1,21,0.01,1,-19,0,0,20,-1,-0.99,-20,400,19,19.01,20,1.152,1,0.99,0.99,1.152,0,20
629,1.99,0.01,625,618.75,612.56,0.0,495.0,49.75,24.75,44.75,-0.25,24.75,4.75,0,500,25,45,0.25,25,5,0,0,20,-25,-24.75,-20,400,-5,-4.75,20,326.48466666666667,25,24.75,0.99,326.48466666666667,0,20
630,1.99,0.01,625,618.75,612.56,0.0,0.0,49.75,24.75,24.75,-0.25,24.75,24.75,0,0,25,25,0.25,25,25,0,0,0,-25,-24.75,0,0,-25,-24.75,0,322.1,25,24.75,0.99,322.1,0,0
631,1.99,0.01,1,0.99,0.98,0.0,19.8,1.99,0.99,20.99,-0.01,0.99,-19.01,0,20,1,21,0.01,1,-19,0,0,20,-1,-0.99,-20,400,19,19.01,20,1.1266666666666667,1,0.99,0.99,1.1266666666666667,0,20
632,1.99,0.01,625,618.75,612.56,0.0,495.0,49.75,24.75,44.75,-0.25,24.75,4.75,0,500,25,45,0.25,25,5,0,0,20,-25,-24.75,-20,400,-5,-4.75,20,326.8546666666667,25,24.75,0.99,326.8546666666667,0,20
633,1.99,0.01,1,0.99,0.98,0.0,0.99,1.99,0.99,1.99,-0.01,0.99,-0.01,0,1,1,2,0.01,1,0,0,0,1,-1,-0.99,-1,1,0,0.01,1,1.0,1,0.99,0.99,1.0,0,1
634,1.99,0.01,1,0.99,0.98,0.0,0.0,1.99,0.99,0.99,-0.01,0.99,0.99,0,0,1,1,0.01,1,1,0,0,0,-1,-0.99,0,0,-1,-0.99,0,0.9893333333333333,1,0.99,0.99,0.9893333333333333,0,0
635,1.01,0.99,1,0.01,0.0,0.24,0.25,1.01,24.01,25.01,-0.99,-23.99,-24.99,24,25,25,26,0.99,-23,-24,576,600,49,23,23.99,-1,625,24,24.99,1,48.76,1,0.01,0.01,24.759999999999998,24,25
636,1.99,0.01,4,3.96,3.92,0.0,0.0,3.98,1.98,1.98,-0.02,1.98,1.98,0,0,2,2,0.02,2,2,0,0,0,-2,-1.98,0,0,-2,-1.98,0,2.966,2,1.98,0.99,2.966,0,0
637,1.99,0.01,1,0.99,0.98,0.0,0.0,1.99,0.99,0.99,-0.01,0.99,0.99,0,0,1,1,0.01,1,1,0,0,0,-1,-0.99,0,0,-1,-0.99,0,0.9833333333333333,1,0.99,0.99,0.9833333333333333,0,0
638,1.75,0.25,169,125.91,93.8,0.0,0.0,22.69,9.69,9.69,-3.31,9.69,9.69,0,0,13,13,3.31,13,13,0,0,0,-13,-9.69,0,0,-13,-9.69,0,68.02,13,9.69,0.7450002328308657,68.02,0,0
639,1.01,0.99,4,0.04,0.0,0.0,0.0,2.02,0.02,0.02,-1.98,0.02,0.02,0,0,2,2,1.98,2,2,0,0,0,-2,-0.02,0,0,-2,-0.02,0,0.029333333333333333,2,0.02,0.01,0.029333333333333333,0,0
640,1.99,0.01,1,0.99,0.98,0.0,0.0,1.99,0.99,0.99,-0.01,0.99,0.99,0,0,1,1,0.01,1,1,0,0,0,-1,-0.99,0,0,-1,-0.99,0,0.992,1,0.99,0.99,0.992,0,0
641,1.01,0.99,169,1.69,0.02,0.0,0.0,13.13,0.13,0.13,-12.87,0.13,0.13,0,0,13,13,12.87,13,13,0,0,0,-13,-0.13,0,0,-13,-0.13,0,0.9626666666666667,13,0.13,0.01,0.9626666666666667,0,0
642,1.99,0.01,4,3.96,3.92,49.5,39.6,3.98,26.98,21.98,-0.02,-23.02,-18.02,50,40,27,22,0.02,-23,-18,625,500,45,23,23.02,5,400,18,18.02,-5,28.334,2,1.98,0.99,3.3339999999999996,25,20
643,1.99,0.01,25,24.75,24.5,0.0,99.0,9.95,4.95,24.95,-0.05,4.95,-15.05,0,100,5,25,0.05,5,-15,0,0,20,-5,-4.95,-20,400,15,15.05,20,15.707333333333333,5,4.95,0.99,15.707333333333333,0,20
644,1.99,0.01,1,0.99,0.98,0.0,0.99,1.99,0.99,1.99,-0.01,0.99,-0.01,0,1,1,2,0.01,1,0,0,0,1,-1,-0.99,-1,1,0,0.01,1,1.0,1,0.99,0.99,1.0,0,1
645,1.01,0.99,1,0.01,0.0,0.0,0.2,1.01,0.01,20.01,-0.99,0.01,-19.99,0,20,1,21,0.99,1,-19,0,0,20,-1,-0.01,-20,400,19,19.99,20,19.835333333333335,1,0.01,0.01,19.835333333333335,0,20
646,1.99,0.01,625,618.75,612.56,618.75,495.0,49.75,49.75,44.75,-0.25,-0.25,4.75,625,500,50,45,0.25,0,5,625,500,45,0,0.25,5,400,-5,-4.75,-5,351.8113333333333,25,24.75,0.99,326.8113333333333,25,20
647,1.99,0.01,1,0.99,0.98,0.0,0.0,1.99,0.99,0.99,-0.01,0.99,0.99,0,0,1,1,0.01,1,1,0,0,0,-1,-0.99,0,0,-1,-0.99,0,0.9893333333333333,1,0.99,0.99,0.9893333333333333,0,0
648,1.99,0.01,1,0.99,0.98,0.0,19.8,1.99,0.99,20.99,-0.01,0.99,-19.01,0,20,1,21,0.01,1,-19,0,0,20,-1,-0.99,-20,400,19,19.01,20,1.2533333333333334,1,0.99,0.99,1.2533333333333334,0,20
649,1.99,0.01,625,618.75,612.56,0.0,495.0,49.75,24.75,44.75,-0.25,24.75,4.75,0,500,25,45,0.25,25,5,0,0,20,-25,-24.75,-20,400,-5,-4.75,20,326.886,25,24.75,0.99,326.886,0,20
650,1.99,0.01,625,618.75,612.56,618.75,0.0,49.75,49.75,24.75,-0.25,-0.25,24.75,625,0,50,25,0.25,0,25,625,0,25,0,0.25,25,0,-25,-24.75,-25,346.45466666666664,25,24.75,0.99,321.45466666666664,25,0
651,1.99,0.01,625,618.75,612.56,0.0,0.0,49.75,24.75,24.75,-0.25,24.75,24.75,0,0,25,25,0.25,25,25,0,0,0,-25,-24.75,0,0,-25,-24.75,0,321.8093333333333,25,24.75,0.99,321.8093333333333,0,0
652,1.99,0.01,625,618.75,612.56,618.75,0.0,49.75,49.75,24.75,-0.25,-0.25,24.75,625,0,50,25,0.25,0,25,625,0,25,0,0.25,25,0,-25,-24.75,-25,346.53266666666667,25,24.75,0.99,321.53266666666667,25,0
653,1.99,0.01,1,0.99,0.98,0.0,19.8,1.99,0.99,20.99,-0.01,0.99,-19.01,0,20,1,21,0.01,1,-19,0,0,20,-1,-0.99,-20,400,19,19.01,20,1.152,1,0.99,0.99,1.152,0,20
654,1.99,0.01,625,618.75,612.56,0.0,495.0,49.75,24.75,44.75,-0.25,24.75,4.75,0,500,25,45,0.25,25,5,0,0,20,-25,-24.75,-20,400,-5,-4.75,20,326.48466666666667,25,24.75,0.99,326.48466666666667,0,20
655,1.99,0.01,625,618.75,612.56,0.0,0.0,49.75,24.75,24.75,-0.25,24.75,24.75,0,0,25,25,0.25,25,25,0,0,0,-25,-24.75,0,0,-25,-24.75,0,322.1,25,24.75,0.99,322.1,0,0
656,1.99,0.01,1,0.99,0.98,0.0,19.8,1.99,0.99,20.99,-0.01,0.99,-19.01,0,20,1,21,0.01,1,-19,0,0,20,-1,-0.99,-20,400,19,19.01,20,1.1266666666666667,1,0.99,0.99,1.1266666666666667,0,20
657,1.99,0.01,625,618.75,612.56,0.0,495.0,49.75,24.75,44.75,-0.25,24.75,4.75,0,500,25,45,0.25,25,5,0,0,20,-25,-24.75,-20,400,-5,-4.75,20,326.8546666666667,25,24.75,0.99,326.8546666666667,0,20
658,1.99,0.01,1,0.99,0.98,0.0,0.99,1.99,0.99,1.99,-0.01,0.99,-0.01,0,1,1,2,0.01,1,0,0,0,1,-1,-0.99,-1,1,0,0.01,1,1.0,1,0.99,0.99,1.0,0,1
659,1.99,0.01,1,0.99,0.98,0.0,0.0,1.99,0.99,0.99,-0.01,0.99,0.99,0,0,1,1,0.01,1,1,0,0,0,-1,-0.99,0,0,-1,-0.99,0,0.9893333333333333,1,0.99,0.99,0.9893333333333333,0,0
660,1.01,0.99,1,0.01,0.0,0.24,0.25,1.01,24.01,25.01,-0.99,-23.99,-24.99,24,25,25,26,0.99,-23,-24,576,600,49,23,23.99,-1,625,24,24.99,1,48.76,1,0.01,0.01,24.759999999999998,24,25
661,1.99,0.01,4,3.96,3.92,0.0,0.0,3.98,1.98,1.98,-0.02,1.98,1.98,0,0,2,2,0.02,2,2,0,0,0,-2,-1.98,0,0,-2,-1.98,0,2.966,2,1.98,0.99,2.966,0,0
662,1.99,0.01,1,0.99,0.98,0.0,0.0,1.99,0.99,0.99,-0.01,0.99,0.99,0,0,1,1,0.01,1,1,0,0,0,-1,-0.99,0,0,-1,-0.99,0,0.9833333333333333,1,0.99,0.99,0.9833333333333333,0,0
663,1.75,0.25,169,125.91,93.8,0.0,0.0,22.69,9.69,9.69,-3.31,9.69,9.69,0,0,13,13,3.31,13,13,0,0,0,-13,-9.69,0,0,-13,-9.69,0,68.02,13,9.69,0.7450002328308657,68.02,0,0
664,1.01,0.99,4,0.04,0.0,0.0,0.0,2.02,0.02,0.02,-1.98,0.02,0.02,0,0,2,2,1.98,2,2,0,0,0,-2,-0.02,0,0,-2,-0.02,0,0.029333333333333333,2,0.02,0.01,0.029333333333333333,0,0
665,1.99,0.01,1,0.99,0.98,0.0,0.0,1.99,0.99,0.99,-0.01,0.99,0.99,0,0,1,1,0.01,1,1,0,0,0,-1,-0.99,0,0,-1,-0.99,0,0.992,1,0.99,0.99,0.992,0,0
666,1.01,0.99,169,1.69,0.02,0.0,0.0,13.13,0.13,0.13,-12.87,0.13,0.13,0,0,13,13,12.87,13,13,0,0,0,-13,-0.13,0,0,-13,-0.13,0,0.9626666666666667,13,0.13,0.01,0.9626666666666667,0,0
667,1.99,0.01,4,3.96,3.92,49.5,39.6,3.98,26.98,21.98,-0.02,-23.02,-18.02,50,40,27,22,0.02,-23,-18,625,500,45,23,23.02,5,400,18,18.02,-5,28.334,2,1.98,0.99,3.3339999999999996,25,20
668,1.99,0.01,25,24.75,24.5,0.0,99.0,9.95,4.95,24.95,-0.05,4.95,-15.05,0,100,5,25,0.05,5,-15,0,0,20,-5,-4.95,-20,400,15,15.05,20,15.707333333333333,5,4.95,0.99,15.707333333333333,0,20
669,1.99,0.01,1,0.99,0.98,0.0,0.99,1.99,0.99,1.99,-0.01,0.99,-0.01,0,1,1,2,0.01,1,0,0,0,1,-1,-0.99,-1,1,0,0.01,1,1.0,1,0.99,0.99,1.0,0,1
670,1.01,0.99,1,0.01,0.0,0.0,0.2,1.01,0.01,20.01,-0.99,0.01,-19.99,0,20,1,21,0.99,1,-19,0,0,20,-1,-0.01,-20,400,19,19.99,20,19.835333333333335,1,0.01,0.01,19.835333333333335,0,20
671,1.99,0.01,625,618.75,612.56,618.75,495.0,49.75,49.75,44.75,-0.25,-0.25,4.75,625,500,50,45,0.25,0,5,625,500,45,0,0.25,5,400,-5,-4.75,-5,351.8113333333333,25,24.75,0.99,326.8113333333333,25,20
672,1.99,0.01,1,0.99,0.98,0.0,0.0,1.99,0.99,0.99,-0.01,0.99,0.99,0,0,1,1,0.01,1,1,0,0,0,-1,-0.99,0,0,-1,-0.99,0,0.9893333333333333,1,0.99,0.99,0.9893333333333333,0,0
673,1.99,0.01,1,0.99,0.98,0.0,19.8,1.99,0.99,20.99,-0.01,0.99,-19.01,0,20,1,21,0.01,1,-19,0,0,20,-1,-0.99,-20,400,19,19.01,20,1.2533333333333334,1,0.99,0.99,1.2533333333333334,0,20
674,1.99,0.01,625,618.75,612.56,0.0,495.0,49.75,24.75,44.75,-0.25,24.75,4.75,0,500,25,45,0.25,25,5,0,0,20,-25,-24.75,-20,400,-5,-4.75,20,326.886,25,24.75,0.99,326.886,0,20
675,1.99,0.01,625,618.75,612.56,618.75,0.0,49.75,49.75,24.75,-0.25,-0.25,24.75,625,0,50,25,0.25,0,25,625,0,25,0,0.25,25,0,-25,-24.75,-25,346.45466666666664,25,24.75,0.99,321.45466666666664,25,0
676,1.99,0.01,625,618.75,612.56,0.0,0.0,49.75,24.75,24.75,-0.25,24.75,24.75,0,0,25,25,0.25,25,25,0,0,0,-25,-24.75,0,0,-25,-24.75,0,321.8093333333333,25,24.75,0.99,321.8093333333333,0,0
677,1.99,0.01,625,618.75,612.56,618.75,0.0,49.75,49.75,24.75,-0.25,-0.25,24.75,625,0,50,25,0.25,0,25,625,0,25,0,0.25,25,0,-25,-24.75,-25,346.53266666666667,25,24.75,0.99,321.53266666666667,25,0
678,1.99,0.01,1,0.99,0.98,0.0,19.8,1.99,0.99,20.99,-0.01,0.99,-19.01,0,20,1,21,0.01,1,-19,0,0,20,-1,-0.99,-20,400,19,19.01,20,1.152,1,0.99,0.99,1.152,0,20
679,1.99,0.01,625,618.75,612.56,0.0,495.0,49.75,24.75,44.75,-0.25,24.75,4.75,0,500,25,45,0.25,25,5,0,0,20,-25,-24.75,-20,400,-5,-4.75,20,326.48466666666667,25,24.75,0.99,326.48466666666667,0,20
680,1.99,0.01,625,618.75,612.56,0.0,0.0,49.75,24.75,24.75,-0.25,24.75,24.75,0,0,25,25,0.25,25,25,0,0,0,-25,-24.75,0,0,-25,-24.75,0,322.1,25,24.75,0.99,322.1,0,0
681,1.99,0.01,1,0.99,0.98,0.0,19.8,1.99,0.99,20.99,-0.01,0.99,-19.01,0,20,1,21,0.01,1,-19,0,0,20,-1,-0.99,-20,400,19,19.01,20,1.1266666666666667,1,0.99,0.99,1.1266666666666667,0,20
682,1.99,0.01,625,618.75,612.56,0.0,495.0,49.75,24.75,44.75,-0.25,24.75,4.75,0,500,25,45,0.25,25,5,0,0,20,-25,-24.75,-20,400,-5,-4.75,20,326.8546666666667,25,24.75,0.99,326.8546666666667,0,20
683,1.99,0.01,1,0.99,0.98,0.0,0.99,1.99,0.99,1.99,-0.01,0.99,-0.01,0,1,1,2,0.01,1,0,0,0,1,-1,-0.99,-1,1,0,0.01,1,1.0,1,0.99,0.99,1.0,0,1
684,1.99,0.01,1,0.99,0.98,0.0,0.0,1.99,0.99,0.99,-0.01,0.99,0.99,0,0,1,1,0.01,1,1,0,0,0,-1,-0.99,0,0,-1,-0.99,0,0.9893333333333333,1,0.99,0.99,0.9893333333333333,0,0
685,1.01,0.99,1,0.01,0.0,0.24,0.25,1.01,24.01,25.01,-0.99,-23.99,-24.99,24,25,25,26,0.99,-23,-24,576,600,49,23,23.99,-1,625,24,24.99,1,48.76,1,0.01,0.01,24.759999999999998,24,25
686,1.99,0.01,4,3.96,3.92,0.0,0.0,3.98,1.98,1.98,-0.02,1.98,1.98,0,0,2,2,0.02,2,2,0,0,0,-2,-1.98,0,0,-2,-1.98,0,2.966,2,1.98,0.99,2.966,0,0
687,1.99,0.01,1,0.99,0.98,0.0,0.0,1.99,0.99,0.99,-0.01,0.99,0.99,0,0,1,1,0.01,1,1,0,0,0,-1,-0.99,0,0,-1,-0.99,0,0.9833333333333333,1,0.99,0.99,0.9833333333333333,0,0
688,1.75,0.25,169,125.91,93.8,0.0,0.0,22.69,9.69,9.69,-3.31,9.69,9.69,0,0,13,13,3.31,13,13,0,0,0,-13,-9.69,0,0,-13,-9.69,0,68.02,13,9.69,0.7450002328308657,68.02,0,0
689,1.01,0.99,4,0.04,0.0,0.0,0.0,2.02,0.02,0.02,-1.98,0.02,0.02,0,0,2,2,1.98,2,2,0,0,0,-2,-0.02,0,0,-2,-0.02,0,0.029333333333333333,2,0.02,0.01,0.029333333333333333,0,0
690,1.99,0.01,1,0.99,0.98,0.0,0.0,1.99,0.99,0.99,-0.01,0.99,0.99,0,0,1,1,0.01,1,1,0,0,0,-1,-0.99,0,0,-1,-0.99,0,0.992,1,0.99,0.99,0.992,0,0
691,1.01,0.99,169,1.69,0.02,0.0,0.0,13.13,0.13,0.13,-12.87,0.13,0.13,0,0,13,13,12.87,13,13,0,0,0,-13,-0.13,0,0,-13,-0.13,0,0.9626666666666667,13,0.13,0.01,0.9626666666666667,0,0
692,1.99,0.01,4,3.96,3.92,49.5,39.6,3.98,26.98,21.98,-0.02,-23.02,-18.02,50,40,27,22,0.02,-23,-18,625,500,45,23,23.02,5,400,18,18.02,-5,28.334,2,1.98,0.99,3.3339999999999996,25,20
693,1.99,0.01,25,24.75,24.5,0.0,99.0,9.95,4.95,24.95,-0.05,4.95,-15.05,0,100,5,25,0.05,5,-15,0,0,20,-5,-4.95,-20,400,15,15.05,20,15.707333333333333,5,4.95,0.99,15.707333333333333,0,20
694,1.99,0.01,1,0.99,0.98,0.0,0.99,1.99,0.99,1.99,-0.01,0.99,-0.01,0,1,1,2,0.01,1,0,0,0,1,-1,-0.99,-1,1,0,0.01,1,1.0,1,0.99,0.99,1.0,0,1
695,1.01,0.99,1,0.01,0.0,0.0,0.2,1.01,0.01,20.01,-0.99,0.01,-19.99,0,20,1,21,0.99,1,-19,0,0,20,-1,-0.01,-20,400,19,19.99,20,19.835333333333335,1,0.01,0.01,19.835333333333335,0,20
696,1.99,0.01,625,618.75,612.56,618.75,495.0,49.75,49.75,44.75,-0.25,-0.25,4.75,625,500,50,45,0.25,0,5,625,500,45,0,0.25,5,400,-5,-4.75,-5,351.8113333333333,25,24.75,0.99,326.8113333333333,25,20
697,1.99,0.01,1,0.99,0.98,0.0,0.0,1.99,0.99,0.99,-0.01,0.99,0.99,0,0,1,1,0.01,1,1,0,0,0,-1,-0.99,0,0,-1,-0.99,0,0.9893333333333333,1,0.99,0.99,0.9893333333333333,0,0
698,1.99,0.01,1,0.99,0.98,0.0,19.8,1.99,0.99,20.99,-0.01,0.99,-19.01,0,20,1,21,0.01,1,-19,0,0,20,-1,-0.99,-20,400,19,19.01,20,1.2533333333333334,1,0.99,0.99,1.2533333333333334,0,20
699,1.99,0.01,625,618.75,612.56,0.0,495.0,49.75,24.75,44.75,-0.25,24.75,4.75,0,500,25,45,0.25,25,5,0,0,20,-25,-24.75,-20,400,-5,-4.75,20,326.886,25,24.75,0.99,326.886,0,20
700,1.99,0.01,625,618.75,612.56,618.75,0.0,49.75,49.75,24.75,-0.25,-0.25,24.75,625,0,50,25,0.25,0,25,625,0,25,0,0.25,25,0,-25,-24.75,-25,346.45466666666664,25,24.75,0.99,321.45466666666664,25,0
701,1.99,0.01,625,618.75,612.56,0.0,0.0,49.75,24.75,24.75,-0.25,24.75,24.75,0,0,25,25,0.25,25,25,0,0,0,-25,-24.75,0,0,-25,-24.75,0,321.8093333333333,25,24.75,0.99,321.8093333333333,0,0
702,1.99,0.01,625,618.75,612.56,618.75,0.0,49.75,49.75,24.75,-0.25,-0.25,24.75,625,0,50,25,0.25,0,25,625,0,25,0,0.25,25,0,-25,-24.75,-25,346.53266666666667,25,24.75,0.99,321.53266666666667,25,0
703,1.99,0.01,1,0.99,0.98,0.0,19.8,1.99,0.99,20.99,-0.01,0.99,-19.01,0,20,1,21,0.01,1,-19,0,0,20,-1,-0.99,-20,400,19,19.01,20,1.152,1,0.99,0.99,1.152,0,20
704,1.99,0.01,625,618.75,612.56,0.0,495.0,49.75,24.75,44.75,-0.25,24.75,4.75,0,500,25,45,0.25,25,5,0,0,20,-25,-24.75,-20,400,-5,-4.75,20,326.48466666666667,25,24.75,0.99,326.48466666666667,0,20
705,1.99,0.01,625,618.75,612.56,0.0,0.0,49.75,24.75,24.75,-0.25,24.75,24.75,0,0,25,25,0.25,25,25,0,0,0,-25,-24.75,0,0,-25,-24.75,0,322.1,25,24.75,0.99,322.1,0,0
706,1.99,0.01,1,0.99,0.98,0.0,19.8,1.99,0.99,20.99,-0.01,0.99,-19.01,0,20,1,21,0.01,1,-19,0,0,20,-1,-0.99,-20,400,19,19.01,20,1.1266666666666667,1,0.99,0.99,1.1266666666666667,0,20
707,1.99,0.01,625,618.75,612.56,0.0,495.0,49.75,24.75,44.75,-0.25,24.75,4.75,0,500,25,45,0.25,25,5,0,0,20,-25,-24.75,-20,400,-5,-4.75,20,326.8546666666667,25,24.75,0.99,326.8546666666667,0,20
708,1.99,0.01,1,0.99,0.98,0.0,0.99,1.99,0.99,1.99,-0.01,0.99,-0.01,0,1,1,2,0.01,1,0,0,0,1,-1,-0.99,-1,1,0,0.01,1,1.0,1,0.99,0.99,1.0,0,1
709,1.99,0.01,1,0.99,0.98,0.0,0.0,1.99,0.99,0.99,-0.01,0.99,0.99,0,0,1,1,0.01,1,1,0,0,0,-1,-0.99,0,0,-1,-0.99,0,0.9893333333333333,1,0.99,0.99,0.9893333333333333,0,0
710,1.01,0.99,1,0.01,0.0,0.24,0.25,1.01,24.01,25.01,-0.99,-23.99,-24.99,24,25,25,26,0.99,-23,-24,576,600,49,23,23.99,-1,625,24,24.99,1,48.76,1,0.01,0.01,24.759999999999998,24,25
711,1.99,0.01,4,3.96,3.92,0.0,0.0,3.98,1.98,1.98,-0.02,1.98,1.98,0,0,2,2,0.02,2,2,0,0,0,-2,-1.98,0,0,-2,-1.98,0,2.966,2,1.98,0.99,2.966,0,0
712,1.99,0.01,1,0.99,0.98,0.0,0.0,1.99,0.99,0.99,-0.01,0.99,0.99,0,0,1,1,0.01,1,1,0,0,0,-1,-0.99,0,0,-1,-0.99,0,0.9833333333333333,1,0.99,0.99,0.9833333333333333,0,0
713,1.75,0.25,169,125.91,93.8,0.0,0.0,22.69,9.69,9.69,-3.31,9.69,9.69,0,0,13,13,3.31,13,13,0,0,0,-13,-9.69,0,0,-13,-9.69,0,68.02,13,9.69,0.7450002328308657,68.02,0,0
714,1.01,0.99,4,0.04,0.0,0.0,0.0,2.02,0.02,0.02,-1.98,0.02,0.02,0,0,2,2,1.98,2,2,0,0,0,-2,-0.02,0,0,-2,-0.02,0,0.029333333333333333,2,0.02,0.01,0.029333333333333333,0,0
715,1.99,0.01,1,0.99,0.98,0.0,0.0,1.99,0.99,0.99,-0.01,0.99,0.99,0,0,1,1,0.01,1,1,0,0,0,-1,-0.99,0,0,-1,-0.99,0,0.992,1,0.99,0.99,0.992,0,0
716,1.01,0.99,169,1.69,0.02,0.0,0.0,13.13,0.13,0.13,-12.87,0.13,0.13,0,0,13,13,12.87,13,13,0,0,0,-13,-0.13,0,0,-13,-0.13,0,0.9626666666666667,13,0.13,0.01,0.9626666666666667,0,0
717,1.99,0.01,4,3.96,3.92,49.5,39.6,3.98,26.98,21.98,-0.02,-23.02,-18.02,50,40,27,22,0.02,-23,-18,625,500,45,23,23.02,5,400,18,18.02,-5,28.334,2,1.98,0.99,3.3339999999999996,25,20
718,1.99,0.01,25,24.75,24.5,0.0,99.0,9.95,4.95,24.95,-0.05,4.95,-15.05,0,100,5,25,0.05,5,-15,0,0,20,-5,-4.95,-20,400,15,15.05,20,15.707333333333333,5,4.95,0.99,15.707333333333333,0,20
719,1.99,0.01,1,0.99,0.98,0.0,0.99,1.99,0.99,1.99,-0.01,0.99,-0.01,0,1,1,2,0.01,1,0,0,0,1,-1,-0.99,-1,1,0,0.01,1,1.0,1,0.99,0.99,1.0,0,1
720,1.01,0.99,1,0.01,0.0,0.0,0.2,1.01,0.01,20.01,-0.99,0.01,-19.99,0,20,1,21,0.99,1,-19,0,0,20,-1,-0.01,-20,400,19,19.99,20,19.835333333333335,1,0.01,0.01,19.835333333333335,0,20
721,1.99,0.01,625,618.75,612.56,618.75,495.0,49.75,49.75,44.75,-0.25,-0.25,4.75,625,500,50,45,0.25,0,5,625,500,45,0,0.25,5,400,-5,-4.75,-5,351.8113333333333,25,24.75,0.99,326.8113333333333,25,20
722,1.99,0.01,1,0.99,0.98,0.0,0.0,1.99,0.99,0.99,-0.01,0.99,0.99,0,0,1,1,0.01,1,1,0,0,0,-1,-0.99,0,0,-1,-0.99,0,0.9893333333333333,1,0.99,0.99,0.9893333333333333,0,0
723,1.99,0.01,1,0.99,0.98,0.0,19.8,1.99,0.99,20.99,-0.01,0.99,-19.01,0,20,1,21,0.01,1,-19,0,0,20,-1,-0.99,-20,400,19,19.01,20,1.2533333333333334,1,0.99,0.99,1.2533333333333334,0,20
724,1.99,0.01,625,618.75,612.56,0.0,495.0,49.75,24.75,44.75,-0.25,24.75,4.75,0,500,25,45,0.25,25,5,0,0,20,-25,-24.75,-20,400,-5,-4.75,20,326.886,25,24.75,0.99,326.886,0,20
725,1.99,0.01,625,618.75,612.56,618.75,0.0,49.75,49.75,24.75,-0.25,-0.25,24.75,625,0,50,25,0.25,0,25,625,0,25,0,0.25,25,0,-25,-24.75,-25,346.45466666666664,25,24.75,0.99,321.45466666666664,25,0
726,1.99,0.01,625,618.75,612.56,0.0,0.0,49.75,24.75,24.75,-0.25,24.75,24.75,0,0,25,25,0.25,25,25,0,0,0,-25,-24.75,0,0,-25,-24.75,0,321.8093333333333,25,24.75,0.99,321.8093333333333,0,0
727,1.99,0.01,625,618.75,612.56,618.75,0.0,49.75,49.75,24.75,-0.25,-0.25,24.75,625,0,50,25,0.25,0,25,625,0,25,0,0.25,25,0,-25,-24.75,-25,346.53266666666667,25,24.75,0.99,321.53266666666667,25,0
728,1.99,0.01,1,0.99,0.98,0.0,19.8,1.99,0.99,20.99,-0.01,0.99,-19.01,0,20,1,21,0.01,1,-19,0,0,20,-1,-0.99,-20,400,19,19.01,20,1.152,1,0.99,0.99,1.152,0,20
729,1.99,0.01,625,618.75,612.56,0.0,495.0,49.75,24.75,44.75,-0.25,24.75,4.75,0,500,25,45,0.25,25,5,0,0,20,-25,-24.75,-20,400,-5,-4.75,20,326.48466666666667,25,24.75,0.99,326.48466666666667,0,20
730,1.99,0.01,625,618.75,612.56,0.0,0.0,49.75,24.75,24.75,-0.25,24.75,24.75,0,0,25,25,0.25,25,25,0,0,0,-25,-24.75,0,0,-25,-24.75,0,322.1,25,24.75,0.99,322.1,0,0
731,1.99,0.01,1,0.99,0.98,0.0,19.8,1.99,0.99,20.99,-0.01,0.99,-19.01,0,20,1,21,0.01,1,-19,0,0,20,-1,-0.99,-20,400,19,19.01,20,1.1266666666666667,1,0.99,0.99,1.1266666666666667,0,20
732,1.99,0.01,625,618.75,612.56,0.0,495.0,49.75,24.75,44.75,-0.25,24.75,4.75,0,500,25,45,0.25,25,5,0,0,20,-25,-24.75,-20,400,-5,-4.75,20,326.8546666666667,25,24.75,0.99,326.8546666666667,0,20
733,1.99,0.01,1,0.99,0.98,0.0,0.99,1.99,0.99,1.99,-0.01,0.99,-0.01,0,1,1,2,0.01,1,0,0,0,1,-1,-0.99,-1,1,0,0.01,1,1.0,1,0.99,0.99,1.0,0,1
734,1.99,0.01,1,0.99,0.98,0.0,0.0,1.99,0.99,0.99,-0.01,0.99,0.99,0,0,1,1,0.01,1,1,0,0,0,-1,-0.99,0,0,-1,-0.99,0,0.9893333333333333,1,0.99,0.99,0.9893333333333333,0,0
735,1.01,0.99,1,0.01,0.0,0.24,0.25,1.01,24.01,25.01,-0.99,-23.99,-24.99,24,25,25,26,0.99,-23,-24,576,600,49,23,23.99,-1,625,24,24.99,1,48.76,1,0.01,0.01,24.759999999999998,24,25
736,1.99,0.01,4,3.96,3.92,0.0,0.0,3.98,1.98,1.98,-0.02,1.98,1.98,0,0,2,2,0.02,2,2,0,0,0,-2,-1.98,0,0,-2,-1.98,0,2.966,2,1.98,0.99,2.966,0,0
737,1.99,0.01,1,0.99,0.98,0.0,0.0,1.99,0.99,0.99,-0.01,0.99,0.99,0,0,1,1,0.01,1,1,0,0,0,-1,-0.99,0,0,-1,-0.99,0,0.9833333333333333,1,0.99,0.99,0.9833333333333333,0,0
738,1.75,0.25,169,125.91,93.8,0.0,0.0,22.69,9.69,9.69,-3.31,9.69,9.69,0,0,13,13,3.31,13,13,0,0,0,-13,-9.69,0,0,-13,-9.69,0,68.02,13,9.69,0.7450002328308657,68.02,0,0
739,1.01,0.99,4,0.04,0.0,0.0,0.0,2.02,0.02,0.02,-1.98,0.02,0.02,0,0,2,2,1.98,2,2,0,0,0,-2,-0.02,0,0,-2,-0.02,0,0.029333333333333333,2,0.02,0.01,0.029333333333333333,0,0
740,1.99,0.01,1,0.99,0.98,0.0,0.0,1.99,0.99,0.99,-0.01,0.99,0.99,0,0,1,1,0.01,1,1,0,0,0,-1,-0.99,0,0,-1,-0.99,0,0.992,1,0.99,0.99,0.992,0,0
741,1.01,0.99,169,1.69,0.02,0.0,0.0,13.13,0.13,0.13,-12.87,0.13,0.13,0,0,13,13,12.87,13,13,0,0,0,-13,-0.13,0,0,-13,-0.13,0,0.9626666666666667,13,0.13,0.01,0.9626666666666667,0,0
742,1.99,0.01,4,3.96,3.92,49.5,39.6,3.98,26.98,21.98,-0.02,-23.02,-18.02,50,40,27,22,0.02,-23,-18,625,500,45,23,23.02,5,400,18,18.02,-5,28.334,2,1.98,0.99,3.3339999999999996,25,20
743,1.99,0.01,25,24.75,24.5,0.0,99.0,9.95,4.95,24.95,-0.05,4.95,-15.05,0,100,5,25,0.05,5,-15,0,0,20,-5,-4.95,-20,400,15,15.05,20,15.707333333333333,5,4.95,0.99,15.707333333333333,0,20
744,1.99,0.01,1,0.99,0.98,0.0,0.99,1.99,0.99,1.99,-0.01,0.99,-0.01,0,1,1,2,0.01,1,0,0,0,1,-1,-0.99,-1,1,0,0.01,1,1.0,1,0.99,0.99,1.0,0,1
745,1.01,0.99,1,0.01,0.0,0.0,0.2,1.01,0.01,20.01,-0.99,0.01,-19.99,0,20,1,21,0.99,1,-19,0,0,20,-1,-0.01,-20,400,19,19.99,20,19.835333333333335,1,0.01,0.01,19.835333333333335,0,20
746,1.99,0.01,625,618.75,612.56,618.75,495.0,49.75,49.75,44.75,-0.25,-0.25,4.75,625,500,50,45,0.25,0,5,625,500,45,0,0.25,5,400,-5,-4.75,-5,351.8113333333333,25,24.75,0.99,326.8113333333333,25,20
747,1.99,0.01,1,0.99,0.98,0.0,0.0,1.99,0.99,0.99,-0.01,0.99,0.99,0,0,1,1,0.01,1,1,0,0,0,-1,-0.99,0,0,-1,-0.99,0,0.9893333333333333,1,0.99,0.99,0.9893333333333333,0,0
748,1.99,0.01,1,0.99,0.98,0.0,19.8,1.99,0.99,20.99,-0.01,0.99,-19.01,0,20,1,21,0.01,1,-19,0,0,20,-1,-0.99,-20,400,19,19.01,20,1.2533333333333334,1,0.99,0.99,1.2533333333333334,0,20
749,1.99,0.01,625,618.75,612.56,0.0,495.0,49.75,24.75,44.75,-0.25,24.75,4.75,0,500,25,45,0.25,25,5,0,0,20,-25,-24.75,-20,400,-5,-4.75,20,326.886,25,24.75,0.99,326.886,0,20
0,1.15,0.85,4,0.6,0.09,3.9,0.9,2.3,13.3,3.3,-1.7,-12.7,-2.7,26,6,15,5,1.7,-11,-1,169,39,16,11,12.7,10,9,1,2.7,-10,18.564,2,0.3,0.15,5.564,13,3
1,1.56,0.44,324,181.44,101.61,161.28,131.04,28.08,26.08,23.08,-7.92,-5.92,-2.92,288,234,34,31,7.92,2,5,256,208,29,-2,5.92,3,169,-5,2.92,-3,214.782,18,10.08,0.56,198.782,16,13
2,1.29,0.71,256,74.24,21.53,41.76,4.64,20.64,13.64,5.64,-11.36,-4.36,3.64,144,16,25,17,11.36,7,15,81,9,10,-7,4.36,8,1,-15,-3.64,-8,59.572,16,4.64,0.29,50.572,9,1
3,1.2,0.8,169,33.8,6.76,49.4,23.4,15.6,21.6,11.6,-10.4,-16.4,-6.4,247,117,32,22,10.4,-6,4,361,171,28,6,16.4,10,81,-4,6.4,-10,130.55,13,2.6,0.2,111.55000000000001,19,9
4,1.56,0.44,256,143.36,80.28,152.32,0.0,24.96,25.96,8.96,-7.04,-8.04,8.96,272,0,33,16,7.04,-1,16,289,0,17,1,8.04,17,0,-16,-8.96,-17,92.02,16,8.96,0.56,75.02,17,0
5,1.21,0.79,100,21.0,4.41,16.8,14.7,12.1,10.1,9.1,-7.9,-5.9,-4.9,80,70,18,17,7.9,2,3,64,56,15,-2,5.9,1,49,-3,4.9,-1,74.684,10,2.1,0.21,66.684,8,7
6,1.28,0.72,196,54.88,15.37,47.04,50.96,17.92,15.92,16.92,-10.08,-8.08,-9.08,168,182,26,27,10.08,2,1,144,156,25,-2,8.08,-1,169,-1,9.08,1,172.622,14,3.92,0.28,160.622,12,13
7,1.57,0.43,256,145.92,83.17,82.08,118.56,25.12,18.12,22.12,-6.88,0.12,-3.88,144,208,25,29,6.88,7,3,81,117,22,-7,-0.12,-4,169,-3,3.88,4,174.858,16,9.12,0.57,165.858,9,13
8,1.3,0.7,324,97.2,29.16,108.0,81.0,23.4,25.4,20.4,-12.6,-14.6,-9.6,360,270,38,33,12.6,-2,3,400,300,35,2,14.6,5,225,-3,9.6,-5,260.226,18,5.4,0.3,240.226,20,15
9,1.91,0.09,400,364.0,331.24,254.8,309.4,38.2,32.2,35.2,-1.8,4.2,1.2,280,340,34,37,1.8,6,3,196,238,31,-6,-4.2,-3,289,-3,-1.2,3,235.97,20,18.2,0.91,221.97,14,17
10,1.11,0.89,49,5.39,0.59,9.24,6.93,7.77,12.77,9.77,-6.23,-11.23,-8.23,84,63,19,16,6.23,-5,-2,144,108,21,5,11.23,3,81,2,8.23,-3,71.152,7,0.77,0.11,59.152,12,9
11,1.36,0.64,144,51.84,18.66,60.48,60.48,16.32,18.32,18.32,-7.68,-9.68,-9.68,168,168,26,26,7.68,-2,-2,196,196,28,2,9.68,0,196,2,9.68,0,150.78,12,4.32,0.36,136.78,14,14
12,1.71,0.29,361,256.31,181.98,202.35,148.39,32.49,28.49,24.49,-5.51,-1.51,2.49,285,209,34,30,5.51,4,8,225,165,26,-4,1.51,4,121,-8,-2.49,-4,210.238,19,13.49,0.71,195.238,15,11
13,1.16,0.84,256,40.96,6.55,51.2,10.24,18.56,22.56,6.56,-13.44,-17.44,-1.44,320,64,36,20,13.44,-4,12,400,80,24,4,17.44,16,16,-12,1.44,-16,95.468,16,2.56,0.16,75.468,20,4
14,1.4,0.6,49,19.6,7.84,16.8,19.6,9.8,8.8,9.8,-4.2,-3.2,-4.2,42,49,13,14,4.2,1,0,36,42,13,-1,3.2,-1,49,0,4.2,1,46.646,7,2.8,0.4,40.646,6,7
15,1.78,0.22,49,38.22,29.81,27.3,103.74,12.46,10.46,24.46,-1.54,0.46,-13.54,35,133,12,26,1.54,2,-12,25,95,24,-2,-0.46,-14,361,12,13.54,14,54.998,7,5.46,0.78,49.998,5,19
16,1.64,0.36,49,31.36,20.07,85.12,4.48,11.48,23.48,5.48,-2.52,-14.52,3.48,133,7,26,8,2.52,-12,6,361,19,20,12,14.52,18,1,-6,-3.48,-18,39.446,7,4.48,0.64,20.445999999999998,19,1
17,1.22,0.78,16,3.52,0.77,17.6,17.6,4.88,20.88,20.88,-3.12,-19.12,-19.12,80,80,24,24,3.12,-16,-16,400,400,40,16,19.12,0,400,16,19.12,0,84.586,4,0.88,0.22,64.586,20,20
18,1.55,0.45,324,178.2,98.01,49.5,89.1,27.9,14.9,18.9,-8.1,4.9,0.9,90,162,23,27,8.1,13,9,25,45,14,-13,-4.9,-4,81,-9,-0.9,4,170.52,18,9.9,0.55,165.52,5,9
19,1.47,0.53,196,92.12,43.3,26.32,131.6,20.58,10.58,26.58,-7.42,2.58,-13.42,56,280,18,34,7.42,10,-6,16,80,24,-10,-2.58,-16,400,6,13.42,16,202.928,14,6.58,0.47,198.928,4,20
20,1.88,0.12,100,88.0,77.44,8.8,167.2,18.8,9.8,27.8,-1.2,7.8,-10.2,10,190,11,29,1.2,9,-9,1,19,20,-9,-7.8,-18,361,9,10.2,18,72.59,10,8.8,0.88,71.59,1,19
21,1.35,0.65,169,59.15,20.7,0.0,81.9,17.55,4.55,22.55,-8.45,4.55,-13.45,0,234,13,31,8.45,13,-5,0,0,18,-13,-4.55,-18,324,5,13.45,18,185.402,13,4.55,0.35,185.402,0,18
22,1.43,0.57,100,43.0,18.49,25.8,81.7,14.3,10.3,23.3,-5.7,-1.7,-14.7,60,190,16,29,5.7,4,-9,36,114,25,-4,1.7,-13,361,9,14.7,13,138.336,10,4.3,0.43,132.336,6,19
23,1.38,0.62,169,64.22,24.4,34.58,49.4,17.94,11.94,14.94,-8.06,-2.06,-5.06,91,130,20,23,8.06,6,3,49,70,17,-6,2.06,-3,100,-3,5.06,3,122.424,13,4.94,0.38,115.424,7,10
24,1.14,0.86,225,31.5,4.41,12.6,33.6,17.1,8.1,18.1,-12.9,-3.9,-13.9,90,240,21,31,12.9,9,-1,36,96,22,-9,3.9,-10,256,1,13.9,10,229.498,15,2.1,0.14,223.498,6,16
25,1.26,0.74,324,84.24,21.9,74.88,14.04,22.68,20.68,7.68,-13.32,-11.32,1.68,288,54,34,21,13.32,2,15,256,48,19,-2,11.32,13,9,-15,-1.68,-13,99.428,18,4.68,0.26,83.428,16,3
26,1.82,0.18,121,99.22,81.36,90.2,54.12,20.02,19.02,15.02,-1.98,-0.98,3.02,110,66,21,17,1.98,1,5,100,60,16,-1,0.98,4,36,-5,-3.02,-4,76.18,11,9.02,0.82,66.18,10,6
27,1.9,0.1,324,291.6,262.44,194.4,162.0,34.2,28.2,26.2,-1.8,4.2,6.2,216,180,30,28,1.8,6,8,144,120,22,-6,-4.2,2,100,-8,-6.2,-2,183.622,18,16.2,0.9,171.622,12,10
28,1.8,0.2,64,51.2,40.96,83.2,19.2,14.4,19.4,9.4,-1.6,-6.6,3.4,104,24,21,11,1.6,-5,5,169,39,16,5,6.6,10,9,-5,-3.4,-10,46.41,8,6.4,0.8,33.41,13,3
29,1.12,0.88,361,43.32,5.2,36.48,4.56,21.28,18.28,4.28,-16.72,-13.72,0.28,304,38,35,21,16.72,3,17,256,32,18,-3,13.72,14,4,-17,-0.28,-14,72.168,19,2.28,0.12,56.168000000000006,16,2
30,1.76,0.24,324,246.24,187.14,54.72,27.36,31.68,17.68,15.68,-4.32,9.68,11.68,72,36,22,20,4.32,14,16,16,8,6,-14,-9.68,2,4,-16,-11.68,-2,141.208,18,13.68,0.76,137.208,4,2
31,1.42,0.58,64,26.88,11.29,40.32,10.08,11.36,15.36,6.36,-4.64,-8.64,0.36,96,24,20,11,4.64,-4,5,144,36,15,4,8.64,9,9,-5,-0.36,-9,41.0,8,3.36,0.42,29.0,12,3
32,1.93,0.07,36,33.48,31.14,61.38,100.44,11.58,16.58,23.58,-0.42,-5.42,-12.42,66,108,17,24,0.42,-5,-12,121,198,29,5,5.42,-7,324,12,12.42,7,38.04,6,5.58,0.93,27.04,11,18
33,1.73,0.27,16,11.68,8.53,0.0,2.92,6.92,2.92,3.92,-1.08,2.92,1.92,0,4,4,5,1.08,4,3,0,0,1,-4,-2.92,-1,1,-3,-1.92,1,8.434,4,2.92,0.73,8.434,0,1
34,1.93,0.07,1,0.93,0.86,10.23,13.02,1.93,11.93,14.93,-0.07,-10.07,-13.07,11,14,12,15,0.07,-10,-13,121,154,25,10,10.07,-3,196,13,13.07,3,13.04,1,0.93,0.93,2.039999999999999,11,14
35,1.49,0.51,16,7.84,3.84,5.88,15.68,5.96,4.96,9.96,-2.04,-1.04,-6.04,12,32,7,12,2.04,1,-4,9,24,11,-1,1.04,-5,64,4,6.04,5,24.192,4,1.96,0.49,21.192,3,8
36,1.12,0.88,144,17.28,2.07,7.2,5.76,13.44,6.44,5.44,-10.56,-3.56,-2.56,60,48,17,16,10.56,7,8,25,20,9,-7,3.56,1,16,-8,2.56,-1,56.468,12,1.44,0.12,51.468,5,4
37,1.26,0.74,4,1.04,0.27,10.4,1.56,2.52,20.52,3.52,-1.48,-19.48,-2.48,40,6,22,5,1.48,-18,-1,400,60,23,18,19.48,17,9,1,2.48,-17,25.232,2,0.52,0.26,5.231999999999999,20,3
38,1.77,0.23,49,37.73,29.05,53.9,26.95,12.39,15.39,10.39,-1.61,-4.61,0.39,70,35,17,12,1.61,-3,2,100,50,15,3,4.61,5,25,-2,-0.39,-5,39.646,7,5.39,0.77,29.646,10,5
39,1.77,0.23,64,49.28,37.95,73.92,49.28,14.16,18.16,14.16,-1.84,-5.84,-1.84,96,64,20,16,1.84,-4,0,144,96,20,4,5.84,4,64,0,1.84,-4,54.296,8,6.16,0.77,42.296,12,8
40,1.46,0.54,16,7.36,3.39,16.56,22.08,5.84,10.84,13.84,-2.16,-7.16,-10.16,36,48,13,16,2.16,-5,-8,81,108,21,5,7.16,-3,144,8,10.16,3,38.48,4,1.84,0.46,29.479999999999997,9,12
41,1.56,0.44,256,143.36,80.28,89.6,26.88,24.96,18.96,11.96,-7.04,-1.04,5.96,160,48,26,19,7.04,6,13,100,30,13,-6,1.04,7,9,-13,-5.96,-7,107.236,16,8.96,0.56,97.236,10,3
42,1.57,0.43,196,111.72,63.68,0.0,119.7,21.98,7.98,22.98,-6.02,7.98,-7.02,0,210,14,29,6.02,14,-1,0,0,15,-14,-7.98,-15,225,1,7.02,15,150.056,14,7.98,0.57,150.056,0,15
43,1.28,0.72,64,17.92,5.02,11.2,42.56,10.24,7.24,21.24,-5.76,-2.76,-16.76,40,152,13,27,5.76,3,-11,25,95,24,-3,2.76,-14,361,11,16.76,14,124.126,8,2.24,0.28,119.126,5,19
44,1.49,0.51,49,24.01,11.76,58.31,27.44,10.43,20.43,11.43,-3.57,-13.57,-4.57,119,56,24,15,3.57,-10,-1,289,136,25,10,13.57,9,64,1,4.57,-9,59.526,7,3.43,0.49,42.526,17,8
45,1.63,0.37,9,5.67,3.57,34.02,1.89,4.89,19.89,2.89,-1.11,-16.11,0.89,54,3,21,4,1.11,-15,2,324,18,19,15,16.11,17,1,-2,-0.89,-17,22.878,3,1.89,0.63,4.878,18,1
46,1.55,0.45,49,26.95,14.82,3.85,34.65,10.85,4.85,12.85,-3.15,2.85,-5.15,7,63,8,16,3.15,6,-2,1,9,10,-6,-2.85,-8,81,2,5.15,8,44.462,7,3.85,0.55,43.462,1,9
