,(1+p),(1-p),(n*n),(n*p*n),(n*p*n*p),(n*p*x),(n*p*y),(n*p+n),(n*p+x),(n*p+y),(n*p-n),(n*p-x),(n*p-y),(n*x),(n*y),(n+x),(n+y),(n-n*p),(n-x),(n-y),(x*x),(x*y),(x+y),(x-n),(x-n*p),(x-y),(y*y),(y-n),(y-n*p),(y-x),expected_post,n,n*p,p,post-init,x,y
0,1.52,0.48,121,62.92,32.72,22.88,91.52,16.72,9.72,21.72,-5.28,1.72,-10.28,44,176,15,27,5.28,7,-5,16,64,20,-7,-1.72,-12,256,5,10.28,12,122.53,11,5.72,0.52,118.53,4,16
1,1.47,0.53,36,16.92,7.95,50.76,19.74,8.82,20.82,9.82,-3.18,-15.18,-4.18,108,42,24,13,3.18,-12,-1,324,126,25,12,15.18,11,49,1,4.18,-11,50.4,6,2.82,0.47,32.4,18,7
2,1.8,0.2,256,204.8,163.84,12.8,89.6,28.8,13.8,19.8,-3.2,11.8,5.8,16,112,17,23,3.2,15,9,1,7,8,-15,-11.8,-6,49,-9,-5.8,6,132.732,16,12.8,0.8,131.732,1,7
3,1.68,0.32,81,55.08,37.45,42.84,18.36,15.12,13.12,9.12,-2.88,-0.88,3.12,63,27,16,12,2.88,2,6,49,21,10,-2,0.88,4,9,-6,-3.12,-4,46.48,9,6.12,0.68,39.48,7,3
4,1.26,0.74,324,84.24,21.9,60.84,56.16,22.68,17.68,16.68,-13.32,-8.32,-7.32,234,216,31,30,13.32,5,6,169,156,25,-5,8.32,1,144,-6,7.32,-1,218.064,18,4.68,0.26,205.064,13,12
5,1.24,0.76,144,34.56,8.29,25.92,54.72,14.88,11.88,21.88,-9.12,-6.12,-16.12,108,228,21,31,9.12,3,-7,81,171,28,-3,6.12,-10,361,7,16.12,10,201.304,12,2.88,0.24,192.304,9,19
6,1.93,0.07,121,112.53,104.65,153.45,20.46,21.23,25.23,12.23,-0.77,-4.77,8.23,165,22,26,13,0.77,-4,9,225,30,17,4,4.77,13,4,-9,-8.23,-13,77.97,11,10.23,0.93,62.97,15,2
7,1.35,0.65,4,1.4,0.49,0.0,12.6,2.7,0.7,18.7,-1.3,0.7,-17.3,0,36,2,20,1.3,2,-16,0,0,18,-2,-0.7,-18,324,16,17.3,18,25.344,2,0.7,0.35,25.344,0,18
8,1.54,0.46,49,26.46,14.29,45.36,0.0,10.78,15.78,3.78,-3.22,-8.22,3.78,84,0,19,7,3.22,-5,7,144,0,12,5,8.22,12,0,-7,-3.78,-12,27.878,7,3.78,0.54,15.878,12,0
9,1.6,0.4,144,86.4,51.84,14.4,144.0,19.2,9.2,27.2,-4.8,5.2,-12.8,24,240,14,32,4.8,10,-8,4,40,22,-10,-5.2,-18,400,8,12.8,18,145.522,12,7.2,0.6,143.522,2,20
10,1.9,0.1,256,230.4,207.36,216.0,115.2,30.4,29.4,22.4,-1.6,-0.6,6.4,240,128,31,24,1.6,1,8,225,120,23,-1,0.6,7,64,-8,-6.4,-7,150.436,16,14.4,0.9,135.436,15,8
11,1.46,0.54,256,117.76,54.17,51.52,7.36,23.36,14.36,8.36,-8.64,0.36,6.36,112,16,23,17,8.64,9,15,49,7,8,-9,-0.36,6,1,-15,-6.36,-6,78.892,16,7.36,0.46,71.892,7,1
12,1.81,0.19,49,39.69,32.15,22.68,102.06,12.67,9.67,23.67,-1.33,1.67,-12.33,28,126,11,25,1.33,3,-11,16,72,22,-3,-1.67,-14,324,11,12.33,14,50.26,7,5.67,0.81,46.26,4,18
13,1.6,0.4,81,48.6,29.16,10.8,5.4,14.4,7.4,6.4,-3.6,3.4,4.4,18,9,11,10,3.6,7,8,4,2,3,-7,-3.4,1,1,-8,-4.4,-1,32.692,9,5.4,0.6,30.692,2,1
14,1.14,0.86,324,45.36,6.35,15.12,40.32,20.52,8.52,18.52,-15.48,-3.48,-13.48,108,288,24,34,15.48,12,2,36,96,22,-12,3.48,-10,256,-2,13.48,10,277.814,18,2.52,0.14,271.814,6,16
15,1.87,0.13,225,195.75,170.3,52.2,26.1,28.05,17.05,15.05,-1.95,9.05,11.05,60,30,19,17,1.95,11,13,16,8,6,-11,-9.05,2,4,-13,-11.05,-2,112.292,15,13.05,0.87,108.292,4,2
16,1.33,0.67,64,21.12,6.97,2.64,7.92,10.64,3.64,5.64,-5.36,1.64,-0.36,8,24,9,11,5.36,7,5,1,3,4,-7,-1.64,-2,9,-5,0.36,2,28.936,8,2.64,0.33,27.936,1,3
17,1.84,0.16,36,30.24,25.4,25.2,40.32,11.04,10.04,13.04,-0.96,0.04,-2.96,30,48,11,14,0.96,1,-2,25,40,13,-1,-0.04,-3,64,2,2.96,3,30.212,6,5.04,0.84,25.212,5,8
18,1.68,0.32,100,68.0,46.24,20.4,27.2,16.8,9.8,10.8,-3.2,3.8,2.8,30,40,13,14,3.2,7,6,9,12,7,-7,-3.8,-1,16,-6,-2.8,1,53.022,10,6.8,0.68,50.022,3,4
19,1.92,0.08,289,265.88,244.61,172.04,109.48,32.64,26.64,22.64,-1.36,4.64,8.64,187,119,28,24,1.36,6,10,121,77,18,-6,-4.64,4,49,-10,-8.64,-4,161.436,17,15.64,0.92,150.436,11,7
20,1.05,0.95,400,20.0,1.0,10.0,0.0,21.0,11.0,1.0,-19.0,-9.0,1.0,200,0,30,20,19.0,10,20,100,0,10,-10,9.0,10,0,-20,-1.0,-10,20.44,20,1.0,0.05,10.440000000000001,10,0
21,1.81,0.19,4,3.24,2.62,30.78,12.96,3.62,20.62,9.62,-0.38,-17.38,-6.38,38,16,21,10,0.38,-17,-6,361,152,27,17,17.38,11,64,6,6.38,-11,24.462,2,1.62,0.81,5.462,19,8
22,1.92,0.08,16,14.72,13.54,58.88,69.92,7.68,19.68,22.68,-0.32,-12.32,-15.32,64,76,20,23,0.32,-12,-15,256,304,35,12,12.32,-3,361,15,15.32,3,31.976,4,3.68,0.92,15.975999999999999,16,19
23,1.84,0.16,100,84.0,70.56,142.8,25.2,18.4,25.4,11.4,-1.6,-8.6,5.4,170,30,27,13,1.6,-7,7,289,51,20,7,8.6,14,9,-7,-5.4,-14,68.046,10,8.4,0.84,51.04600000000001,17,3
24,1.93,0.07,289,268.77,249.96,173.91,94.86,32.81,26.81,21.81,-1.19,4.81,9.81,187,102,28,23,1.19,6,11,121,66,17,-6,-4.81,5,36,-11,-9.81,-5,160.32,17,15.81,0.93,149.32,11,6
25,1.54,0.46,225,121.5,65.61,113.4,129.6,23.1,22.1,24.1,-6.9,-5.9,-7.9,210,240,29,31,6.9,1,-1,196,224,30,-1,5.9,-2,256,1,7.9,2,189.454,15,8.1,0.54,175.454,14,16
26,1.11,0.89,225,24.75,2.72,1.65,29.7,16.65,2.65,19.65,-13.35,0.65,-16.35,15,270,16,33,13.35,14,-3,1,18,19,-14,-0.65,-17,324,3,16.35,17,256.27,15,1.65,0.11,255.26999999999998,1,18
27,1.43,0.57,4,1.72,0.74,4.3,4.3,2.86,5.86,5.86,-1.14,-4.14,-4.14,10,10,7,7,1.14,-3,-3,25,25,10,3,4.14,0,25,3,4.14,0,12.048,2,0.86,0.43,7.048,5,5
28,1.82,0.18,289,236.98,194.32,125.46,55.76,30.94,22.94,17.94,-3.06,4.94,9.94,153,68,26,21,3.06,8,13,81,36,13,-8,-4.94,5,16,-13,-9.94,-5,147.006,17,13.94,0.82,138.006,9,4
29,1.71,0.29,1,0.71,0.5,4.26,12.07,1.71,6.71,17.71,-0.29,-5.29,-16.29,6,17,7,18,0.29,-5,-16,36,102,23,5,5.29,-11,289,16,16.29,11,12.024,1,0.71,0.71,6.023999999999999,6,17
30,1.69,0.31,36,24.84,17.14,62.1,49.68,10.14,19.14,16.14,-1.86,-10.86,-7.86,90,72,21,18,1.86,-9,-6,225,180,27,9,10.86,3,144,6,7.86,-3,51.324,6,4.14,0.69,36.324,15,12
31,1.64,0.36,169,108.16,69.22,158.08,8.32,21.32,27.32,9.32,-4.68,-10.68,7.32,247,13,32,14,4.68,-6,12,361,19,20,6,10.68,18,1,-12,-7.32,-18,82.182,13,8.32,0.64,63.182,19,1
32,1.33,0.67,121,39.93,13.18,54.45,43.56,14.63,18.63,15.63,-7.37,-11.37,-8.37,165,132,26,23,7.37,-4,-1,225,180,27,4,11.37,3,144,1,8.37,-3,124.998,11,3.63,0.33,109.998,15,12
33,1.76,0.24,25,19.0,14.44,34.2,60.8,8.8,12.8,19.8,-1.2,-5.2,-12.2,45,80,14,21,1.2,-4,-11,81,144,25,4,5.2,-7,256,11,12.2,7,39.786,5,3.8,0.76,30.786,9,16
34,1.33,0.67,289,95.37,31.47,56.1,5.61,22.61,15.61,6.61,-11.39,-4.39,4.61,170,17,27,18,11.39,7,16,100,10,11,-7,4.39,9,1,-16,-4.61,-9,72.834,17,5.61,0.33,62.834,10,1
35,1.75,0.25,196,147.0,110.25,0.0,189.0,24.5,10.5,28.5,-3.5,10.5,-7.5,0,252,14,32,3.5,14,-4,0,0,18,-14,-10.5,-18,324,4,7.5,18,142.834,14,10.5,0.75,142.834,0,18
36,1.21,0.79,1,0.21,0.04,3.78,1.47,1.21,18.21,7.21,-0.79,-17.79,-6.79,18,7,19,8,0.79,-17,-6,324,126,25,17,17.79,11,49,6,6.79,-11,23.764,1,0.21,0.21,5.763999999999999,18,7
37,1.1,0.9,9,0.9,0.09,2.7,2.1,3.3,9.3,7.3,-2.7,-8.7,-6.7,27,21,12,10,2.7,-6,-4,81,63,16,6,8.7,2,49,4,6.7,-2,28.484,3,0.3,0.1,19.484,9,7
38,1.05,0.95,49,2.45,0.12,2.8,4.55,7.35,8.35,13.35,-6.65,-7.65,-12.65,56,91,15,20,6.65,-1,-6,64,104,21,1,7.65,-5,169,6,12.65,5,95.866,7,0.35,0.05,87.866,8,13
39,1.14,0.86,9,1.26,0.18,2.52,6.3,3.42,6.42,15.42,-2.58,-5.58,-14.58,18,45,9,18,2.58,-3,-12,36,90,21,3,5.58,-9,225,12,14.58,9,45.844,3,0.42,0.14,39.844,6,15
40,1.76,0.24,196,148.96,113.21,0.0,95.76,24.64,10.64,19.64,-3.36,10.64,1.64,0,126,14,23,3.36,14,5,0,0,9,-14,-10.64,-9,81,-5,-1.64,9,110.606,14,10.64,0.76,110.606,0,9
41,1.08,0.92,100,8.0,0.64,12.8,5.6,10.8,16.8,7.8,-9.2,-15.2,-6.2,160,70,26,17,9.2,-6,3,256,112,23,6,15.2,9,49,-3,6.2,-9,84.584,10,0.8,0.08,68.584,16,7
42,1.21,0.79,289,60.69,12.74,21.42,17.85,20.57,9.57,8.57,-13.43,-2.43,-1.43,102,85,23,22,13.43,11,12,36,30,11,-11,2.43,1,25,-12,1.43,-1,105.28,17,3.57,0.21,99.28,6,5
43,1.45,0.55,16,7.2,3.24,7.2,9.0,5.8,5.8,6.8,-2.2,-2.2,-3.2,16,20,8,9,2.2,0,-1,16,20,9,0,2.2,-1,25,1,3.2,1,19.276,4,1.8,0.45,15.276,4,5
44,1.08,0.92,1,0.08,0.01,1.04,1.36,1.08,13.08,17.08,-0.92,-12.92,-16.92,13,17,14,18,0.92,-12,-16,169,221,30,12,12.92,-4,289,16,16.92,4,28.56,1,0.08,0.08,15.559999999999999,13,17
45,1.08,0.92,400,32.0,2.56,1.6,14.4,21.6,2.6,10.6,-18.4,0.6,-7.4,20,180,21,29,18.4,19,11,1,9,10,-19,-0.6,-8,81,-11,7.4,8,183.488,20,1.6,0.08,182.488,1,9
46,1.24,0.76,256,61.44,14.75,72.96,65.28,19.84,22.84,20.84,-12.16,-15.16,-13.16,304,272,35,33,12.16,-3,-1,361,323,36,3,15.16,2,289,1,13.16,-2,258.016,16,3.84,0.24,239.01600000000002,19,17
47,1.12,0.88,400,48.0,5.76,43.2,21.6,22.4,20.4,11.4,-17.6,-15.6,-6.6,360,180,38,29,17.6,2,11,324,162,27,-2,15.6,9,81,-11,6.6,-9,201.048,20,2.4,0.12,183.048,18,9
48,1.22,0.78,81,17.82,3.92,29.7,29.7,10.98,16.98,16.98,-7.02,-13.02,-13.02,135,135,24,24,7.02,-6,-6,225,225,30,6,13.02,0,225,6,13.02,0,129.704,9,1.98,0.22,114.70400000000001,15,15
49,1.76,0.24,361,274.36,208.51,187.72,187.72,33.44,27.44,27.44,-4.56,1.44,1.44,247,247,32,32,4.56,6,6,169,169,26,-6,-1.44,0,169,-6,-1.44,0,216.222,19,14.44,0.76,203.222,13,13
50,1.61,0.39,121,73.81,45.02,107.36,134.2,17.71,22.71,26.71,-4.29,-9.29,-13.29,176,220,27,31,4.29,-5,-9,256,320,36,5,9.29,-4,400,9,13.29,4,142.508,11,6.71,0.61,126.50800000000001,16,20
51,1.9,0.1,289,260.1,234.09,15.3,229.5,32.3,16.3,30.3,-1.7,14.3,0.3,17,255,18,32,1.7,16,2,1,15,16,-16,-14.3,-14,225,-2,-0.3,14,164.04,17,15.3,0.9,163.04,1,15
52,1.57,0.43,64,36.48,20.79,77.52,27.36,12.56,21.56,10.56,-3.44,-12.44,-1.44,136,48,25,14,3.44,-9,2,289,102,23,9,12.44,11,36,-2,1.44,-11,58.434,8,4.56,0.57,41.434,17,6
53,1.58,0.42,361,209.38,121.44,176.32,165.3,30.02,27.02,26.02,-7.98,-4.98,-3.98,304,285,35,34,7.98,3,4,256,240,31,-3,4.98,1,225,-4,3.98,-1,246.168,19,11.02,0.58,230.168,16,15
54,1.57,0.43,361,205.77,117.29,151.62,151.62,29.83,24.83,24.83,-8.17,-3.17,-3.17,266,266,33,33,8.17,5,5,196,196,28,-5,3.17,0,196,-5,3.17,0,237.654,19,10.83,0.57,223.654,14,14
55,1.38,0.62,144,54.72,20.79,31.92,68.4,16.56,11.56,19.56,-7.44,-2.44,-10.44,84,180,19,27,7.44,5,-3,49,105,22,-5,2.44,-8,225,3,10.44,8,147.822,12,4.56,0.38,140.822,7,15
56,1.36,0.64,361,129.96,46.79,136.8,75.24,25.84,26.84,17.84,-12.16,-13.16,-4.16,380,209,39,30,12.16,-1,8,400,220,31,1,13.16,9,121,-8,4.16,-9,222.752,19,6.84,0.36,202.752,20,11
57,1.44,0.56,121,53.24,23.43,43.56,67.76,15.84,13.84,18.84,-6.16,-4.16,-9.16,99,154,20,25,6.16,2,-3,81,126,23,-2,4.16,-5,196,3,9.16,5,124.248,11,4.84,0.44,115.248,9,14
58,1.34,0.66,196,66.64,22.66,42.84,90.44,18.76,13.76,23.76,-9.24,-4.24,-14.24,126,266,23,33,9.24,5,-5,81,171,28,-5,4.24,-10,361,5,14.24,10,219.458,14,4.76,0.34,210.458,9,19
59,1.36,0.64,324,116.64,41.99,64.8,0.0,24.48,16.48,6.48,-11.52,-3.52,6.48,180,0,28,18,11.52,8,18,100,0,10,-8,3.52,10,0,-18,-6.48,-10,70.44,18,6.48,0.36,60.44,10,0
60,1.23,0.77,4,0.92,0.21,5.98,1.84,2.46,13.46,4.46,-1.54,-12.54,-3.54,26,8,15,6,1.54,-11,-2,169,52,17,11,12.54,9,16,2,3.54,-9,19.774,2,0.46,0.23,6.774000000000001,13,4
61,1.08,0.92,256,20.48,1.64,3.84,6.4,17.28,4.28,6.28,-14.72,-1.72,-3.72,48,80,19,21,14.72,13,11,9,15,8,-13,1.72,-2,25,-11,3.72,2,87.464,16,1.28,0.08,84.464,3,5
62,1.72,0.28,64,46.08,33.18,92.16,34.56,13.76,21.76,11.76,-2.24,-10.24,-0.24,128,48,24,14,2.24,-8,2,256,96,22,8,10.24,10,36,-2,0.24,-10,55.388,8,5.76,0.72,39.388,16,6
63,1.5,0.5,196,98.0,49.0,7.0,98.0,21.0,8.0,21.0,-7.0,6.0,-7.0,14,196,15,28,7.0,13,0,1,14,15,-13,-6.0,-13,196,0,7.0,13,150.858,14,7.0,0.5,149.858,1,14
64,1.85,0.15,121,102.85,87.42,168.3,65.45,20.35,27.35,16.35,-1.65,-8.65,2.35,198,77,29,18,1.65,-7,4,324,126,25,7,8.65,11,49,-4,-2.35,-11,85.282,11,9.35,0.85,67.282,18,7
65,1.34,0.66,81,27.54,9.36,45.9,52.02,12.06,18.06,20.06,-5.94,-11.94,-13.94,135,153,24,26,5.94,-6,-8,225,255,32,6,11.94,-2,289,8,13.94,2,130.266,9,3.06,0.34,115.26599999999999,15,17
66,1.63,0.37,169,106.47,67.08,16.38,40.95,21.19,10.19,13.19,-4.81,6.19,3.19,26,65,15,18,4.81,11,8,4,10,7,-11,-6.19,-3,25,-8,-3.19,3,83.626,13,8.19,0.63,81.626,2,5
67,1.11,0.89,400,44.0,4.84,24.2,19.8,22.2,13.2,11.2,-17.8,-8.8,-6.8,220,180,31,29,17.8,9,11,121,99,20,-9,8.8,2,81,-11,6.8,-2,194.386,20,2.2,0.11,183.386,11,9
68,1.21,0.79,400,84.0,17.64,21.0,58.8,24.2,9.2,18.2,-15.8,-0.8,-9.8,100,280,25,34,15.8,15,6,25,70,19,-15,0.8,-9,196,-6,9.8,9,269.994,20,4.2,0.21,264.994,5,14
69,1.46,0.54,324,149.04,68.56,49.68,66.24,26.28,14.28,16.28,-9.72,2.28,0.28,108,144,24,26,9.72,12,10,36,48,14,-12,-2.28,-2,64,-10,-0.28,2,162.966,18,8.28,0.46,156.966,6,8
70,1.49,0.51,36,17.64,8.64,49.98,5.88,8.94,19.94,4.94,-3.06,-14.06,0.94,102,12,23,8,3.06,-11,4,289,34,19,11,14.06,15,4,-4,-0.94,-15,33.218,6,2.94,0.49,16.218000000000004,17,2
71,1.18,0.82,16,2.88,0.52,0.72,1.44,4.72,1.72,2.72,-3.28,-0.28,-1.28,4,8,5,6,3.28,3,2,1,2,3,-3,0.28,-1,4,-2,1.28,1,9.394,4,0.72,0.18,8.394,1,2
72,1.1,0.9,121,12.1,1.21,16.5,7.7,12.1,16.1,8.1,-9.9,-13.9,-5.9,165,77,26,18,9.9,-4,4,225,105,22,4,13.9,8,49,-4,5.9,-8,90.97,11,1.1,0.1,75.97,15,7
73,1.53,0.47,256,135.68,71.91,59.36,110.24,24.48,15.48,21.48,-7.52,1.48,-4.52,112,208,23,29,7.52,9,3,49,91,20,-9,-1.48,-6,169,-3,4.52,6,175.918,16,8.48,0.53,168.918,7,13
74,1.3,0.7,4,1.2,0.36,7.2,8.4,2.6,12.6,14.6,-1.4,-11.4,-13.4,24,28,14,16,1.4,-10,-12,144,168,26,10,11.4,-2,196,12,13.4,2,32.244,2,0.6,0.3,20.244,12,14
75,1.88,0.12,4,3.52,3.1,19.36,24.64,3.76,12.76,15.76,-0.24,-9.24,-12.24,22,28,13,16,0.24,-9,-12,121,154,25,9,9.24,-3,196,12,12.24,3,16.738,2,1.76,0.88,5.7379999999999995,11,14
76,1.73,0.27,324,236.52,172.66,262.8,91.98,31.14,33.14,20.14,-4.86,-6.86,6.14,360,126,38,25,4.86,-2,11,400,140,27,2,6.86,13,49,-11,-6.14,-13,177.722,18,13.14,0.73,157.722,20,7
77,1.89,0.11,144,128.16,114.06,10.68,74.76,22.68,11.68,17.68,-1.32,9.68,3.68,12,84,13,19,1.32,11,5,1,7,8,-11,-9.68,-6,49,-5,-3.68,6,79.814,12,10.68,0.89,78.814,1,7
78,1.77,0.23,361,277.97,214.04,117.04,131.67,33.63,22.63,23.63,-4.37,6.63,5.63,152,171,27,28,4.37,11,10,64,72,17,-11,-6.63,-1,81,-10,-5.63,1,193.292,19,14.63,0.77,185.292,8,9
79,1.68,0.32,81,55.08,37.45,36.72,36.72,15.12,12.12,12.12,-2.88,0.12,0.12,54,54,15,15,2.88,3,3,36,36,12,-3,-0.12,0,36,-3,-0.12,0,53.926,9,6.12,0.68,47.926,6,6
80,1.51,0.49,324,165.24,84.27,146.88,165.24,27.18,25.18,27.18,-8.82,-6.82,-8.82,288,324,34,36,8.82,2,0,256,288,34,-2,6.82,-2,324,0,8.82,2,260.954,18,9.18,0.51,244.954,16,18
81,1.32,0.68,49,15.68,5.02,33.6,8.96,9.24,17.24,6.24,-4.76,-12.76,-1.76,105,28,22,11,4.76,-8,3,225,60,19,8,12.76,11,16,-3,1.76,-11,42.944,7,2.24,0.32,27.944000000000003,15,4
82,1.74,0.26,144,106.56,78.85,53.28,88.8,20.88,14.88,18.88,-3.12,2.88,-1.12,72,120,18,22,3.12,6,2,36,60,16,-6,-2.88,-4,100,-2,1.12,4,95.06,12,8.88,0.74,89.06,6,10
83,1.16,0.84,4,0.64,0.1,0.32,4.16,2.32,1.32,13.32,-1.68,-0.68,-12.68,2,26,3,15,1.68,1,-11,1,13,14,-1,0.68,-12,169,11,12.68,12,23.638,2,0.32,0.16,22.638,1,13
84,1.37,0.63,324,119.88,44.36,33.3,59.94,24.66,11.66,15.66,-11.34,1.66,-2.34,90,162,23,27,11.34,13,9,25,45,14,-13,-1.66,-4,81,-9,2.34,4,170.414,18,6.66,0.37,165.414,5,9
85,1.68,0.32,49,33.32,22.66,14.28,23.8,11.76,7.76,9.76,-2.24,1.76,-0.24,21,35,10,12,2.24,4,2,9,15,8,-4,-1.76,-2,25,-2,0.24,2,33.262,7,4.76,0.68,30.262,3,5
86,1.85,0.15,400,340.0,289.0,136.0,272.0,37.0,25.0,33.0,-3.0,9.0,1.0,160,320,28,36,3.0,12,4,64,128,24,-12,-9.0,-8,256,-4,-1.0,8,233.524,20,17.0,0.85,225.524,8,16
87,1.09,0.91,144,12.96,1.17,17.28,5.4,13.08,17.08,6.08,-10.92,-14.92,-3.92,192,60,28,17,10.92,-4,7,256,80,21,4,14.92,11,25,-7,3.92,-11,77.678,12,1.08,0.09,61.678,16,5
88,1.06,0.94,400,24.0,1.44,19.2,2.4,21.2,17.2,3.2,-18.8,-14.8,-0.8,320,40,36,22,18.8,4,18,256,32,18,-4,14.8,14,4,-18,0.8,-14,65.84,20,1.2,0.06,49.84,16,2
89,1.54,0.46,324,174.96,94.48,165.24,9.72,27.72,26.72,10.72,-8.28,-7.28,8.72,306,18,35,19,8.28,1,17,289,17,18,-1,7.28,16,1,-17,-8.72,-16,117.178,18,9.72,0.54,100.178,17,1
90,1.12,0.88,81,9.72,1.17,0.0,7.56,10.08,1.08,8.08,-7.92,1.08,-5.92,0,63,9,16,7.92,9,2,0,0,7,-9,-1.08,-7,49,-2,5.92,7,61.052,9,1.08,0.12,61.052,0,7
91,1.76,0.24,16,12.16,9.24,57.76,36.48,7.04,22.04,15.04,-0.96,-15.96,-8.96,76,48,23,16,0.96,-15,-8,361,228,31,15,15.96,7,144,8,8.96,-7,37.8,4,3.04,0.76,18.799999999999997,19,12
92,1.69,0.31,25,17.25,11.9,41.4,55.2,8.45,15.45,19.45,-1.55,-8.55,-12.55,60,80,17,21,1.55,-7,-11,144,192,28,7,8.55,-4,256,11,12.55,4,46.688,5,3.45,0.69,34.688,12,16
93,1.76,0.24,289,219.64,166.93,103.36,116.28,29.92,20.92,21.92,-4.08,4.92,3.92,136,153,25,26,4.08,9,8,64,72,17,-9,-4.92,-1,81,-8,-3.92,1,160.556,17,12.92,0.76,152.556,8,9
94,1.21,0.79,36,7.56,1.59,10.08,10.08,7.26,9.26,9.26,-4.74,-6.74,-6.74,48,48,14,14,4.74,-2,-2,64,64,16,2,6.74,0,64,2,6.74,0,50.288,6,1.26,0.21,42.288,8,8
95,1.89,0.11,361,321.29,285.95,219.83,253.65,35.91,29.91,31.91,-2.09,3.91,1.91,247,285,32,34,2.09,6,4,169,195,28,-6,-3.91,-2,225,-4,-1.91,2,213.75,19,16.91,0.89,200.75,13,15
96,1.68,0.32,64,43.52,29.59,38.08,48.96,13.44,12.44,14.44,-2.56,-1.56,-3.56,56,72,15,17,2.56,1,-1,49,63,16,-1,1.56,-2,81,1,3.56,2,54.41,8,5.44,0.68,47.41,7,9
97,1.87,0.13,169,147.03,127.92,22.62,33.93,24.31,13.31,14.31,-1.69,9.31,8.31,26,39,15,16,1.69,11,10,4,6,5,-11,-9.31,-1,9,-10,-8.31,1,86.614,13,11.31,0.87,84.614,2,3
98,1.66,0.34,16,10.56,6.97,2.64,7.92,6.64,3.64,5.64,-1.36,1.64,-0.36,4,12,5,7,1.36,3,1,1,3,4,-3,-1.64,-2,9,-1,0.36,2,11.748,4,2.64,0.66,10.748,1,3
99,1.78,0.22,49,38.22,29.81,109.2,43.68,12.46,25.46,13.46,-1.54,-14.54,-2.54,140,56,27,15,1.54,-13,-1,400,160,28,13,14.54,12,64,1,2.54,-12,54.488,7,5.46,0.78,34.488,20,8
100,1.33,0.67,256,84.48,27.88,73.92,0.0,21.28,19.28,5.28,-10.72,-8.72,5.28,224,0,30,16,10.72,2,16,196,0,14,-2,8.72,14,0,-16,-5.28,-14,57.786,16,5.28,0.33,43.786,14,0
101,1.46,0.54,49,22.54,10.37,51.52,51.52,10.22,19.22,19.22,-3.78,-12.78,-12.78,112,112,23,23,3.78,-9,-9,256,256,32,9,12.78,0,256,9,12.78,0,89.292,7,3.22,0.46,73.292,16,16
102,1.3,0.7,400,120.0,36.0,114.0,0.0,26.0,25.0,6.0,-14.0,-13.0,6.0,380,0,39,20,14.0,1,20,361,0,19,-1,13.0,19,0,-20,-6.0,-19,81.37,20,6.0,0.3,62.370000000000005,19,0
103,1.56,0.44,400,224.0,125.44,44.8,89.6,31.2,15.2,19.2,-8.8,7.2,3.2,80,160,24,28,8.8,16,12,16,32,12,-16,-7.2,-4,64,-12,-3.2,4,192.94,20,11.2,0.56,188.94,4,8
104,1.81,0.19,144,116.64,94.48,29.16,0.0,21.72,12.72,9.72,-2.28,6.72,9.72,36,0,15,12,2.28,9,12,9,0,3,-9,-6.72,3,0,-12,-9.72,-3,66.24,12,9.72,0.81,63.239999999999995,3,0
105,1.66,0.34,169,111.54,73.62,60.06,128.7,21.58,15.58,23.58,-4.42,1.58,-6.42,91,195,20,28,4.42,6,-2,49,105,22,-6,-1.58,-8,225,2,6.42,8,134.34,13,8.58,0.66,127.34,7,15
106,1.6,0.4,36,21.6,12.96,21.6,21.6,9.6,9.6,9.6,-2.4,-2.4,-2.4,36,36,12,12,2.4,0,0,36,36,12,0,2.4,0,36,0,2.4,0,33.076,6,3.6,0.6,27.076,6,6
107,1.12,0.88,361,43.32,5.2,45.6,6.84,21.28,22.28,5.28,-16.72,-17.72,-0.72,380,57,39,22,16.72,-1,16,400,60,23,1,17.72,17,9,-16,0.72,-17,92.61,19,2.28,0.12,72.61,20,3
108,1.3,0.7,121,36.3,10.89,0.0,52.8,14.3,3.3,19.3,-7.7,3.3,-12.7,0,176,11,27,7.7,11,-5,0,0,16,-11,-3.3,-16,256,5,12.7,16,141.654,11,3.3,0.3,141.654,0,16
109,1.76,0.24,100,76.0,57.76,0.0,45.6,17.6,7.6,13.6,-2.4,7.6,1.6,0,60,10,16,2.4,10,4,0,0,6,-10,-7.6,-6,36,-4,-1.6,6,56.342,10,7.6,0.76,56.342,0,6
110,1.19,0.81,169,32.11,6.1,49.4,22.23,15.47,22.47,11.47,-10.53,-17.53,-6.53,260,117,33,22,10.53,-7,4,400,180,29,7,17.53,11,81,-4,6.53,-11,131.844,13,2.47,0.19,111.844,20,9
111,1.06,0.94,289,17.34,1.04,1.02,14.28,18.02,2.02,15.02,-15.98,0.02,-12.98,17,238,18,31,15.98,16,3,1,14,15,-16,-0.02,-13,196,-3,12.98,13,234.248,17,1.02,0.06,233.248,1,14
112,1.54,0.46,100,54.0,29.16,81.0,37.8,15.4,20.4,12.4,-4.6,-9.6,-1.6,150,70,25,17,4.6,-5,3,225,105,22,5,9.6,8,49,-3,1.6,-8,76.914,10,5.4,0.54,61.914,15,7
113,1.36,0.64,400,144.0,51.84,108.0,115.2,27.2,22.2,23.2,-12.8,-7.8,-8.8,300,320,35,36,12.8,5,4,225,240,31,-5,7.8,-1,256,-4,8.8,1,294.634,20,7.2,0.36,279.634,15,16
114,1.68,0.32,196,133.28,90.63,133.28,38.08,23.52,23.52,13.52,-4.48,-4.48,5.52,196,56,28,18,4.48,0,10,196,56,18,0,4.48,10,16,-10,-5.52,-10,102.934,14,9.52,0.68,88.934,14,4
115,1.72,0.28,121,87.12,62.73,23.76,55.44,18.92,10.92,14.92,-3.08,4.92,0.92,33,77,14,18,3.08,8,4,9,21,10,-8,-4.92,-4,49,-4,-0.92,4,71.792,11,7.92,0.72,68.792,3,7
116,1.88,0.12,9,7.92,6.97,29.04,5.28,5.64,13.64,4.64,-0.36,-8.36,0.64,33,6,14,5,0.36,-8,1,121,22,13,8,8.36,9,4,-1,-0.64,-9,17.018,3,2.64,0.88,6.018000000000001,11,2
117,1.13,0.87,256,33.28,4.33,27.04,22.88,18.08,15.08,13.08,-13.92,-10.92,-8.92,208,176,29,27,13.92,3,5,169,143,24,-3,10.92,2,121,-5,8.92,-2,184.038,16,2.08,0.13,171.038,13,11
118,1.48,0.52,36,17.28,8.29,23.04,11.52,8.88,10.88,6.88,-3.12,-5.12,-1.12,48,24,14,10,3.12,-2,2,64,32,12,2,5.12,4,16,-2,1.12,-4,30.686,6,2.88,0.48,22.686,8,4
119,1.56,0.44,64,35.84,20.07,40.32,22.4,12.48,13.48,9.48,-3.52,-4.52,-0.52,72,40,17,13,3.52,-1,3,81,45,14,1,4.52,4,25,-3,0.52,-4,46.67,8,4.48,0.56,37.67,9,5
120,1.65,0.35,361,234.65,152.52,111.15,24.7,31.35,21.35,14.35,-6.65,3.35,10.35,171,38,28,21,6.65,10,17,81,18,11,-10,-3.35,7,4,-17,-10.35,-7,144.398,19,12.35,0.65,135.398,9,2
121,1.66,0.34,169,111.54,73.62,42.9,8.58,21.58,13.58,9.58,-4.42,3.58,7.58,65,13,18,14,4.42,8,12,25,5,6,-8,-3.58,4,1,-12,-7.58,-4,69.118,13,8.58,0.66,64.118,5,1
122,1.29,0.71,121,35.09,10.18,9.57,0.0,14.19,6.19,3.19,-7.81,0.19,3.19,33,0,14,11,7.81,8,11,9,0,3,-8,-0.19,3,0,-11,-3.19,-3,22.876,11,3.19,0.29,19.876,3,0
123,1.24,0.76,25,6.0,1.44,4.8,16.8,6.2,5.2,15.2,-3.8,-2.8,-12.8,20,70,9,19,3.8,1,-9,16,56,18,-1,2.8,-10,196,9,12.8,10,61.03,5,1.2,0.24,57.03,4,14
124,1.74,0.26,169,125.06,92.54,105.82,115.44,22.62,20.62,21.62,-3.38,-1.38,-2.38,143,156,24,25,3.38,2,1,121,132,23,-2,1.38,-1,144,-1,2.38,1,118.442,13,9.62,0.74,107.442,11,12
125,1.12,0.88,121,14.52,1.74,10.56,21.12,12.32,9.32,17.32,-9.68,-6.68,-14.68,88,176,19,27,9.68,3,-5,64,128,24,-3,6.68,-8,256,5,14.68,8,171.19,11,1.32,0.12,163.19,8,16
126,1.23,0.77,25,5.75,1.32,10.35,17.25,6.15,10.15,16.15,-3.85,-7.85,-13.85,45,75,14,20,3.85,-4,-10,81,135,24,4,7.85,-6,225,10,13.85,6,70.0,5,1.15,0.23,61.0,9,15
127,1.21,0.79,225,47.25,9.92,28.35,15.75,18.15,12.15,8.15,-11.85,-5.85,-1.85,135,75,24,20,11.85,6,10,81,45,14,-6,5.85,4,25,-10,1.85,-4,93.332,15,3.15,0.21,84.332,9,5
128,1.14,0.86,169,23.66,3.31,5.46,7.28,14.82,4.82,5.82,-11.18,-1.18,-2.18,39,52,16,17,11.18,10,9,9,12,7,-10,1.18,-1,16,-9,2.18,1,60.368,13,1.82,0.14,57.368,3,4
129,1.41,0.59,64,26.24,10.76,13.12,62.32,11.28,7.28,22.28,-4.72,-0.72,-15.72,32,152,12,27,4.72,4,-11,16,76,23,-4,0.72,-15,361,11,15.72,15,107.244,8,3.28,0.41,103.244,4,19
130,1.53,0.47,121,64.13,33.99,23.32,52.47,16.83,9.83,14.83,-5.17,1.83,-3.17,44,99,15,20,5.17,7,2,16,36,13,-7,-1.83,-5,81,-2,3.17,5,85.992,11,5.83,0.53,81.992,4,9
131,1.49,0.51,324,158.76,77.79,44.1,141.12,26.82,13.82,24.82,-9.18,3.82,-7.18,90,288,23,34,9.18,13,2,25,80,21,-13,-3.82,-11,256,-2,7.18,11,235.604,18,8.82,0.49,230.604,5,16
132,1.07,0.93,16,1.12,0.08,5.6,3.92,4.28,20.28,14.28,-3.72,-19.72,-13.72,80,56,24,18,3.72,-16,-10,400,280,34,16,19.72,6,196,10,13.72,-6,72.928,4,0.28,0.07,52.928,20,14
133,1.25,0.75,4,1.0,0.25,1.5,3.5,2.5,3.5,7.5,-1.5,-2.5,-6.5,6,14,5,9,1.5,-1,-5,9,21,10,1,2.5,-4,49,5,6.5,4,14.244,2,0.5,0.25,11.244,3,7
134,1.48,0.52,144,69.12,33.18,74.88,57.6,17.76,18.76,15.76,-6.24,-7.24,-4.24,156,120,25,22,6.24,-1,2,169,130,23,1,7.24,3,100,-2,4.24,-3,113.092,12,5.76,0.48,100.092,13,10
135,1.36,0.64,100,36.0,12.96,64.8,68.4,13.6,21.6,22.6,-6.4,-14.4,-15.4,180,190,28,29,6.4,-8,-9,324,342,37,8,14.4,-1,361,9,15.4,1,160.31,10,3.6,0.36,142.31,18,19
136,1.63,0.37,361,227.43,143.28,143.64,35.91,30.97,23.97,14.97,-7.03,-0.03,8.97,228,57,31,22,7.03,7,16,144,36,15,-7,0.03,9,9,-16,-8.97,-9,152.924,19,11.97,0.63,140.924,12,3
137,1.2,0.8,256,51.2,10.24,54.4,57.6,19.2,20.2,21.2,-12.8,-13.8,-14.8,272,288,33,34,12.8,-1,-2,289,306,35,1,13.8,-1,324,2,14.8,1,274.44,16,3.2,0.2,257.44,17,18
138,1.25,0.75,324,81.0,20.25,31.5,0.0,22.5,11.5,4.5,-13.5,-2.5,4.5,126,0,25,18,13.5,11,18,49,0,7,-11,2.5,7,0,-18,-4.5,-7,49.468,18,4.5,0.25,42.468,7,0
139,1.29,0.71,121,35.09,10.18,6.38,51.04,14.19,5.19,19.19,-7.81,1.19,-12.81,22,176,13,27,7.81,9,-5,4,32,18,-9,-1.19,-14,256,5,12.81,14,146.058,11,3.19,0.29,144.058,2,16
140,1.77,0.23,169,130.13,100.2,160.16,150.15,23.01,26.01,25.01,-2.99,-5.99,-4.99,208,195,29,28,2.99,-3,-2,256,240,31,3,5.99,1,225,2,4.99,-1,130.782,13,10.01,0.77,114.78200000000001,16,15
141,1.75,0.25,196,147.0,110.25,178.5,189.0,24.5,27.5,28.5,-3.5,-6.5,-7.5,238,252,31,32,3.5,-3,-4,289,306,35,3,6.5,-1,324,4,7.5,1,158.624,14,10.5,0.75,141.624,17,18
142,1.18,0.82,361,64.98,11.7,44.46,6.84,22.42,16.42,5.42,-15.58,-9.58,1.42,247,38,32,21,15.58,6,17,169,26,15,-6,9.58,11,4,-17,-1.42,-11,78.34,19,3.42,0.18,65.34,13,2
143,1.7,0.3,81,56.7,39.69,75.6,126.0,15.3,18.3,26.3,-2.7,-5.7,-13.7,108,180,21,29,2.7,-3,-11,144,240,32,3,5.7,-8,400,11,13.7,8,98.85,9,6.3,0.7,86.85,12,20
144,1.64,0.36,25,16.0,10.24,44.8,9.6,8.2,17.2,6.2,-1.8,-10.8,0.2,70,15,19,8,1.8,-9,2,196,42,17,9,10.8,11,9,-2,-0.2,-11,28.926,5,3.2,0.64,14.925999999999998,14,3
145,1.85,0.15,361,306.85,260.82,64.6,32.3,35.15,20.15,18.15,-2.85,12.15,14.15,76,38,23,21,2.85,15,17,16,8,6,-15,-12.15,2,4,-17,-14.15,-2,170.818,19,16.15,0.85,166.818,4,2
146,1.52,0.48,4,2.08,1.08,9.36,11.44,3.04,10.04,12.04,-0.96,-7.96,-9.96,18,22,11,13,0.96,-7,-9,81,99,20,7,7.96,-2,121,9,9.96,2,21.646,2,1.04,0.52,12.646,9,11
147,1.64,0.36,256,163.84,104.86,0.0,204.8,26.24,10.24,30.24,-5.76,10.24,-9.76,0,320,16,36,5.76,16,-4,0,0,20,-16,-10.24,-20,400,4,9.76,20,204.036,16,10.24,0.64,204.036,0,20
148,1.84,0.16,256,215.04,180.63,255.36,80.64,29.44,32.44,19.44,-2.56,-5.56,7.44,304,96,35,22,2.56,-3,10,361,114,25,3,5.56,13,36,-10,-7.44,-13,148.734,16,13.44,0.84,129.734,19,6
149,1.08,0.92,49,3.92,0.31,6.72,1.68,7.56,12.56,3.56,-6.44,-11.44,-2.44,84,21,19,10,6.44,-5,4,144,36,15,5,11.44,9,9,-4,2.44,-9,33.498,7,0.56,0.08,21.497999999999998,12,3
150,1.72,0.28,289,208.08,149.82,0.0,97.92,29.24,12.24,20.24,-4.76,12.24,4.24,0,136,17,25,4.76,17,9,0,0,8,-17,-12.24,-8,64,-9,-4.24,8,148.082,17,12.24,0.72,148.082,0,8
151,1.45,0.55,16,7.2,3.24,14.4,7.2,5.8,9.8,5.8,-2.2,-6.2,-2.2,32,16,12,8,2.2,-4,0,64,32,12,4,6.2,4,16,0,2.2,-4,21.32,4,1.8,0.45,13.32,8,4
152,1.56,0.44,25,14.0,7.84,56.0,28.0,7.8,22.8,12.8,-2.2,-17.2,-7.2,100,50,25,15,2.2,-15,-5,400,200,30,15,17.2,10,100,5,7.2,-10,50.114,5,2.8,0.56,30.113999999999997,20,10
153,1.18,0.82,289,52.02,9.36,42.84,18.36,20.06,17.06,9.06,-13.94,-10.94,-2.94,238,102,31,23,13.94,3,11,196,84,20,-3,10.94,8,36,-11,2.94,-8,125.242,17,3.06,0.18,111.242,14,6
154,1.44,0.56,169,74.36,32.72,74.36,0.0,18.72,18.72,5.72,-7.28,-7.28,5.72,169,0,26,13,7.28,0,13,169,0,13,0,7.28,13,0,-13,-5.72,-13,52.538,13,5.72,0.44,39.538,13,0
155,1.06,0.94,324,19.44,1.17,18.36,15.12,19.08,18.08,15.08,-16.92,-15.92,-12.92,306,252,35,32,16.92,1,4,289,238,31,-1,15.92,3,196,-4,12.92,-3,263.74,18,1.08,0.06,246.74,17,14
156,1.86,0.14,196,168.56,144.96,180.6,228.76,26.04,27.04,31.04,-1.96,-2.96,-6.96,210,266,29,33,1.96,-1,-5,225,285,34,1,2.96,-4,361,5,6.96,4,143.098,14,12.04,0.86,128.098,15,19
157,1.85,0.15,9,7.65,6.5,20.4,40.8,5.55,10.55,18.55,-0.45,-5.45,-13.45,24,48,11,19,0.45,-5,-13,64,128,24,5,5.45,-8,256,13,13.45,8,20.596,3,2.55,0.85,12.596,8,16
158,1.8,0.2,225,180.0,144.0,24.0,48.0,27.0,14.0,16.0,-3.0,10.0,8.0,30,60,17,19,3.0,13,11,4,8,6,-13,-10.0,-2,16,-11,-8.0,2,109.548,15,12.0,0.8,107.548,2,4
159,1.05,0.95,4,0.2,0.01,1.6,0.8,2.1,16.1,8.1,-1.9,-15.9,-7.9,32,16,18,10,1.9,-14,-6,256,128,24,14,15.9,8,64,6,7.9,-8,31.424,2,0.1,0.05,15.424,16,8
160,1.67,0.33,36,24.12,16.16,8.04,56.28,10.02,6.02,18.02,-1.98,2.02,-9.98,12,84,8,20,1.98,4,-8,4,28,16,-4,-2.02,-12,196,8,9.98,12,43.552,6,4.02,0.67,41.552,2,14
161,1.93,0.07,100,93.0,86.49,158.1,130.2,19.3,26.3,23.3,-0.7,-7.7,-4.7,170,140,27,24,0.7,-7,-4,289,238,31,7,7.7,3,196,4,4.7,-3,77.714,10,9.3,0.93,60.714,17,14
162,1.44,0.56,121,53.24,23.43,77.44,87.12,15.84,20.84,22.84,-6.16,-11.16,-13.16,176,198,27,29,6.16,-5,-7,256,288,34,5,11.16,-2,324,7,13.16,2,155.202,11,4.84,0.44,139.202,16,18
163,1.25,0.75,9,2.25,0.56,11.25,10.5,3.75,15.75,14.75,-2.25,-14.25,-13.25,45,42,18,17,2.25,-12,-11,225,210,29,12,14.25,1,196,11,13.25,-1,48.392,3,0.75,0.25,33.392,15,14
164,1.46,0.54,25,11.5,5.29,6.9,34.5,7.3,5.3,17.3,-2.7,-0.7,-12.7,15,75,8,20,2.7,2,-10,9,45,18,-2,0.7,-12,225,10,12.7,12,49.754,5,2.3,0.46,46.754,3,15
165,1.5,0.5,400,200.0,100.0,40.0,100.0,30.0,14.0,20.0,-10.0,6.0,0.0,80,200,24,30,10.0,16,10,16,40,14,-16,-6.0,-6,100,-10,0.0,6,208.632,20,10.0,0.5,204.632,4,10
166,1.36,0.64,400,144.0,51.84,50.4,108.0,27.2,14.2,22.2,-12.8,0.2,-7.8,140,300,27,35,12.8,13,5,49,105,22,-13,-0.2,-8,225,-5,7.8,8,275.018,20,7.2,0.36,268.018,7,15
167,1.55,0.45,121,66.55,36.6,72.6,54.45,17.05,18.05,15.05,-4.95,-5.95,-2.95,132,99,23,20,4.95,-1,2,144,108,21,1,5.95,3,81,-2,2.95,-3,93.014,11,6.05,0.55,81.014,12,9
168,1.16,0.84,49,7.84,1.25,5.6,1.12,8.12,6.12,2.12,-5.88,-3.88,0.12,35,7,12,8,5.88,2,6,25,5,6,-2,3.88,4,1,-6,-0.12,-4,15.248,7,1.12,0.16,10.248,5,1
169,1.78,0.22,4,3.12,2.43,1.56,4.68,3.56,2.56,4.56,-0.44,0.56,-1.44,2,6,3,5,0.44,1,-1,1,3,4,-1,-0.56,-2,9,1,1.44,2,4.666,2,1.56,0.78,3.6660000000000004,1,3
170,1.79,0.21,169,133.51,105.47,195.13,174.59,23.27,29.27,27.27,-2.73,-8.73,-6.73,247,221,32,30,2.73,-6,-4,361,323,36,6,8.73,2,289,4,6.73,-2,137.194,13,10.27,0.79,118.19399999999999,19,17
171,1.53,0.47,196,103.88,55.06,29.68,148.4,21.42,11.42,27.42,-6.58,3.42,-12.58,56,280,18,34,6.58,10,-6,16,80,24,-10,-3.42,-16,400,6,12.58,16,190.332,14,7.42,0.53,186.332,4,20
172,1.92,0.08,121,111.32,102.41,182.16,0.0,21.12,28.12,10.12,-0.88,-7.88,10.12,198,0,29,11,0.88,-7,11,324,0,18,7,7.88,18,0,-11,-10.12,-18,78.586,11,10.12,0.92,60.586,18,0
173,1.58,0.42,25,14.5,8.41,40.6,52.2,7.9,16.9,20.9,-2.1,-11.1,-15.1,70,90,19,23,2.1,-9,-13,196,252,32,9,11.1,-4,324,13,15.1,4,60.598,5,2.9,0.58,46.598,14,18
174,1.43,0.57,9,3.87,1.66,21.93,3.87,4.29,18.29,4.29,-1.71,-15.71,-1.71,51,9,20,6,1.71,-14,0,289,51,20,14,15.71,14,9,0,1.71,-14,24.66,3,1.29,0.43,7.66,17,3
175,1.53,0.47,100,53.0,28.09,63.6,31.8,15.3,17.3,11.3,-4.7,-6.7,-0.7,120,60,22,16,4.7,-2,4,144,72,18,2,6.7,6,36,-4,0.7,-6,69.552,10,5.3,0.53,57.55200000000001,12,6
176,1.85,0.15,1,0.85,0.72,1.7,0.85,1.85,2.85,1.85,-0.15,-1.15,-0.15,2,1,3,2,0.15,-1,0,4,2,3,1,1.15,1,1,0,0.15,-1,3.0,1,0.85,0.85,1.0,2,1
177,1.77,0.23,25,19.25,14.82,61.6,11.55,8.85,19.85,6.85,-1.15,-12.15,0.85,80,15,21,8,1.15,-11,2,256,48,19,11,12.15,13,9,-2,-0.85,-13,30.988,5,3.85,0.77,14.988,16,3
178,1.67,0.33,361,241.87,162.05,165.49,127.3,31.73,25.73,22.73,-6.27,-0.27,2.73,247,190,32,29,6.27,6,9,169,130,23,-6,0.27,3,100,-9,-2.73,-3,203.522,19,12.73,0.67,190.522,13,10
179,1.72,0.28,256,184.32,132.71,161.28,149.76,27.52,25.52,24.52,-4.48,-2.48,-1.48,224,208,30,29,4.48,2,3,196,182,27,-2,2.48,1,169,-3,1.48,-1,169.052,16,11.52,0.72,155.052,14,13
180,1.73,0.27,225,164.25,119.9,32.85,153.3,25.95,13.95,24.95,-4.05,7.95,-3.05,45,210,18,29,4.05,12,1,9,42,17,-12,-7.95,-11,196,-1,3.05,11,147.972,15,10.95,0.73,144.972,3,14
181,1.31,0.69,361,111.91,34.69,0.0,5.89,24.89,5.89,6.89,-13.11,5.89,4.89,0,19,19,20,13.11,19,18,0,0,1,-19,-5.89,-1,1,-18,-4.89,1,73.592,19,5.89,0.31,73.592,0,1
182,1.2,0.8,144,28.8,5.76,48.0,45.6,14.4,22.4,21.4,-9.6,-17.6,-16.6,240,228,32,31,9.6,-8,-7,400,380,39,8,17.6,1,361,7,16.6,-1,219.432,12,2.4,0.2,199.432,20,19
183,1.05,0.95,9,0.45,0.02,0.6,0.6,3.15,4.15,4.15,-2.85,-3.85,-3.85,12,12,7,7,2.85,-1,-1,16,16,8,1,3.85,0,16,1,3.85,0,15.716,3,0.15,0.05,11.716,4,4
184,1.64,0.36,64,40.96,26.21,10.24,35.84,13.12,7.12,12.12,-2.88,3.12,-1.88,16,56,10,15,2.88,6,1,4,14,9,-6,-3.12,-5,49,-1,1.88,5,45.36,8,5.12,0.64,43.36,2,7
185,1.38,0.62,81,30.78,11.7,17.1,6.84,12.42,8.42,5.42,-5.58,-1.58,1.42,45,18,14,11,5.58,4,7,25,10,7,-4,1.58,3,4,-7,-1.42,-3,33.124,9,3.42,0.38,28.124000000000002,5,2
186,1.27,0.73,1,0.27,0.07,3.78,3.51,1.27,14.27,13.27,-0.73,-13.73,-12.73,14,13,15,14,0.73,-13,-12,196,182,27,13,13.73,1,169,12,12.73,-1,23.784,1,0.27,0.27,9.783999999999999,14,13
187,1.31,0.69,256,79.36,24.6,4.96,79.36,20.96,5.96,20.96,-11.04,3.96,-11.04,16,256,17,32,11.04,15,0,1,16,17,-15,-3.96,-15,256,0,11.04,15,219.022,16,4.96,0.31,218.022,1,16
188,1.57,0.43,196,111.72,63.68,0.0,55.86,21.98,7.98,14.98,-6.02,7.98,0.98,0,98,14,21,6.02,14,7,0,0,7,-14,-7.98,-7,49,-7,-0.98,7,101.852,14,7.98,0.57,101.852,0,7
189,1.29,0.71,256,74.24,21.53,64.96,78.88,20.64,18.64,21.64,-11.36,-9.36,-12.36,224,272,30,33,11.36,2,-1,196,238,31,-2,9.36,-3,289,1,12.36,3,247.076,16,4.64,0.29,233.076,14,17
190,1.44,0.56,16,7.04,3.1,7.04,8.8,5.76,5.76,6.76,-2.24,-2.24,-3.24,16,20,8,9,2.24,0,-1,16,20,9,0,2.24,-1,25,1,3.24,1,19.632,4,1.76,0.44,15.632000000000001,4,5
191,1.73,0.27,121,88.33,64.48,88.33,8.03,19.03,19.03,9.03,-2.97,-2.97,7.03,121,11,22,12,2.97,0,10,121,11,12,0,2.97,10,1,-10,-7.03,-10,62.868,11,8.03,0.73,51.868,11,1
192,1.39,0.61,256,99.84,38.94,12.48,93.6,22.24,8.24,21.24,-9.76,4.24,-8.76,32,240,18,31,9.76,14,1,4,30,17,-14,-4.24,-13,225,-1,8.76,13,200.196,16,6.24,0.39,198.196,2,15
193,1.87,0.13,81,70.47,61.31,46.98,148.77,16.83,13.83,26.83,-1.17,1.83,-11.17,54,171,15,28,1.17,3,-10,36,114,25,-3,-1.83,-13,361,10,11.17,13,67.868,9,7.83,0.87,61.867999999999995,6,19
194,1.92,0.08,361,332.12,305.55,17.48,279.68,36.48,18.48,33.48,-1.52,16.48,1.48,19,304,20,35,1.52,18,3,1,16,17,-18,-16.48,-15,256,-3,-1.48,15,199.63,19,17.48,0.92,198.63,1,16
195,1.42,0.58,121,50.82,21.34,78.54,46.2,15.62,21.62,14.62,-6.38,-12.38,-5.38,187,110,28,21,6.38,-6,1,289,170,27,6,12.38,7,100,-1,5.38,-7,108.33,11,4.62,0.42,91.33,17,10
196,1.9,0.1,169,152.1,136.89,198.9,234.0,24.7,28.7,31.7,-1.3,-5.3,-8.3,221,260,30,33,1.3,-4,-7,289,340,37,4,5.3,-3,400,7,8.3,3,125.382,13,11.7,0.9,108.382,17,20
197,1.38,0.62,289,109.82,41.73,6.46,122.74,23.46,7.46,25.46,-10.54,5.46,-12.54,17,323,18,36,10.54,16,-2,1,19,20,-16,-5.46,-18,361,2,12.54,18,257.696,17,6.46,0.38,256.696,1,19
198,1.67,0.33,400,268.0,179.56,160.8,0.0,33.4,25.4,13.4,-6.6,1.4,13.4,240,0,32,20,6.6,8,20,144,0,12,-8,-1.4,12,0,-20,-13.4,-12,151.758,20,13.4,0.67,139.758,12,0
199,1.84,0.16,81,68.04,57.15,90.72,151.2,16.56,19.56,27.56,-1.44,-4.44,-12.44,108,180,21,29,1.44,-3,-11,144,240,32,3,4.44,-8,400,11,12.44,8,79.172,9,7.56,0.84,67.172,12,20
200,1.33,0.67,256,84.48,27.88,52.8,89.76,21.28,15.28,22.28,-10.72,-4.72,-11.72,160,272,26,33,10.72,6,-1,100,170,27,-6,4.72,-7,289,1,11.72,7,237.366,16,5.28,0.33,227.366,10,17
201,1.89,0.11,361,321.29,285.95,202.92,169.1,35.91,28.91,26.91,-2.09,4.91,6.91,228,190,31,29,2.09,7,9,144,120,22,-7,-4.91,2,100,-9,-6.91,-2,201.886,19,16.91,0.89,189.886,12,10
202,1.18,0.82,64,11.52,2.07,12.96,18.72,9.44,10.44,14.44,-6.56,-7.56,-11.56,72,104,17,21,6.56,-1,-5,81,117,22,1,7.56,-4,169,5,11.56,4,101.216,8,1.44,0.18,92.216,9,13
203,1.14,0.86,169,23.66,3.31,0.0,34.58,14.82,1.82,20.82,-11.18,1.82,-17.18,0,247,13,32,11.18,13,-6,0,0,19,-13,-1.82,-19,361,6,17.18,19,223.764,13,1.82,0.14,223.764,0,19
204,1.56,0.44,169,94.64,53.0,116.48,58.24,20.28,23.28,15.28,-5.72,-8.72,-0.72,208,104,29,21,5.72,-3,5,256,128,24,3,8.72,8,64,-5,0.72,-8,112.388,13,7.28,0.56,96.388,16,8
205,1.64,0.36,400,256.0,163.84,102.4,256.0,32.8,20.8,32.8,-7.2,4.8,-7.2,160,400,28,40,7.2,12,0,64,160,28,-12,-4.8,-12,400,0,7.2,12,286.44,20,12.8,0.64,278.44,8,20
206,1.3,0.7,1,0.3,0.09,4.8,2.1,1.3,16.3,7.3,-0.7,-15.7,-6.7,16,7,17,8,0.7,-15,-6,256,112,23,15,15.7,9,49,6,6.7,-9,21.26,1,0.3,0.3,5.260000000000002,16,7
207,1.78,0.22,225,175.5,136.89,23.4,152.1,26.7,13.7,24.7,-3.3,9.7,-1.3,30,195,17,28,3.3,13,2,4,26,15,-13,-9.7,-11,169,-2,1.3,11,138.588,15,11.7,0.78,136.588,2,13
208,1.63,0.37,81,51.03,32.15,56.7,5.67,14.67,15.67,6.67,-3.33,-4.33,4.67,90,9,19,10,3.33,-1,8,100,10,11,1,4.33,9,1,-8,-4.67,-9,41.968,9,5.67,0.63,31.968000000000004,10,1
209,1.14,0.86,169,23.66,3.31,36.4,23.66,14.82,21.82,14.82,-11.18,-18.18,-11.18,260,169,33,26,11.18,-7,0,400,260,33,7,18.18,7,169,0,11.18,-7,178.724,13,1.82,0.14,158.724,20,13
210,1.88,0.12,1,0.88,0.77,8.8,7.04,1.88,10.88,8.88,-0.12,-9.12,-7.12,10,8,11,9,0.12,-9,-7,100,80,18,9,9.12,2,64,7,7.12,-2,11.812,1,0.88,0.88,1.8119999999999994,10,8
211,1.93,0.07,25,23.25,21.62,55.8,18.6,9.65,16.65,8.65,-0.35,-7.35,0.65,60,20,17,9,0.35,-7,1,144,48,16,7,7.35,8,16,-1,-0.65,-8,27.358,5,4.65,0.93,15.358,12,4
212,1.48,0.52,16,7.68,3.69,9.6,5.76,5.92,6.92,4.92,-2.08,-3.08,-1.08,20,12,9,7,2.08,-1,1,25,15,8,1,3.08,2,9,-1,1.08,-2,15.944,4,1.92,0.48,10.944,5,3
213,1.62,0.38,16,9.92,6.15,42.16,0.0,6.48,19.48,2.48,-1.52,-14.52,2.48,68,0,21,4,1.52,-13,4,289,0,17,13,14.52,17,0,-4,-2.48,-17,23.266,4,2.48,0.62,6.265999999999998,17,0
214,1.7,0.3,400,280.0,196.0,238.0,224.0,34.0,31.0,30.0,-6.0,-3.0,-2.0,340,320,37,36,6.0,3,4,289,272,33,-3,3.0,1,256,-4,2.0,-1,258.634,20,14.0,0.7,241.63400000000001,17,16
215,1.93,0.07,400,372.0,345.96,37.2,372.0,38.6,20.6,38.6,-1.4,16.6,-1.4,40,400,22,40,1.4,18,0,4,40,22,-18,-16.6,-18,400,0,1.4,18,225.508,20,18.6,0.93,223.508,2,20
216,1.6,0.4,121,72.6,43.56,33.0,52.8,17.6,11.6,14.6,-4.4,1.6,-1.4,55,88,16,19,4.4,6,3,25,40,13,-6,-1.6,-3,64,-3,1.4,3,79.76,11,6.6,0.6,74.76,5,8
217,1.18,0.82,324,58.32,10.5,38.88,61.56,21.24,15.24,22.24,-14.76,-8.76,-15.76,216,342,30,37,14.76,6,-1,144,228,31,-6,8.76,-7,361,1,15.76,7,323.3,18,3.24,0.18,311.3,12,19
218,1.26,0.74,100,26.0,6.76,26.0,10.4,12.6,12.6,6.6,-7.4,-7.4,-1.4,100,40,20,14,7.4,0,6,100,40,14,0,7.4,6,16,-6,1.4,-6,53.79,10,2.6,0.26,43.79,10,4
219,1.87,0.13,169,147.03,127.92,56.55,147.03,24.31,16.31,24.31,-1.69,6.31,-1.69,65,169,18,26,1.69,8,0,25,65,18,-8,-6.31,-8,169,0,1.69,8,105.67,13,11.31,0.87,100.67,5,13
220,1.53,0.47,16,8.48,4.49,36.04,12.72,6.12,19.12,8.12,-1.88,-14.88,-3.88,68,24,21,10,1.88,-13,-2,289,102,23,13,14.88,11,36,2,3.88,-11,33.868,4,2.12,0.53,16.868000000000002,17,6
221,1.36,0.64,100,36.0,12.96,32.4,72.0,13.6,12.6,23.6,-6.4,-5.4,-16.4,90,200,19,30,6.4,1,-10,81,180,29,-1,5.4,-11,400,10,16.4,11,156.376,10,3.6,0.36,147.376,9,20
222,1.29,0.71,196,56.84,16.48,44.66,8.12,18.06,15.06,6.06,-9.94,-6.94,2.06,154,28,25,16,9.94,3,12,121,22,13,-3,6.94,9,4,-12,-2.06,-9,61.87,14,4.06,0.29,50.87,11,2
223,1.37,0.63,256,94.72,35.05,35.52,11.84,21.92,11.92,7.92,-10.08,-0.08,3.92,96,32,22,18,10.08,10,14,36,12,8,-10,0.08,4,4,-14,-3.92,-4,76.09,16,5.92,0.37,70.09,6,2
224,1.82,0.18,25,20.5,16.81,8.2,45.1,9.1,6.1,15.1,-0.9,2.1,-6.9,10,55,7,16,0.9,3,-6,4,22,13,-3,-2.1,-9,121,6,6.9,9,24.522,5,4.1,0.82,22.522,2,11
225,1.72,0.28,196,141.12,101.61,201.6,161.28,24.08,30.08,26.08,-3.92,-9.92,-5.92,280,224,34,30,3.92,-6,-2,400,320,36,6,9.92,4,256,2,5.92,-4,159.12,14,10.08,0.72,139.12,20,16
226,1.74,0.26,400,296.0,219.04,251.6,192.4,34.8,31.8,27.8,-5.2,-2.2,1.8,340,260,37,33,5.2,3,7,289,221,30,-3,2.2,4,169,-7,-1.8,-4,240.604,20,14.8,0.74,223.604,17,13
227,1.92,0.08,16,14.72,13.54,36.8,36.8,7.68,13.68,13.68,-0.32,-6.32,-6.32,40,40,14,14,0.32,-6,-6,100,100,20,6,6.32,0,100,6,6.32,0,22.044,4,3.68,0.92,12.044,10,10
228,1.7,0.3,81,56.7,39.69,6.3,18.9,15.3,7.3,9.3,-2.7,5.3,3.3,9,27,10,12,2.7,8,6,1,3,4,-8,-5.3,-2,9,-6,-3.3,2,40.616,9,6.3,0.7,39.616,1,3
229,1.69,0.31,49,33.81,23.33,24.15,9.66,11.83,9.83,6.83,-2.17,-0.17,2.83,35,14,12,9,2.17,2,5,25,10,7,-2,0.17,3,4,-5,-2.83,-3,28.538,7,4.83,0.69,23.538,5,2
230,1.44,0.56,144,63.36,27.88,10.56,100.32,17.28,7.28,24.28,-6.72,3.28,-13.72,24,228,14,31,6.72,10,-7,4,38,21,-10,-3.28,-17,361,7,13.72,17,165.916,12,5.28,0.44,163.916,2,19
231,1.67,0.33,225,150.75,101.0,50.25,140.7,25.05,15.05,24.05,-4.95,5.05,-3.95,75,210,20,29,4.95,10,1,25,70,19,-10,-5.05,-9,196,-1,3.95,9,154.716,15,10.05,0.67,149.716,5,14
232,1.29,0.71,289,83.81,24.3,64.09,29.58,21.93,17.93,10.93,-12.07,-8.07,-1.07,221,102,30,23,12.07,4,11,169,78,19,-4,8.07,7,36,-11,1.07,-7,130.314,17,4.93,0.29,117.314,13,6
233,1.84,0.16,36,30.24,25.4,15.12,100.8,11.04,8.04,25.04,-0.96,2.04,-14.96,18,120,9,26,0.96,3,-14,9,60,23,-3,-2.04,-17,400,14,14.96,17,38.896,6,5.04,0.84,35.896,3,20
234,1.7,0.3,169,118.3,82.81,63.7,9.1,22.1,16.1,10.1,-3.9,2.1,8.1,91,13,20,14,3.9,6,12,49,7,8,-6,-2.1,6,1,-12,-8.1,-6,74.568,13,9.1,0.7,67.568,7,1
235,1.45,0.55,36,16.2,7.29,51.3,40.5,8.7,21.7,17.7,-3.3,-16.3,-12.3,114,90,25,21,3.3,-13,-9,361,285,34,13,16.3,4,225,9,12.3,-4,77.338,6,2.7,0.45,58.337999999999994,19,15
236,1.86,0.14,256,220.16,189.34,13.76,137.6,29.76,14.76,23.76,-2.24,12.76,3.76,16,160,17,26,2.24,15,6,1,10,11,-15,-12.76,-9,100,-6,-3.76,9,139.664,16,13.76,0.86,138.664,1,10
237,1.35,0.65,256,89.6,31.36,0.0,84.0,21.6,5.6,20.6,-10.4,5.6,-9.4,0,240,16,31,10.4,16,1,0,0,15,-16,-5.6,-15,225,-1,9.4,15,203.678,16,5.6,0.35,203.678,0,15
238,1.28,0.72,25,7.0,1.96,2.8,0.0,6.4,3.4,1.4,-3.6,-0.6,1.4,10,0,7,5,3.6,3,5,4,0,2,-3,0.6,2,0,-5,-1.4,-2,5.906,5,1.4,0.28,3.9059999999999997,2,0
239,1.48,0.52,225,108.0,51.84,43.2,36.0,22.2,13.2,12.2,-7.8,1.2,2.2,90,75,21,20,7.8,9,10,36,30,11,-9,-1.2,1,25,-10,-2.2,-1,102.214,15,7.2,0.48,96.214,6,5
240,1.39,0.61,289,112.71,43.96,59.67,19.89,23.63,15.63,9.63,-10.37,-2.37,3.63,153,51,26,20,10.37,8,14,81,27,12,-8,2.37,6,9,-14,-3.63,-6,100.082,17,6.63,0.39,91.082,9,3
241,1.88,0.12,4,3.52,3.1,29.92,22.88,3.76,18.76,14.76,-0.24,-15.24,-11.24,34,26,19,15,0.24,-15,-11,289,221,30,15,15.24,4,169,11,11.24,-4,23.108,2,1.76,0.88,6.1080000000000005,17,13
242,1.43,0.57,256,110.08,47.33,130.72,103.2,22.88,25.88,21.88,-9.12,-12.12,-8.12,304,240,35,31,9.12,-3,1,361,285,34,3,12.12,4,225,-1,8.12,-4,215.484,16,6.88,0.43,196.484,19,15
243,1.89,0.11,100,89.0,79.21,53.4,62.3,18.9,14.9,15.9,-1.1,2.9,1.9,60,70,16,17,1.1,4,3,36,42,13,-4,-2.9,-1,49,-3,-1.9,1,62.684,10,8.9,0.89,56.684,6,7
244,1.24,0.76,361,86.64,20.79,0.0,82.08,23.56,4.56,22.56,-14.44,4.56,-13.44,0,342,19,37,14.44,19,1,0,0,18,-19,-4.56,-18,324,-1,13.44,18,305.342,19,4.56,0.24,305.342,0,18
245,1.52,0.48,169,87.88,45.7,81.12,74.36,19.76,18.76,17.76,-6.24,-5.24,-4.24,156,143,25,24,6.24,1,2,144,132,23,-1,5.24,1,121,-2,4.24,-1,127.928,13,6.76,0.52,115.928,12,11
246,1.5,0.5,144,72.0,36.0,12.0,60.0,18.0,8.0,16.0,-6.0,4.0,-4.0,24,120,14,22,6.0,10,2,4,20,12,-10,-4.0,-8,100,-2,4.0,8,101.618,12,6.0,0.5,99.618,2,10
247,1.8,0.2,4,3.2,2.56,20.8,4.8,3.6,14.6,4.6,-0.4,-11.4,-1.4,26,6,15,5,0.4,-11,-1,169,39,16,11,11.4,10,9,1,1.4,-10,16.664,2,1.6,0.8,3.6640000000000015,13,3
248,1.11,0.89,169,18.59,2.04,18.59,21.45,14.43,14.43,16.43,-11.57,-11.57,-13.57,169,195,26,28,11.57,0,-2,169,195,28,0,11.57,-2,225,2,13.57,2,196.576,13,1.43,0.11,183.576,13,15
249,1.42,0.58,225,94.5,39.69,94.5,44.1,21.3,21.3,13.3,-8.7,-8.7,-0.7,225,105,30,22,8.7,0,8,225,105,22,0,8.7,8,49,-8,0.7,-8,126.274,15,6.3,0.42,111.274,15,7
250,1.63,0.37,324,204.12,128.6,34.02,170.1,29.34,14.34,26.34,-6.66,8.34,-3.66,54,270,21,33,6.66,15,3,9,45,18,-15,-8.34,-12,225,-3,3.66,12,210.692,18,11.34,0.63,207.692,3,15
251,1.87,0.13,4,3.48,3.03,19.14,10.44,3.74,12.74,7.74,-0.26,-9.26,-4.26,22,12,13,8,0.26,-9,-4,121,66,17,9,9.26,5,36,4,4.26,-5,15.19,2,1.74,0.87,4.1899999999999995,11,6
252,1.52,0.48,400,208.0,108.16,93.6,83.2,30.4,19.4,18.4,-9.6,1.4,2.4,180,160,29,28,9.6,11,12,81,72,17,-11,-1.4,1,64,-12,-2.4,-1,194.906,20,10.4,0.52,185.906,9,8
253,1.89,0.11,36,32.04,28.52,37.38,26.7,11.34,12.34,10.34,-0.66,-1.66,0.34,42,30,13,11,0.66,-1,1,49,35,12,1,1.66,2,25,-1,-0.34,-2,29.008,6,5.34,0.89,22.008,7,5
254,1.74,0.26,100,74.0,54.76,103.6,81.4,17.4,21.4,18.4,-2.6,-6.6,-3.6,140,110,24,21,2.6,-4,-1,196,154,25,4,6.6,3,121,1,3.6,-3,83.304,10,7.4,0.74,69.304,14,11
255,1.47,0.53,225,105.75,49.7,35.25,14.1,22.05,12.05,9.05,-7.95,2.05,5.05,75,30,20,17,7.95,10,13,25,10,7,-10,-2.05,3,4,-13,-5.05,-3,77.476,15,7.05,0.47,72.476,5,2
256,1.63,0.37,9,5.67,3.57,7.56,30.24,4.89,5.89,17.89,-1.11,-2.11,-14.11,12,48,7,19,1.11,-1,-13,16,64,20,1,2.11,-12,256,13,14.11,12,25.66,3,1.89,0.63,21.66,4,16
257,1.91,0.09,9,8.19,7.45,38.22,2.73,5.73,16.73,3.73,-0.27,-11.27,1.73,42,3,17,4,0.27,-11,2,196,14,15,11,11.27,13,1,-2,-1.73,-13,19.756,3,2.73,0.91,5.756,14,1
258,1.12,0.88,196,23.52,2.82,8.4,33.6,15.68,6.68,21.68,-12.32,-3.32,-18.32,70,280,19,34,12.32,9,-6,25,100,25,-9,3.32,-15,400,6,18.32,15,263.024,14,1.68,0.12,258.024,5,20
259,1.6,0.4,4,2.4,1.44,10.8,6.0,3.2,10.2,6.2,-0.8,-7.8,-3.8,18,10,11,7,0.8,-7,-3,81,45,14,7,7.8,4,25,3,3.8,-4,14.792,2,1.2,0.6,5.792,9,5
260,1.69,0.31,225,155.25,107.12,155.25,72.45,25.35,25.35,17.35,-4.65,-4.65,3.35,225,105,30,22,4.65,0,8,225,105,22,0,4.65,8,49,-8,-3.35,-8,130.176,15,10.35,0.69,115.17599999999999,15,7
261,1.46,0.54,144,66.24,30.47,27.6,110.4,17.52,10.52,25.52,-6.48,0.52,-14.48,60,240,17,32,6.48,7,-8,25,100,25,-7,-0.52,-15,400,8,14.48,15,171.59,12,5.52,0.46,166.59,5,20
262,1.43,0.57,81,34.83,14.98,65.79,19.35,12.87,20.87,8.87,-5.13,-13.13,-1.13,153,45,26,14,5.13,-8,4,289,85,22,8,13.13,12,25,-4,1.13,-12,61.938,9,3.87,0.43,44.938,17,5
263,1.75,0.25,1,0.75,0.56,8.25,0.0,1.75,11.75,0.75,-0.25,-10.25,0.75,11,0,12,1,0.25,-10,1,121,0,11,10,10.25,11,0,-1,-0.75,-11,11.772,1,0.75,0.75,0.7720000000000002,11,0
264,1.7,0.3,1,0.7,0.49,2.8,2.1,1.7,4.7,3.7,-0.3,-3.3,-2.3,4,3,5,4,0.3,-3,-2,16,12,7,3,3.3,1,9,2,2.3,-1,5.588,1,0.7,0.7,1.588,4,3
265,1.08,0.92,400,32.0,2.56,3.2,30.4,21.6,3.6,20.6,-18.4,-0.4,-17.4,40,380,22,39,18.4,18,1,4,38,21,-18,0.4,-17,361,-1,17.4,17,368.296,20,1.6,0.08,366.296,2,19
266,1.89,0.11,36,32.04,28.52,80.1,64.08,11.34,20.34,17.34,-0.66,-9.66,-6.66,90,72,21,18,0.66,-9,-6,225,180,27,9,9.66,3,144,6,6.66,-3,41.876,6,5.34,0.89,26.875999999999998,15,12
267,1.15,0.85,49,7.35,1.1,6.3,9.45,8.05,7.05,10.05,-5.95,-4.95,-7.95,42,63,13,16,5.95,1,-2,36,54,15,-1,4.95,-3,81,2,7.95,3,63.684,7,1.05,0.15,57.684,6,9
268,1.4,0.6,1,0.4,0.16,3.2,6.4,1.4,8.4,16.4,-0.6,-7.6,-15.6,8,16,9,17,0.6,-7,-15,64,128,24,7,7.6,-8,256,15,15.6,8,18.0,1,0.4,0.4,10.0,8,16
269,1.2,0.8,225,45.0,9.0,9.0,54.0,18.0,6.0,21.0,-12.0,0.0,-15.0,45,270,18,33,12.0,12,-3,9,54,21,-12,0.0,-15,324,3,15.0,15,241.488,15,3.0,0.2,238.488,3,18
270,1.78,0.22,225,175.5,136.89,187.2,70.2,26.7,27.7,17.7,-3.3,-4.3,5.7,240,90,31,21,3.3,-1,9,256,96,22,1,4.3,10,36,-9,-5.7,-10,129.236,15,11.7,0.78,113.23599999999999,16,6
271,1.76,0.24,4,3.04,2.31,21.28,19.76,3.52,15.52,14.52,-0.48,-12.48,-11.48,28,26,16,15,0.48,-12,-11,196,182,27,12,12.48,1,169,11,11.48,-1,22.294,2,1.52,0.76,8.294,14,13
272,1.77,0.23,121,93.17,71.74,143.99,152.46,19.47,25.47,26.47,-2.53,-8.53,-9.53,187,198,28,29,2.53,-6,-7,289,306,35,6,8.53,-1,324,7,9.53,1,114.14,11,8.47,0.77,97.14,17,18
273,1.78,0.22,289,225.42,175.83,145.86,66.3,30.26,24.26,18.26,-3.74,2.26,8.26,187,85,28,22,3.74,6,12,121,55,16,-6,-2.26,6,25,-12,-8.26,-6,149.244,17,13.26,0.78,138.244,11,5
274,1.58,0.42,81,46.98,27.25,78.3,73.08,14.22,20.22,19.22,-3.78,-9.78,-8.78,135,126,24,23,3.78,-6,-5,225,210,29,6,9.78,1,196,5,8.78,-1,93.886,9,5.22,0.58,78.886,15,14
275,1.83,0.17,25,20.75,17.22,83.0,33.2,9.15,24.15,12.15,-0.85,-15.85,-3.85,100,40,25,13,0.85,-15,-3,400,160,28,15,15.85,12,64,3,3.85,-12,39.302,5,4.15,0.83,19.302,20,8
276,1.38,0.62,121,45.98,17.47,25.08,16.72,15.18,10.18,8.18,-6.82,-1.82,0.18,66,44,17,15,6.82,5,7,36,24,10,-5,1.82,2,16,-7,-0.18,-2,58.052,11,4.18,0.38,52.052,6,4
277,1.88,0.12,100,88.0,77.44,167.2,149.6,18.8,27.8,25.8,-1.2,-10.2,-8.2,190,170,29,27,1.2,-9,-7,361,323,36,9,10.2,2,289,7,8.2,-2,87.254,10,8.8,0.88,68.254,19,17
278,1.57,0.43,196,111.72,63.68,39.9,119.7,21.98,12.98,22.98,-6.02,2.98,-7.02,70,210,19,29,6.02,9,-1,25,75,20,-9,-2.98,-10,225,1,7.02,10,155.26,14,7.98,0.57,150.26,5,15
279,1.17,0.83,400,68.0,11.56,0.0,37.4,23.4,3.4,14.4,-16.6,3.4,-7.6,0,220,20,31,16.6,20,9,0,0,11,-20,-3.4,-11,121,-9,7.6,11,218.072,20,3.4,0.17,218.072,0,11
280,1.65,0.35,361,234.65,152.52,86.45,135.85,31.35,19.35,23.35,-6.65,5.35,1.35,133,209,26,30,6.65,12,8,49,77,18,-12,-5.35,-4,121,-8,-1.35,4,203.58,19,12.35,0.65,196.58,7,11
281,1.67,0.33,144,96.48,64.64,112.56,48.24,20.04,22.04,14.04,-3.96,-5.96,2.04,168,72,26,18,3.96,-2,6,196,84,20,2,5.96,8,36,-6,-2.04,-8,90.132,12,8.04,0.67,76.132,14,6
282,1.71,0.29,4,2.84,2.02,0.0,2.84,3.42,1.42,3.42,-0.58,1.42,-0.58,0,4,2,4,0.58,2,0,0,0,2,-2,-1.42,-2,4,0,0.58,2,3.27,2,1.42,0.71,3.27,0,2
283,1.62,0.38,400,248.0,153.76,148.8,24.8,32.4,24.4,14.4,-7.6,0.4,10.4,240,40,32,22,7.6,8,18,144,24,14,-8,-0.4,10,4,-18,-10.4,-10,157.356,20,12.4,0.62,145.356,12,2
284,1.58,0.42,256,148.48,86.12,92.8,55.68,25.28,19.28,15.28,-6.72,-0.72,3.28,160,96,26,22,6.72,6,10,100,60,16,-6,0.72,4,36,-10,-3.28,-4,129.31,16,9.28,0.58,119.31,10,6
285,1.16,0.84,169,27.04,4.33,24.96,29.12,15.08,14.08,16.08,-10.92,-9.92,-11.92,156,182,25,27,10.92,1,-1,144,168,26,-1,9.92,-2,196,1,11.92,2,180.066,13,2.08,0.16,168.066,12,14
286,1.83,0.17,196,162.68,135.02,104.58,209.16,25.62,20.62,29.62,-2.38,2.62,-6.38,126,252,23,32,2.38,5,-4,81,162,27,-5,-2.62,-9,324,4,6.38,9,139.444,14,11.62,0.83,130.444,9,18
287,1.26,0.74,49,12.74,3.31,25.48,25.48,8.82,15.82,15.82,-5.18,-12.18,-12.18,98,98,21,21,5.18,-7,-7,196,196,28,7,12.18,0,196,7,12.18,0,94.556,7,1.82,0.26,80.556,14,14
288,1.8,0.2,4,3.2,2.56,30.4,12.8,3.6,20.6,9.6,-0.4,-17.4,-6.4,38,16,21,10,0.4,-17,-6,361,152,27,17,17.4,11,64,6,6.4,-11,24.61,2,1.6,0.8,5.609999999999999,19,8
289,1.69,0.31,196,135.24,93.32,173.88,48.3,23.66,27.66,14.66,-4.34,-8.34,4.66,252,70,32,19,4.34,-4,9,324,90,23,4,8.34,13,25,-9,-4.66,-13,112.174,14,9.66,0.69,94.174,18,5
290,1.56,0.44,100,56.0,31.36,106.4,67.2,15.6,24.6,17.6,-4.4,-13.4,-6.4,190,120,29,22,4.4,-9,-2,361,228,31,9,13.4,7,144,2,6.4,-7,102.108,10,5.6,0.56,83.108,19,12
291,1.34,0.66,289,98.26,33.41,75.14,115.6,22.78,18.78,25.78,-11.22,-7.22,-14.22,221,340,30,37,11.22,4,-3,169,260,33,-4,7.22,-7,400,3,14.22,7,290.89,17,5.78,0.34,277.89,13,20
292,1.74,0.26,144,106.56,78.85,44.4,150.96,20.88,13.88,25.88,-3.12,3.88,-8.12,60,204,17,29,3.12,7,-5,25,85,22,-7,-3.88,-12,289,5,8.12,12,115.35,12,8.88,0.74,110.35,5,17
293,1.31,0.69,25,7.75,2.4,4.65,15.5,6.55,4.55,11.55,-3.45,-1.45,-8.45,15,50,8,15,3.45,2,-5,9,30,13,-2,1.45,-7,100,5,8.45,7,41.65,5,1.55,0.31,38.65,3,10
294,1.84,0.16,36,30.24,25.4,35.28,85.68,11.04,12.04,22.04,-0.96,-1.96,-11.96,42,102,13,23,0.96,-1,-11,49,119,24,1,1.96,-10,289,11,11.96,10,40.694,6,5.04,0.84,33.694,7,17
295,1.84,0.16,25,21.0,17.64,29.4,29.4,9.2,11.2,11.2,-0.8,-2.8,-2.8,35,35,12,12,0.8,-2,-2,49,49,14,2,2.8,0,49,2,2.8,0,25.484,5,4.2,0.84,18.484,7,7
296,1.41,0.59,289,118.49,48.58,76.67,0.0,23.97,17.97,6.97,-10.03,-4.03,6.97,187,0,28,17,10.03,6,17,121,0,11,-6,4.03,11,0,-17,-6.97,-11,74.57,17,6.97,0.41,63.56999999999999,11,0
297,1.93,0.07,225,209.25,194.6,139.5,111.6,28.95,23.95,21.95,-1.05,3.95,5.95,150,120,25,23,1.05,5,7,100,80,18,-5,-3.95,2,64,-7,-5.95,-2,129.934,15,13.95,0.93,119.934,10,8
298,1.19,0.81,64,12.16,2.31,4.56,1.52,9.52,4.52,2.52,-6.48,-1.48,0.52,24,8,11,9,6.48,5,7,9,3,4,-5,1.48,2,1,-7,-0.52,-2,16.17,8,1.52,0.19,13.170000000000002,3,1
299,1.2,0.8,256,51.2,10.24,60.8,60.8,19.2,22.2,22.2,-12.8,-15.8,-15.8,304,304,35,35,12.8,-3,-3,361,361,38,3,15.8,0,361,3,15.8,0,288.99,16,3.2,0.2,269.99,19,19
300,1.26,0.74,256,66.56,17.31,29.12,83.2,20.16,11.16,24.16,-11.84,-2.84,-15.84,112,320,23,36,11.84,9,-4,49,140,27,-9,2.84,-13,400,4,15.84,13,278.668,16,4.16,0.26,271.668,7,20
301,1.45,0.55,25,11.25,5.06,45.0,40.5,7.25,22.25,20.25,-2.75,-17.75,-15.75,100,90,25,23,2.75,-15,-13,400,360,38,15,17.75,2,324,13,15.75,-2,77.2,5,2.25,0.45,57.2,20,18
302,1.47,0.53,144,67.68,31.81,16.92,95.88,17.64,8.64,22.64,-6.36,2.64,-11.36,36,204,15,29,6.36,9,-5,9,51,20,-9,-2.64,-14,289,5,11.36,14,148.49,12,5.64,0.47,145.49,3,17
303,1.82,0.18,49,40.18,32.95,91.84,114.8,12.74,21.74,25.74,-1.26,-10.26,-14.26,112,140,23,27,1.26,-9,-13,256,320,36,9,10.26,-4,400,13,14.26,4,64.564,7,5.74,0.82,48.56399999999999,16,20
304,1.91,0.09,289,262.99,239.32,30.94,309.4,32.47,17.47,35.47,-1.53,13.47,-4.53,34,340,19,37,1.53,15,-3,4,40,22,-15,-13.47,-18,400,3,4.53,18,172.264,17,15.47,0.91,170.264,2,20
305,1.15,0.85,289,43.35,6.5,22.95,7.65,19.55,11.55,5.55,-14.45,-6.45,-0.45,153,51,26,20,14.45,8,14,81,27,12,-8,6.45,6,9,-14,0.45,-6,75.256,17,2.55,0.15,66.256,9,3
306,1.29,0.71,324,93.96,27.25,78.3,26.1,23.22,20.22,10.22,-12.78,-9.78,0.22,270,90,33,23,12.78,3,13,225,75,20,-3,9.78,10,25,-13,-0.22,-10,127.824,18,5.22,0.29,112.824,15,5
307,1.77,0.23,169,130.13,100.2,150.15,10.01,23.01,25.01,11.01,-2.99,-4.99,9.01,195,13,28,14,2.99,-2,12,225,15,16,2,4.99,14,1,-12,-9.01,-14,88.434,13,10.01,0.77,73.434,15,1
308,1.44,0.56,1,0.44,0.19,0.0,5.28,1.44,0.44,12.44,-0.56,0.44,-11.56,0,12,1,13,0.56,1,-11,0,0,12,-1,-0.44,-12,144,11,11.56,12,6.984,1,0.44,0.44,6.984,0,12
309,1.71,0.29,144,102.24,72.59,42.6,25.56,20.52,13.52,11.52,-3.48,3.52,5.52,60,36,17,15,3.48,7,9,25,15,8,-7,-3.52,2,9,-9,-5.52,-2,71.07,12,8.52,0.71,66.07,5,3
310,1.84,0.16,100,84.0,70.56,84.0,8.4,18.4,18.4,9.4,-1.6,-1.6,7.4,100,10,20,11,1.6,0,9,100,10,11,0,1.6,9,1,-9,-7.4,-9,58.072,10,8.4,0.84,48.072,10,1
311,1.36,0.64,256,92.16,33.18,57.6,115.2,21.76,15.76,25.76,-10.24,-4.24,-14.24,160,320,26,36,10.24,6,-4,100,200,30,-6,4.24,-10,400,4,14.24,10,264.772,16,5.76,0.36,254.772,10,20
312,1.24,0.76,64,15.36,3.69,7.68,36.48,9.92,5.92,20.92,-6.08,-2.08,-17.08,32,152,12,27,6.08,4,-11,16,76,23,-4,2.08,-15,361,11,17.08,15,127.868,8,1.92,0.24,123.868,4,19
313,1.83,0.17,1,0.83,0.69,13.28,1.66,1.83,16.83,2.83,-0.17,-15.17,-1.17,16,2,17,3,0.17,-15,-1,256,32,18,15,15.17,14,4,1,1.17,-14,17.152,1,0.83,0.83,1.152000000000001,16,2
314,1.33,0.67,100,33.0,10.89,19.8,16.5,13.3,9.3,8.3,-6.7,-2.7,-1.7,60,50,16,15,6.7,4,5,36,30,11,-4,2.7,1,25,-5,1.7,-1,57.67,10,3.3,0.33,51.67,6,5
315,1.8,0.2,4,3.2,2.56,11.2,25.6,3.6,8.6,17.6,-0.4,-5.4,-14.4,14,32,9,18,0.4,-5,-14,49,112,23,5,5.4,-9,256,14,14.4,9,15.702,2,1.6,0.8,8.702,7,16
316,1.66,0.34,256,168.96,111.51,137.28,42.24,26.56,23.56,14.56,-5.44,-2.44,6.56,208,64,29,20,5.44,3,12,169,52,17,-3,2.44,9,16,-12,-6.56,-9,123.5,16,10.56,0.66,110.5,13,4
317,1.56,0.44,400,224.0,125.44,156.8,44.8,31.2,25.2,15.2,-8.8,-2.8,7.2,280,80,34,24,8.8,6,16,196,56,18,-6,2.8,10,16,-16,-7.2,-10,166.68,20,11.2,0.56,152.68,14,4
318,1.38,0.62,144,54.72,20.79,22.8,91.2,16.56,9.56,24.56,-7.44,-0.44,-15.44,60,240,17,32,7.44,7,-8,25,100,25,-7,0.44,-15,400,8,15.44,15,184.934,12,4.56,0.38,179.934,5,20
319,1.38,0.62,36,13.68,5.2,9.12,41.04,8.28,6.28,20.28,-3.72,-1.72,-15.72,24,108,10,24,3.72,2,-12,16,72,22,-2,1.72,-14,324,12,15.72,14,79.016,6,2.28,0.38,75.016,4,18
320,1.32,0.68,361,115.52,36.97,79.04,91.2,25.08,19.08,21.08,-12.92,-6.92,-8.92,247,285,32,34,12.92,6,4,169,195,28,-6,6.92,-2,225,-4,8.92,2,268.582,19,6.08,0.32,255.582,13,15
321,1.74,0.26,256,189.44,140.19,142.08,165.76,27.84,23.84,25.84,-4.16,-0.16,-2.16,192,224,28,30,4.16,4,2,144,168,26,-4,0.16,-2,196,-2,2.16,2,170.208,16,11.84,0.74,158.208,12,14
322,1.87,0.13,121,105.27,91.58,47.85,191.4,20.57,14.57,29.57,-1.43,4.57,-10.43,55,220,16,31,1.43,6,-9,25,100,25,-6,-4.57,-15,400,9,10.43,15,90.166,11,9.57,0.87,85.166,5,20
323,1.6,0.4,25,15.0,9.0,18.0,42.0,8.0,9.0,17.0,-2.0,-3.0,-11.0,30,70,11,19,2.0,-1,-9,36,84,20,1,3.0,-8,196,9,11.0,8,41.818,5,3.0,0.6,35.818,6,14
324,1.27,0.73,196,52.92,14.29,49.14,11.34,17.78,16.78,6.78,-10.22,-9.22,0.78,182,42,27,17,10.22,1,11,169,39,16,-1,9.22,10,9,-11,-0.78,-10,72.13,14,3.78,0.27,59.129999999999995,13,3
325,1.26,0.74,25,6.5,1.69,26.0,15.6,6.3,21.3,13.3,-3.7,-18.7,-10.7,100,60,25,17,3.7,-15,-7,400,240,32,15,18.7,8,144,7,10.7,-8,67.866,5,1.3,0.26,47.866,20,12
326,1.74,0.26,144,106.56,78.85,35.52,88.8,20.88,12.88,18.88,-3.12,4.88,-1.12,48,120,16,22,3.12,8,2,16,40,14,-8,-4.88,-6,100,-2,1.12,6,92.612,12,8.88,0.74,88.612,4,10
327,1.16,0.84,144,23.04,3.69,30.72,11.52,13.92,17.92,7.92,-10.08,-14.08,-4.08,192,72,28,18,10.08,-4,6,256,96,22,4,14.08,10,36,-6,4.08,-10,89.126,12,1.92,0.16,73.126,16,6
328,1.47,0.53,121,56.87,26.73,0.0,98.23,16.17,5.17,24.17,-5.83,5.17,-13.83,0,209,11,30,5.83,11,-8,0,0,19,-11,-5.17,-19,361,8,13.83,19,142.324,11,5.17,0.47,142.324,0,19
329,1.16,0.84,196,31.36,5.02,38.08,38.08,16.24,19.24,19.24,-11.76,-14.76,-14.76,238,238,31,31,11.76,-3,-3,289,289,34,3,14.76,0,289,3,14.76,0,232.872,14,2.24,0.16,215.872,17,17
330,1.62,0.38,121,75.02,46.51,95.48,54.56,17.82,20.82,14.82,-4.18,-7.18,-1.18,154,88,25,19,4.18,-3,3,196,112,22,3,7.18,6,64,-3,1.18,-6,87.764,11,6.82,0.62,73.764,14,8
331,1.9,0.1,361,324.9,292.41,222.3,17.1,36.1,30.1,18.1,-1.9,4.1,16.1,247,19,32,20,1.9,6,18,169,13,14,-6,-4.1,12,1,-18,-16.1,-12,185.258,19,17.1,0.9,172.258,13,1
332,1.46,0.54,169,77.74,35.76,101.66,29.9,18.98,22.98,10.98,-7.02,-11.02,0.98,221,65,30,18,7.02,-4,8,289,85,22,4,11.02,12,25,-8,-0.98,-12,93.46,13,5.98,0.46,76.46,17,5
333,1.55,0.45,16,8.8,4.84,26.4,30.8,6.2,14.2,16.2,-1.8,-9.8,-11.8,48,56,16,18,1.8,-8,-10,144,168,26,8,9.8,-2,196,10,11.8,2,42.268,4,2.2,0.55,30.268,12,14
334,1.62,0.38,1,0.62,0.38,3.1,11.78,1.62,5.62,19.62,-0.38,-4.38,-18.38,5,19,6,20,0.38,-4,-18,25,95,24,4,4.38,-14,361,18,18.38,14,12.444,1,0.62,0.62,7.444000000000001,5,19
335,1.61,0.39,324,197.64,120.56,109.8,98.82,28.98,20.98,19.98,-7.02,0.98,1.98,180,162,28,27,7.02,8,9,100,90,19,-8,-0.98,1,81,-9,-1.98,-1,178.012,18,10.98,0.61,168.012,10,9
336,1.79,0.21,169,133.51,105.47,112.97,133.51,23.27,21.27,23.27,-2.73,-0.73,-2.73,143,169,24,26,2.73,2,0,121,143,24,-2,0.73,-2,169,0,2.73,2,118.754,13,10.27,0.79,107.754,11,13
337,1.76,0.24,81,61.56,46.79,20.52,88.92,15.84,9.84,19.84,-2.16,3.84,-6.16,27,117,12,22,2.16,6,-4,9,39,16,-6,-3.84,-10,169,4,6.16,10,65.538,9,6.84,0.76,62.538,3,13
338,1.64,0.36,169,108.16,69.22,158.08,99.84,21.32,27.32,20.32,-4.68,-10.68,-3.68,247,156,32,25,4.68,-6,1,361,228,31,6,10.68,7,144,-1,3.68,-7,133.384,13,8.32,0.64,114.38399999999999,19,12
339,1.57,0.43,144,82.08,46.79,6.84,95.76,18.84,7.84,20.84,-5.16,5.84,-7.16,12,168,13,26,5.16,11,-2,1,14,15,-11,-5.84,-13,196,2,7.16,13,117.398,12,6.84,0.57,116.398,1,14
340,1.41,0.59,289,118.49,48.58,6.97,13.94,23.97,7.97,8.97,-10.03,5.97,4.97,17,34,18,19,10.03,16,15,1,2,3,-16,-5.97,-1,4,-15,-4.97,1,84.372,17,6.97,0.41,83.372,1,2
341,1.25,0.75,169,42.25,10.56,26.0,26.0,16.25,11.25,11.25,-9.75,-4.75,-4.75,104,104,21,21,9.75,5,5,64,64,16,-5,4.75,0,64,-5,4.75,0,108.816,13,3.25,0.25,100.816,8,8
342,1.42,0.58,49,20.58,8.64,41.16,14.7,9.94,16.94,7.94,-4.06,-11.06,-2.06,98,35,21,12,4.06,-7,2,196,70,19,7,11.06,9,25,-2,2.06,-9,45.82,7,2.94,0.42,31.82,14,5
343,1.09,0.91,169,15.21,1.37,5.85,0.0,14.17,6.17,1.17,-11.83,-3.83,1.17,65,0,18,13,11.83,8,13,25,0,5,-8,3.83,5,0,-13,-1.17,-5,12.666,13,1.17,0.09,7.666,5,0
344,1.32,0.68,9,2.88,0.92,18.24,11.52,3.96,19.96,12.96,-2.04,-18.04,-11.04,57,36,22,15,2.04,-16,-9,361,228,31,16,18.04,7,144,9,11.04,-7,45.68,3,0.96,0.32,26.68,19,12
345,1.38,0.62,36,13.68,5.2,41.04,6.84,8.28,20.28,5.28,-3.72,-15.72,-0.72,108,18,24,9,3.72,-12,3,324,54,21,12,15.72,15,9,-3,0.72,-15,37.138,6,2.28,0.38,19.137999999999998,18,3
346,1.69,0.31,324,223.56,154.26,86.94,211.14,30.42,19.42,29.42,-5.58,5.42,-4.58,126,306,25,35,5.58,11,1,49,119,24,-11,-5.42,-10,289,-1,4.58,10,218.462,18,12.42,0.69,211.462,7,17
347,1.17,0.83,361,61.37,10.43,41.99,64.6,22.23,16.23,23.23,-15.77,-9.77,-16.77,247,380,32,39,15.77,6,-1,169,260,33,-6,9.77,-7,400,1,16.77,7,360.384,19,3.23,0.17,347.384,13,20
348,1.51,0.49,9,4.59,2.34,10.71,19.89,4.53,8.53,14.53,-1.47,-5.47,-11.47,21,39,10,16,1.47,-4,-10,49,91,20,4,5.47,-6,169,10,11.47,6,29.744,3,1.53,0.51,22.744,7,13
349,1.51,0.49,1,0.51,0.26,8.16,8.16,1.51,16.51,16.51,-0.49,-15.49,-15.49,16,16,17,17,0.49,-15,-15,256,256,32,15,15.49,0,256,15,15.49,0,24.53,1,0.51,0.51,8.530000000000001,16,16
350,1.56,0.44,256,143.36,80.28,53.76,71.68,24.96,14.96,16.96,-7.04,2.96,0.96,96,128,22,24,7.04,10,8,36,48,14,-10,-2.96,-2,64,-8,-0.96,2,139.326,16,8.96,0.56,133.326,6,8
351,1.58,0.42,1,0.58,0.34,11.6,4.06,1.58,20.58,7.58,-0.42,-19.42,-6.42,20,7,21,8,0.42,-19,-6,400,140,27,19,19.42,13,49,6,6.42,-13,23.376,1,0.58,0.58,3.3760000000000012,20,7
352,1.82,0.18,100,82.0,67.24,164.0,82.0,18.2,28.2,18.2,-1.8,-11.8,-1.8,200,100,30,20,1.8,-10,0,400,200,30,10,11.8,10,100,0,1.8,-10,83.178,10,8.2,0.82,63.178,20,10
353,1.09,0.91,289,26.01,2.34,15.3,26.01,18.53,11.53,18.53,-15.47,-8.47,-15.47,170,289,27,34,15.47,7,0,100,170,27,-7,8.47,-7,289,0,15.47,7,285.74,17,1.53,0.09,275.74,10,17
354,1.81,0.19,400,324.0,262.44,307.8,48.6,36.2,35.2,19.2,-3.8,-2.8,13.2,380,60,39,23,3.8,1,17,361,57,22,-1,2.8,16,9,-17,-13.2,-16,199.944,20,16.2,0.81,180.944,19,3
355,1.69,0.31,256,176.64,121.88,187.68,220.8,27.04,28.04,31.04,-4.96,-5.96,-8.96,272,320,33,36,4.96,-1,-4,289,340,37,1,5.96,-3,400,4,8.96,3,209.528,16,11.04,0.69,192.528,17,20
356,1.08,0.92,361,28.88,2.31,6.08,30.4,20.52,5.52,21.52,-17.48,-2.48,-18.48,76,380,23,39,17.48,15,-1,16,80,24,-15,2.48,-16,400,1,18.48,16,368.394,19,1.52,0.08,364.394,4,20
357,1.73,0.27,64,46.72,34.11,17.52,46.72,13.84,8.84,13.84,-2.16,2.84,-2.16,24,64,11,16,2.16,5,0,9,24,11,-5,-2.84,-5,64,0,2.16,5,46.436,8,5.84,0.73,43.436,3,8
358,1.42,0.58,324,136.08,57.15,90.72,0.0,25.56,19.56,7.56,-10.44,-4.44,7.56,216,0,30,18,10.44,6,18,144,0,12,-6,4.44,12,0,-18,-7.56,-12,83.688,18,7.56,0.42,71.688,12,0
359,1.9,0.1,81,72.9,65.61,24.3,40.5,17.1,11.1,13.1,-0.9,5.1,3.1,27,45,12,14,0.9,6,4,9,15,8,-6,-5.1,-2,25,-4,-3.1,2,48.014,9,8.1,0.9,45.014,3,5
360,1.4,0.6,9,3.6,1.44,2.4,14.4,4.2,3.2,13.2,-1.8,-0.8,-10.8,6,36,5,15,1.8,1,-9,4,24,14,-1,0.8,-10,144,9,10.8,10,26.326,3,1.2,0.4,24.326,2,12
361,1.69,0.31,144,99.36,68.56,49.68,74.52,20.28,14.28,17.28,-3.72,2.28,-0.72,72,108,18,21,3.72,6,3,36,54,15,-6,-2.28,-3,81,-3,0.72,3,93.73,12,8.28,0.69,87.73,6,9
362,1.73,0.27,256,186.88,136.42,105.12,175.2,27.68,20.68,26.68,-4.32,2.68,-3.32,144,240,25,31,4.32,7,1,81,135,24,-7,-2.68,-6,225,-1,3.32,6,174.028,16,11.68,0.73,165.028,9,15
363,1.76,0.24,36,27.36,20.79,9.12,86.64,10.56,6.56,23.56,-1.44,2.56,-14.44,12,114,8,25,1.44,4,-13,4,38,21,-4,-2.56,-17,361,13,14.44,17,45.524,6,4.56,0.76,43.524,2,19
364,1.06,0.94,49,2.94,0.18,7.14,3.36,7.42,17.42,8.42,-6.58,-16.58,-7.58,119,56,24,15,6.58,-10,-1,289,136,25,10,16.58,9,64,1,7.58,-9,71.352,7,0.42,0.06,54.352000000000004,17,8
365,1.44,0.56,64,28.16,12.39,52.8,17.6,11.52,18.52,8.52,-4.48,-11.48,-1.48,120,40,23,13,4.48,-7,3,225,75,20,7,11.48,10,25,-3,1.48,-10,53.3,8,3.52,0.44,38.3,15,5
366,1.41,0.59,25,10.25,4.2,2.05,30.75,7.05,3.05,17.05,-2.95,1.05,-12.95,5,75,6,20,2.95,4,-10,1,15,16,-4,-1.05,-14,225,10,12.95,14,51.396,5,2.05,0.41,50.396,1,15
367,1.89,0.11,361,321.29,285.95,33.82,219.83,35.91,18.91,29.91,-2.09,14.91,3.91,38,247,21,32,2.09,17,6,4,26,15,-17,-14.91,-11,169,-6,-3.91,11,198.042,19,16.91,0.89,196.042,2,13
368,1.72,0.28,1,0.72,0.52,0.0,10.8,1.72,0.72,15.72,-0.28,0.72,-14.28,0,15,1,16,0.28,1,-14,0,0,15,-1,-0.72,-15,225,14,14.28,15,4.836,1,0.72,0.72,4.836,0,15
369,1.09,0.91,121,10.89,0.98,4.95,15.84,11.99,5.99,16.99,-10.01,-4.01,-15.01,55,176,16,27,10.01,6,-5,25,80,21,-6,4.01,-11,256,5,15.01,11,171.272,11,0.99,0.09,166.272,5,16
370,1.11,0.89,36,3.96,0.44,1.32,9.9,6.66,2.66,15.66,-5.34,-1.34,-14.34,12,90,8,21,5.34,4,-9,4,30,17,-4,1.34,-13,225,9,14.34,13,84.08,6,0.66,0.11,82.08,2,15
371,1.78,0.22,64,49.92,38.94,43.68,24.96,14.24,13.24,10.24,-1.76,-0.76,2.24,56,32,15,12,1.76,1,4,49,28,11,-1,0.76,3,16,-4,-2.24,-3,42.088,8,6.24,0.78,35.088,7,4
372,1.58,0.42,225,130.5,75.69,113.1,113.1,23.7,21.7,21.7,-6.3,-4.3,-4.3,195,195,28,28,6.3,2,2,169,169,26,-2,4.3,0,169,-2,4.3,0,164.512,15,8.7,0.58,151.512,13,13
373,1.54,0.46,361,194.94,105.27,82.08,112.86,29.26,18.26,21.26,-8.74,2.26,-0.74,152,209,27,30,8.74,11,8,64,88,19,-11,-2.26,-3,121,-8,0.74,3,207.212,19,10.26,0.54,199.212,8,11
374,1.77,0.23,121,93.17,71.74,93.17,143.99,19.47,19.47,25.47,-2.53,-2.53,-8.53,121,187,22,28,2.53,0,-6,121,187,28,0,2.53,-6,289,6,8.53,6,104.92,11,8.47,0.77,93.92,11,17
375,1.08,0.92,256,20.48,1.64,17.92,8.96,17.28,15.28,8.28,-14.72,-12.72,-5.72,224,112,30,23,14.72,2,9,196,98,21,-2,12.72,7,49,-9,5.72,-7,127.73,16,1.28,0.08,113.73,14,7
376,1.34,0.66,225,76.5,26.01,10.2,96.9,20.1,7.1,24.1,-9.9,3.1,-13.9,30,285,17,34,9.9,13,-4,4,38,21,-13,-3.1,-17,361,4,13.9,17,233.056,15,5.1,0.34,231.056,2,19
377,1.16,0.84,324,51.84,8.29,34.56,48.96,20.88,14.88,19.88,-15.12,-9.12,-14.12,216,306,30,35,15.12,6,1,144,204,29,-6,9.12,-5,289,-1,14.12,5,296.652,18,2.88,0.16,284.652,12,17
378,1.93,0.07,1,0.93,0.86,2.79,13.02,1.93,3.93,14.93,-0.07,-2.07,-13.07,3,14,4,15,0.07,-2,-13,9,42,17,2,2.07,-11,196,13,13.07,11,5.04,1,0.93,0.93,2.04,3,14
379,1.43,0.57,36,15.48,6.66,30.96,25.8,8.58,14.58,12.58,-3.42,-9.42,-7.42,72,60,18,16,3.42,-6,-4,144,120,22,6,9.42,2,100,4,7.42,-2,55.31,6,2.58,0.43,43.31,12,10
380,1.28,0.72,64,17.92,5.02,42.56,11.2,10.24,21.24,7.24,-5.76,-16.76,-2.76,152,40,27,13,5.76,-11,3,361,95,24,11,16.76,14,25,-3,2.76,-14,57.78,8,2.24,0.28,38.78,19,5
381,1.73,0.27,25,18.25,13.32,0.0,69.35,8.65,3.65,22.65,-1.35,3.65,-15.35,0,95,5,24,1.35,5,-14,0,0,19,-5,-3.65,-19,361,14,15.35,19,36.962,5,3.65,0.73,36.962,0,19
382,1.75,0.25,400,300.0,225.0,45.0,165.0,35.0,18.0,26.0,-5.0,12.0,4.0,60,220,23,31,5.0,17,9,9,33,14,-17,-12.0,-8,121,-9,-4.0,8,215.364,20,15.0,0.75,212.364,3,11
383,1.93,0.07,169,157.17,146.17,108.81,132.99,25.09,21.09,23.09,-0.91,3.09,1.09,117,143,22,24,0.91,4,2,81,99,20,-4,-3.09,-2,121,-2,-1.09,2,103.806,13,12.09,0.93,94.806,9,11
384,1.26,0.74,81,21.06,5.48,37.44,42.12,11.34,18.34,20.34,-6.66,-13.66,-15.66,144,162,25,27,6.66,-7,-9,256,288,34,7,13.66,-2,324,9,15.66,2,148.288,9,2.34,0.26,132.288,16,18
385,1.34,0.66,4,1.36,0.46,1.36,8.84,2.68,2.68,13.68,-1.32,-1.32,-12.32,4,26,4,15,1.32,0,-11,4,26,15,0,1.32,-11,169,11,12.32,11,20.636,2,0.68,0.34,18.636,2,13
386,1.57,0.43,16,9.12,5.2,13.68,13.68,6.28,8.28,8.28,-1.72,-3.72,-3.72,24,24,10,10,1.72,-2,-2,36,36,12,2,3.72,0,36,2,3.72,0,21.898,4,2.28,0.57,15.898,6,6
387,1.74,0.26,144,106.56,78.85,71.04,53.28,20.88,16.88,14.88,-3.12,0.88,2.88,96,72,20,18,3.12,4,6,64,48,14,-4,-0.88,2,36,-6,-2.88,-2,84.698,12,8.88,0.74,76.698,8,6
388,1.15,0.85,361,54.15,8.12,5.7,11.4,21.85,4.85,6.85,-16.15,0.85,-1.15,38,76,21,23,16.15,17,15,4,8,6,-17,-0.85,-2,16,-15,1.15,2,94.828,19,2.85,0.15,92.828,2,4
389,1.75,0.25,64,48.0,36.0,48.0,84.0,14.0,14.0,20.0,-2.0,-2.0,-8.0,64,112,16,22,2.0,0,-6,64,112,22,0,2.0,-6,196,6,8.0,6,63.662,8,6.0,0.75,55.662,8,14
390,1.51,0.49,16,8.16,4.16,4.08,32.64,6.04,4.04,18.04,-1.96,0.04,-13.96,8,64,6,20,1.96,2,-12,4,32,18,-2,-0.04,-14,256,12,13.96,14,38.508,4,2.04,0.51,36.508,2,16
391,1.3,0.7,64,19.2,5.76,36.0,12.0,10.4,17.4,7.4,-5.6,-12.6,-2.6,120,40,23,13,5.6,-7,3,225,75,20,7,12.6,10,25,-3,2.6,-10,53.77,8,2.4,0.3,38.77,15,5
392,1.22,0.78,81,17.82,3.92,29.7,23.76,10.98,16.98,13.98,-7.02,-13.02,-10.02,135,108,24,21,7.02,-6,-3,225,180,27,6,13.02,3,144,3,10.02,-3,108.586,9,1.98,0.22,93.586,15,12
393,1.51,0.49,9,4.59,2.34,0.0,21.42,4.53,1.53,15.53,-1.47,1.53,-12.47,0,42,3,17,1.47,3,-11,0,0,14,-3,-1.53,-14,196,11,12.47,14,23.51,3,1.53,0.51,23.51,0,14
394,1.37,0.63,225,83.25,30.8,27.75,27.75,20.55,10.55,10.55,-9.45,0.55,0.55,75,75,20,20,9.45,10,10,25,25,10,-10,-0.55,0,25,-10,-0.55,0,96.538,15,5.55,0.37,91.538,5,5
395,1.33,0.67,49,16.17,5.34,27.72,27.72,9.31,14.31,14.31,-4.69,-9.69,-9.69,84,84,19,19,4.69,-5,-5,144,144,24,5,9.69,0,144,5,9.69,0,77.36,7,2.31,0.33,65.36,12,12
396,1.87,0.13,36,31.32,27.25,0.0,31.32,11.22,5.22,11.22,-0.78,5.22,-0.78,0,36,6,12,0.78,6,0,0,0,6,-6,-5.22,-6,36,0,0.78,6,22.934,6,5.22,0.87,22.934,0,6
397,1.75,0.25,400,300.0,225.0,225.0,90.0,35.0,30.0,21.0,-5.0,0.0,9.0,300,120,35,26,5.0,5,14,225,90,21,-5,0.0,9,36,-14,-9.0,-9,202.102,20,15.0,0.75,187.102,15,6
398,1.24,0.76,81,19.44,4.67,32.4,21.6,11.16,17.16,12.16,-6.84,-12.84,-7.84,135,90,24,19,6.84,-6,-1,225,150,25,6,12.84,5,100,1,7.84,-5,94.132,9,2.16,0.24,79.132,15,10
399,1.81,0.19,16,12.96,10.5,9.72,51.84,7.24,6.24,19.24,-0.76,0.24,-12.76,12,64,7,20,0.76,1,-12,9,48,19,-1,-0.24,-13,256,12,12.76,13,23.194,4,3.24,0.81,20.194,3,16
400,1.74,0.26,36,26.64,19.71,31.08,35.52,10.44,11.44,12.44,-1.56,-2.56,-3.56,42,48,13,14,1.56,-1,-2,49,56,15,1,2.56,-1,64,2,3.56,1,34.746,6,4.44,0.74,27.746000000000002,7,8
401,1.8,0.2,121,96.8,77.44,123.2,44.0,19.8,22.8,13.8,-2.2,-5.2,3.8,154,55,25,16,2.2,-3,6,196,70,19,3,5.2,9,25,-6,-3.8,-9,78.2,11,8.8,0.8,64.2,14,5
402,1.24,0.76,361,86.64,20.79,50.16,13.68,23.56,15.56,7.56,-14.44,-6.44,1.56,209,57,30,22,14.44,8,16,121,33,14,-8,6.44,8,9,-16,-1.56,-8,100.488,19,4.56,0.24,89.488,11,3
403,1.79,0.21,25,19.75,15.6,59.25,71.1,8.95,18.95,21.95,-1.05,-11.05,-14.05,75,90,20,23,1.05,-10,-13,225,270,33,10,11.05,-3,324,13,14.05,3,45.816,5,3.95,0.79,30.816000000000003,15,18
404,1.7,0.3,4,2.8,1.96,26.6,11.2,3.4,20.4,9.4,-0.6,-17.6,-6.6,38,16,21,10,0.6,-17,-6,361,152,27,17,17.6,11,64,6,6.6,-11,25.72,2,1.4,0.7,6.719999999999999,19,8
405,1.89,0.11,1,0.89,0.79,15.13,5.34,1.89,17.89,6.89,-0.11,-16.11,-5.11,17,6,18,7,0.11,-16,-5,289,102,23,16,16.11,11,36,5,5.11,-11,18.4,1,0.89,0.89,1.3999999999999986,17,6
406,1.82,0.18,49,40.18,32.95,57.4,114.8,12.74,15.74,25.74,-1.26,-4.26,-14.26,70,140,17,27,1.26,-3,-13,100,200,30,3,4.26,-10,400,13,14.26,10,56.77,7,5.74,0.82,46.77,10,20
407,1.8,0.2,25,20.0,16.0,40.0,40.0,9.0,14.0,14.0,-1.0,-6.0,-6.0,50,50,15,15,1.0,-5,-5,100,100,20,5,6.0,0,100,5,6.0,0,31.62,5,4.0,0.8,21.62,10,10
408,1.16,0.84,100,16.0,2.56,22.4,12.8,11.6,15.6,9.6,-8.4,-12.4,-6.4,140,80,24,18,8.4,-4,2,196,112,22,4,12.4,6,64,-2,6.4,-6,90.068,10,1.6,0.16,76.068,14,8
409,1.3,0.7,256,76.8,23.04,72.0,57.6,20.8,19.8,16.8,-11.2,-10.2,-7.2,240,192,31,28,11.2,1,4,225,180,27,-1,10.2,3,144,-4,7.2,-3,190.372,16,4.8,0.3,175.372,15,12
410,1.61,0.39,121,73.81,45.02,120.78,80.52,17.71,24.71,18.71,-4.29,-11.29,-5.29,198,132,29,23,4.29,-7,-1,324,216,30,7,11.29,6,144,1,5.29,-6,109.874,11,6.71,0.61,91.874,18,12
411,1.76,0.24,36,27.36,20.79,41.04,0.0,10.56,13.56,4.56,-1.44,-4.44,4.56,54,0,15,6,1.44,-3,6,81,0,9,3,4.44,9,0,-6,-4.56,-9,25.098,6,4.56,0.76,16.098,9,0
412,1.37,0.63,64,23.68,8.76,47.36,0.0,10.96,18.96,2.96,-5.04,-13.04,2.96,128,0,24,8,5.04,-8,8,256,0,16,8,13.04,16,0,-8,-2.96,-16,28.966,8,2.96,0.37,12.966000000000001,16,0
413,1.56,0.44,100,56.0,31.36,5.6,16.8,15.6,6.6,8.6,-4.4,4.6,2.6,10,30,11,13,4.4,9,7,1,3,4,-9,-4.6,-2,9,-7,-2.6,2,45.17,10,5.6,0.56,44.17,1,3
414,1.7,0.3,1,0.7,0.49,11.9,2.8,1.7,17.7,4.7,-0.3,-16.3,-3.3,17,4,18,5,0.3,-16,-3,289,68,21,16,16.3,13,16,3,3.3,-13,18.996,1,0.7,0.7,1.9959999999999987,17,4
415,1.77,0.23,9,6.93,5.34,0.0,41.58,5.31,2.31,20.31,-0.69,2.31,-15.69,0,54,3,21,0.69,3,-15,0,0,18,-3,-2.31,-18,324,15,15.69,18,17.314,3,2.31,0.77,17.314,0,18
416,1.2,0.8,225,45.0,9.0,9.0,3.0,18.0,6.0,4.0,-12.0,0.0,2.0,45,15,18,16,12.0,12,14,9,3,4,-12,0.0,2,1,-14,-2.0,-2,39.29,15,3.0,0.2,36.29,3,1
417,1.29,0.71,64,18.56,5.38,2.32,41.76,10.32,3.32,20.32,-5.68,1.32,-15.68,8,144,9,26,5.68,7,-10,1,18,19,-7,-1.32,-17,324,10,15.68,17,113.738,8,2.32,0.29,112.738,1,18
418,1.08,0.92,121,9.68,0.77,6.16,3.52,11.88,7.88,4.88,-10.12,-6.12,-3.12,77,44,18,15,10.12,4,7,49,28,11,-4,6.12,3,16,-7,3.12,-3,52.832,11,0.88,0.08,45.832,7,4
419,1.05,0.95,4,0.2,0.01,1.5,0.4,2.1,15.1,4.1,-1.9,-14.9,-3.9,30,8,17,6,1.9,-13,-2,225,60,19,13,14.9,11,16,2,3.9,-11,22.706,2,0.1,0.05,7.7059999999999995,15,4
420,1.38,0.62,169,64.22,24.4,49.4,9.88,17.94,14.94,6.94,-8.06,-5.06,2.94,130,26,23,15,8.06,3,11,100,20,12,-3,5.06,8,4,-11,-2.94,-8,60.366,13,4.94,0.38,50.366,10,2
421,1.45,0.55,196,88.2,39.69,69.3,6.3,20.3,17.3,7.3,-7.7,-4.7,5.3,154,14,25,15,7.7,3,13,121,11,12,-3,4.7,10,1,-13,-5.3,-10,66.646,14,6.3,0.45,55.646,11,1
422,1.85,0.15,196,166.6,141.61,11.9,142.8,25.9,12.9,23.9,-2.1,10.9,-0.1,14,168,15,26,2.1,13,2,1,12,13,-13,-10.9,-11,144,-2,0.1,11,115.956,14,11.9,0.85,114.956,1,12
423,1.33,0.67,144,47.52,15.68,19.8,27.72,15.96,8.96,10.96,-8.04,-1.04,-3.04,60,84,17,19,8.04,7,5,25,35,12,-7,1.04,-2,49,-5,3.04,2,87.082,12,3.96,0.33,82.082,5,7
424,1.12,0.88,25,3.0,0.36,6.6,4.2,5.6,11.6,7.6,-4.4,-10.4,-6.4,55,35,16,12,4.4,-6,-2,121,77,18,6,10.4,4,49,2,6.4,-4,43.668,5,0.6,0.12,32.668,11,7
425,1.84,0.16,256,215.04,180.63,174.72,67.2,29.44,26.44,18.44,-2.56,0.44,8.44,208,80,29,21,2.56,3,11,169,65,18,-3,-0.44,8,25,-11,-8.44,-8,139.986,16,13.44,0.84,126.98599999999999,13,5
426,1.41,0.59,49,20.09,8.24,22.96,48.79,9.87,10.87,19.87,-4.13,-5.13,-14.13,56,119,15,24,4.13,-1,-10,64,136,25,1,5.13,-9,289,10,14.13,9,89.274,7,2.87,0.41,81.274,8,17
427,1.43,0.57,9,3.87,1.66,24.51,24.51,4.29,20.29,20.29,-1.71,-17.71,-17.71,57,57,22,22,1.71,-16,-16,361,361,38,16,17.71,0,361,16,17.71,0,54.328,3,1.29,0.43,35.328,19,19
428,1.12,0.88,64,7.68,0.92,13.44,11.52,8.96,14.96,12.96,-7.04,-13.04,-11.04,112,96,22,20,7.04,-6,-4,196,168,26,6,13.04,2,144,4,11.04,-2,102.196,8,0.96,0.12,88.196,14,12
429,1.82,0.18,324,265.68,217.86,206.64,103.32,32.76,28.76,21.76,-3.24,0.76,7.76,252,126,32,25,3.24,4,11,196,98,21,-4,-0.76,7,49,-11,-7.76,-7,176.6,18,14.76,0.82,162.6,14,7
430,1.5,0.5,256,128.0,64.0,40.0,16.0,24.0,13.0,10.0,-8.0,3.0,6.0,80,32,21,18,8.0,11,14,25,10,7,-11,-3.0,3,4,-14,-6.0,-3,89.334,16,8.0,0.5,84.334,5,2
431,1.81,0.19,49,39.69,32.15,11.34,56.7,12.67,7.67,15.67,-1.33,3.67,-4.33,14,70,9,17,1.33,5,-3,4,20,12,-5,-3.67,-8,100,3,4.33,8,37.748,7,5.67,0.81,35.748,2,10
432,1.82,0.18,256,209.92,172.13,262.4,144.32,29.12,33.12,24.12,-2.88,-6.88,2.12,320,176,36,27,2.88,-4,5,400,220,31,4,6.88,9,121,-5,-2.12,-9,163.406,16,13.12,0.82,143.406,20,11
433,1.13,0.87,196,25.48,3.31,27.3,32.76,15.82,16.82,19.82,-12.18,-13.18,-16.18,210,252,29,32,12.18,-1,-4,225,270,33,1,13.18,-3,324,4,16.18,3,246.246,14,1.82,0.13,231.246,15,18
434,1.78,0.22,25,19.5,15.21,74.1,3.9,8.9,22.9,4.9,-1.1,-15.1,2.9,95,5,24,6,1.1,-14,4,361,19,20,14,15.1,18,1,-4,-2.9,-18,31.736,5,3.9,0.78,12.736,19,1
435,1.08,0.92,4,0.32,0.03,2.08,1.28,2.16,13.16,8.16,-1.84,-12.84,-7.84,26,16,15,10,1.84,-11,-6,169,104,21,11,12.84,5,64,6,7.84,-5,28.104,2,0.16,0.08,15.104,13,8
436,1.57,0.43,256,145.92,83.17,164.16,164.16,25.12,27.12,27.12,-6.88,-8.88,-8.88,288,288,34,34,6.88,-2,-2,324,324,36,2,8.88,0,324,2,8.88,0,219.52,16,9.12,0.57,201.52,18,18
437,1.19,0.81,49,9.31,1.77,1.33,9.31,8.33,2.33,8.33,-5.67,0.33,-5.67,7,49,8,14,5.67,6,0,1,7,8,-6,-0.33,-6,49,0,5.67,6,46.012,7,1.33,0.19,45.012,1,7
438,1.42,0.58,64,26.88,11.29,10.08,43.68,11.36,6.36,16.36,-4.64,0.36,-9.64,24,104,11,21,4.64,5,-5,9,39,16,-5,-0.36,-10,169,5,9.64,10,79.052,8,3.36,0.42,76.052,3,13
439,1.45,0.55,289,130.05,58.52,153.0,137.7,24.65,27.65,25.65,-9.35,-12.35,-10.35,340,306,37,35,9.35,-3,-1,400,360,38,3,12.35,2,324,1,10.35,-2,257.502,17,7.65,0.45,237.502,20,18
440,1.48,0.52,361,173.28,83.17,145.92,0.0,28.12,25.12,9.12,-9.88,-6.88,9.12,304,0,35,19,9.88,3,19,256,0,16,-3,6.88,16,0,-19,-9.12,-16,107.594,19,9.12,0.48,91.594,16,0
441,1.86,0.14,324,278.64,239.63,201.24,154.8,33.48,28.48,25.48,-2.52,2.48,5.48,234,180,31,28,2.52,5,8,169,130,23,-5,-2.48,3,100,-8,-5.48,-3,184.868,18,15.48,0.86,171.868,13,10
442,1.79,0.21,289,228.31,180.36,40.29,53.72,30.43,16.43,17.43,-3.57,10.43,9.43,51,68,20,21,3.57,14,13,9,12,7,-14,-10.43,-1,16,-13,-9.43,1,138.256,17,13.43,0.79,135.256,3,4
443,1.68,0.32,100,68.0,46.24,115.6,34.0,16.8,23.8,11.8,-3.2,-10.2,1.8,170,50,27,15,3.2,-7,5,289,85,22,7,10.2,12,25,-5,-1.8,-12,70.344,10,6.8,0.68,53.343999999999994,17,5
444,1.38,0.62,16,6.08,2.31,28.88,24.32,5.52,20.52,17.52,-2.48,-17.48,-14.48,76,64,23,20,2.48,-15,-12,361,304,35,15,17.48,3,256,12,14.48,-3,62.824,4,1.52,0.38,43.824,19,16
445,1.29,0.71,9,2.61,0.76,9.57,5.22,3.87,11.87,6.87,-2.13,-10.13,-5.13,33,18,14,9,2.13,-8,-3,121,66,17,8,10.13,5,36,3,5.13,-5,25.538,3,0.87,0.29,14.538,11,6
446,1.51,0.49,64,32.64,16.65,4.08,24.48,12.08,5.08,10.08,-3.92,3.08,-1.92,8,48,9,14,3.92,7,2,1,6,7,-7,-3.08,-5,36,-2,1.92,5,43.224,8,4.08,0.51,42.224,1,6
447,1.32,0.68,225,72.0,23.04,52.8,72.0,19.8,15.8,19.8,-10.2,-6.2,-10.2,165,225,26,30,10.2,4,0,121,165,26,-4,6.2,-4,225,0,10.2,4,203.886,15,4.8,0.32,192.886,11,15
448,1.23,0.77,9,2.07,0.48,4.83,10.35,3.69,7.69,15.69,-2.31,-6.31,-14.31,21,45,10,18,2.31,-4,-12,49,105,22,4,6.31,-8,225,12,14.31,8,43.63,3,0.69,0.23,36.63,7,15
449,1.26,0.74,256,66.56,17.31,58.24,12.48,20.16,18.16,7.16,-11.84,-9.84,1.16,224,48,30,19,11.84,2,13,196,42,17,-2,9.84,11,9,-13,-1.16,-11,83.452,16,4.16,0.26,69.452,14,3
450,1.27,0.73,36,9.72,2.62,24.3,19.44,7.62,16.62,13.62,-4.38,-13.38,-10.38,90,72,21,18,4.38,-9,-6,225,180,27,9,13.38,3,144,6,10.38,-3,72.944,6,1.62,0.27,57.944,15,12
451,1.25,0.75,16,4.0,1.0,3.0,19.0,5.0,4.0,20.0,-3.0,-2.0,-18.0,12,76,7,23,3.0,1,-15,9,57,22,-1,2.0,-16,361,15,18.0,16,61.696,4,1.0,0.25,58.696,3,19
452,1.6,0.4,16,9.6,5.76,26.4,24.0,6.4,13.4,12.4,-1.6,-8.6,-7.6,44,40,15,14,1.6,-7,-6,121,110,21,7,8.6,1,100,6,7.6,-1,32.624,4,2.4,0.6,21.624000000000002,11,10
453,1.56,0.44,121,67.76,37.95,18.48,12.32,17.16,9.16,8.16,-4.84,3.16,4.16,33,22,14,13,4.84,8,9,9,6,5,-8,-3.16,1,4,-9,-4.16,-1,50.018,11,6.16,0.56,47.018,3,2
454,1.21,0.79,361,75.81,15.92,63.84,3.99,22.99,19.99,4.99,-15.01,-12.01,2.99,304,19,35,20,15.01,3,18,256,16,17,-3,12.01,15,1,-18,-2.99,-15,70.572,19,3.99,0.21,54.572,16,1
455,1.17,0.83,64,10.88,1.85,13.6,8.16,9.36,11.36,7.36,-6.64,-8.64,-4.64,80,48,18,14,6.64,-2,2,100,60,16,2,8.64,4,36,-2,4.64,-4,55.958,8,1.36,0.17,45.958,10,6
456,1.11,0.89,16,1.76,0.19,1.76,7.04,4.44,4.44,16.44,-3.56,-3.56,-15.56,16,64,8,20,3.56,0,-12,16,64,20,0,3.56,-12,256,12,15.56,12,61.87,4,0.44,0.11,57.87,4,16
457,1.82,0.18,9,7.38,6.05,19.68,31.98,5.46,10.46,15.46,-0.54,-5.54,-10.54,24,39,11,16,0.54,-5,-10,64,104,21,5,5.54,-5,169,10,10.54,5,20.3,3,2.46,0.82,12.3,8,13
458,1.16,0.84,81,12.96,2.07,4.32,14.4,10.44,4.44,11.44,-7.56,-1.56,-8.56,27,90,12,19,7.56,6,-1,9,30,13,-6,1.56,-7,100,1,8.56,7,85.408,9,1.44,0.16,82.408,3,10
459,1.8,0.2,400,320.0,256.0,32.0,160.0,36.0,18.0,26.0,-4.0,14.0,6.0,40,200,22,30,4.0,18,10,4,20,12,-18,-14.0,-8,100,-10,-6.0,8,210.45,20,16.0,0.8,208.45,2,10
460,1.72,0.28,9,6.48,4.67,32.4,0.0,5.16,17.16,2.16,-0.84,-12.84,2.16,45,0,18,3,0.84,-12,3,225,0,15,12,12.84,15,0,-3,-2.16,-15,19.31,3,2.16,0.72,4.309999999999999,15,0
461,1.61,0.39,256,156.16,95.26,107.36,87.84,25.76,20.76,18.76,-6.24,-1.24,0.76,176,144,27,25,6.24,5,7,121,99,20,-5,1.24,2,81,-7,-0.76,-2,150.042,16,9.76,0.61,139.042,11,9
462,1.25,0.75,16,4.0,1.0,14.0,2.0,5.0,15.0,3.0,-3.0,-13.0,-1.0,56,8,18,6,3.0,-10,2,196,28,16,10,13.0,12,4,-2,1.0,-12,22.498,4,1.0,0.25,8.498000000000001,14,2
463,1.2,0.8,4,0.8,0.16,6.8,0.0,2.4,17.4,0.4,-1.6,-16.6,0.4,34,0,19,2,1.6,-15,2,289,0,17,15,16.6,17,0,-2,-0.4,-17,17.68,2,0.4,0.2,0.6799999999999997,17,0
464,1.66,0.34,4,2.64,1.74,7.92,23.76,3.32,7.32,19.32,-0.68,-4.68,-16.68,12,36,8,20,0.68,-4,-16,36,108,24,4,4.68,-12,324,16,16.68,12,20.422,2,1.32,0.66,14.422,6,18
465,1.25,0.75,144,36.0,9.0,18.0,6.0,15.0,9.0,5.0,-9.0,-3.0,1.0,72,24,18,14,9.0,6,10,36,12,8,-6,3.0,4,4,-10,-1.0,-4,43.786,12,3.0,0.25,37.786,6,2
466,1.49,0.51,196,96.04,47.06,137.2,27.44,20.86,26.86,10.86,-7.14,-13.14,2.86,280,56,34,18,7.14,-6,10,400,80,24,6,13.14,16,16,-10,-2.86,-16,100.676,14,6.86,0.49,80.676,20,4
0,1.99,0.01,1,0.99,0.98,0.0,0.99,1.99,0.99,1.99,-0.01,0.99,-0.01,0,1,1,2,0.01,1,0,0,0,1,-1,-0.99,-1,1,0,0.01,1,1.0,1,0.99,0.99,1.0,0,1
1,1.99,0.01,625,618.75,612.56,618.75,0.0,49.75,49.75,24.75,-0.25,-0.25,24.75,625,0,50,25,0.25,0,25,625,0,25,0,0.25,25,0,-25,-24.75,-25,346.75733333333335,25,24.75,0.99,321.75733333333335,25,0
2,1.99,0.01,1,0.99,0.98,0.0,0.0,1.99,0.99,0.99,-0.01,0.99,0.99,0,0,1,1,0.01,1,1,0,0,0,-1,-0.99,0,0,-1,-0.99,0,0.992,1,0.99,0.99,0.992,0,0
3,1.99,0.01,625,618.75,612.56,0.0,0.0,49.75,24.75,24.75,-0.25,24.75,24.75,0,0,25,25,0.25,25,25,0,0,0,-25,-24.75,0,0,-25,-24.75,0,321.89866666666666,25,24.75,0.99,321.89866666666666,0,0
4,1.01,0.99,1,0.01,0.0,0.0,0.25,1.01,0.01,25.01,-0.99,0.01,-24.99,0,25,1,26,0.99,1,-24,0,0,25,-1,-0.01,-25,625,24,24.99,25,24.744,1,0.01,0.01,24.744,0,25
5,1.99,0.01,1,0.99,0.98,0.0,0.99,1.99,0.99,1.99,-0.01,0.99,-0.01,0,1,1,2,0.01,1,0,0,0,1,-1,-0.99,-1,1,0,0.01,1,1.0,1,0.99,0.99,1.0,0,1
6,1.99,0.01,625,618.75,612.56,618.75,0.0,49.75,49.75,24.75,-0.25,-0.25,24.75,625,0,50,25,0.25,0,25,625,0,25,0,0.25,25,0,-25,-24.75,-25,347.122,25,24.75,0.99,322.122,25,0
7,1.01,0.99,144,1.44,0.01,3.0,3.0,12.12,25.12,25.12,-11.88,-24.88,-24.88,300,300,37,37,11.88,-13,-13,625,625,50,13,24.88,0,625,13,24.88,0,322.718,12,0.12,0.01,297.718,25,25
8,1.99,0.01,1,0.99,0.98,0.0,0.0,1.99,0.99,0.99,-0.01,0.99,0.99,0,0,1,1,0.01,1,1,0,0,0,-1,-0.99,0,0,-1,-0.99,0,0.9913333333333333,1,0.99,0.99,0.9913333333333333,0,0
9,1.99,0.01,625,618.75,612.56,0.0,0.0,49.75,24.75,24.75,-0.25,24.75,24.75,0,0,25,25,0.25,25,25,0,0,0,-25,-24.75,0,0,-25,-24.75,0,321.768,25,24.75,0.99,321.768,0,0
10,1.99,0.01,169,167.31,165.64,321.75,321.75,25.87,37.87,37.87,-0.13,-12.13,-12.13,325,325,38,38,0.13,-12,-12,625,625,50,12,12.13,0,625,12,12.13,0,118.42333333333333,13,12.87,0.99,93.42333333333333,25,25
11,1.99,0.01,625,618.75,612.56,0.0,297.0,49.75,24.75,36.75,-0.25,24.75,12.75,0,300,25,37,0.25,25,13,0,0,12,-25,-24.75,-12,144,-13,-12.75,12,324.81333333333333,25,24.75,0.99,324.81333333333333,0,12
12,1.01,0.99,625,6.25,0.06,6.25,6.25,25.25,25.25,25.25,-24.75,-24.75,-24.75,625,625,50,50,24.75,0,0,625,625,50,0,24.75,0,625,0,24.75,0,647.2113333333333,25,0.25,0.01,622.2113333333333,25,25
13,1.99,0.01,169,167.31,165.64,0.0,321.75,25.87,12.87,37.87,-0.13,12.87,-12.13,0,325,13,38,0.13,13,-12,0,0,25,-13,-12.87,-25,625,12,12.13,25,93.29933333333334,13,12.87,0.99,93.29933333333334,0,25
14,1.99,0.01,625,618.75,612.56,0.0,618.75,49.75,24.75,49.75,-0.25,24.75,-0.25,0,625,25,50,0.25,25,0,0,0,25,-25,-24.75,-25,625,0,0.25,25,328.0106666666667,25,24.75,0.99,328.0106666666667,0,25
15,1.01,0.99,1,0.01,0.0,0.24,0.25,1.01,24.01,25.01,-0.99,-23.99,-24.99,24,25,25,26,0.99,-23,-24,576,600,49,23,23.99,-1,625,24,24.99,1,48.792,1,0.01,0.01,24.792,24,25
16,1.99,0.01,4,3.96,3.92,0.0,0.0,3.98,1.98,1.98,-0.02,1.98,1.98,0,0,2,2,0.02,2,2,0,0,0,-2,-1.98,0,0,-2,-1.98,0,2.966666666666667,2,1.98,0.99,2.966666666666667,0,0
17,1.99,0.01,1,0.99,0.98,0.0,0.0,1.99,0.99,0.99,-0.01,0.99,0.99,0,0,1,1,0.01,1,1,0,0,0,-1,-0.99,0,0,-1,-0.99,0,0.988,1,0.99,0.99,0.988,0,0
18,1.01,0.99,169,1.69,0.02,0.0,0.0,13.13,0.13,0.13,-12.87,0.13,0.13,0,0,13,13,12.87,13,13,0,0,0,-13,-0.13,0,0,-13,-0.13,0,0.878,13,0.13,0.01,0.878,0,0
19,1.99,0.01,1,0.99,0.98,0.0,24.75,1.99,0.99,25.99,-0.01,0.99,-24.01,0,25,1,26,0.01,1,-24,0,0,25,-1,-0.99,-25,625,24,24.01,25,1.176,1,0.99,0.99,1.176,0,25
20,1.01,0.99,1,0.01,0.0,0.0,0.0,1.01,0.01,0.01,-0.99,0.01,0.01,0,0,1,1,0.99,1,1,0,0,0,-1,-0.01,0,0,-1,-0.01,0,0.008,1,0.01,0.01,0.008,0,0
21,1.09,0.91,625,57.4,5.27,0.0,57.4,27.3,2.3,27.3,-22.7,2.3,-22.7,0,625,25,50,22.7,25,0,0,0,25,-25,-2.3,-25,625,0,22.7,25,597.2773333333333,25,2.3,0.09183458033420318,597.2773333333333,0,25
22,1.99,0.01,1,0.99,0.98,0.0,0.0,1.99,0.99,0.99,-0.01,0.99,0.99,0,0,1,1,0.01,1,1,0,0,0,-1,-0.99,0,0,-1,-0.99,0,0.9906666666666667,1,0.99,0.99,0.9906666666666667,0,0
23,1.99,0.01,625,618.75,612.56,0.0,0.0,49.75,24.75,24.75,-0.25,24.75,24.75,0,0,25,25,0.25,25,25,0,0,0,-25,-24.75,0,0,-25,-24.75,0,321.50733333333335,25,24.75,0.99,321.50733333333335,0,0
24,1.99,0.01,1,0.99,0.98,24.75,24.75,1.99,25.99,25.99,-0.01,-24.01,-24.01,25,25,26,26,0.01,-24,-24,625,625,50,24,24.01,0,625,24,24.01,0,26.176,1,0.99,0.99,1.1759999999999984,25,25
25,1.01,0.99,4,0.04,0.0,0.5,0.0,2.02,25.02,0.02,-1.98,-24.98,0.02,50,0,27,2,1.98,-23,2,625,0,25,23,24.98,25,0,-2,-0.02,-25,25.032666666666668,2,0.02,0.01,0.03266666666666751,25,0
26,1.99,0.01,1,0.99,0.98,24.75,0.0,1.99,25.99,0.99,-0.01,-24.01,0.99,25,0,26,1,0.01,-24,1,625,0,25,24,24.01,25,0,-1,-0.99,-25,25.994666666666667,1,0.99,0.99,0.9946666666666673,25,0
27,1.01,0.99,625,6.25,0.06,0.0,0.0,25.25,0.25,0.25,-24.75,0.25,0.25,0,0,25,25,24.75,25,25,0,0,0,-25,-0.25,0,0,-25,-0.25,0,3.138,25,0.25,0.01,3.138,0,0
28,1.01,0.99,1,0.01,0.0,0.24,0.25,1.01,24.01,25.01,-0.99,-23.99,-24.99,24,25,25,26,0.99,-23,-24,576,600,49,23,23.99,-1,625,24,24.99,1,48.728,1,0.01,0.01,24.728,24,25
29,1.99,0.01,4,3.96,3.92,0.0,0.0,3.98,1.98,1.98,-0.02,1.98,1.98,0,0,2,2,0.02,2,2,0,0,0,-2,-1.98,0,0,-2,-1.98,0,2.966,2,1.98,0.99,2.966,0,0
30,1.83,0.17,625,517.5,428.49,517.5,248.4,45.7,45.7,32.7,-4.3,-4.3,8.7,625,300,50,37,4.3,0,13,625,300,37,0,4.3,13,144,-13,-8.7,-13,346.1206666666667,25,20.7,0.827999775353927,321.1206666666667,25,12
31,1.99,0.01,625,618.75,612.56,0.0,618.75,49.75,24.75,49.75,-0.25,24.75,-0.25,0,625,25,50,0.25,25,0,0,0,25,-25,-24.75,-25,625,0,0.25,25,328.07533333333333,25,24.75,0.99,328.07533333333333,0,25
32,1.99,0.01,1,0.99,0.98,0.0,0.0,1.99,0.99,0.99,-0.01,0.99,0.99,0,0,1,1,0.01,1,1,0,0,0,-1,-0.99,0,0,-1,-0.99,0,0.9846666666666667,1,0.99,0.99,0.9846666666666667,0,0
33,1.01,0.99,625,6.25,0.06,0.0,0.0,25.25,0.25,0.25,-24.75,0.25,0.25,0,0,25,25,24.75,25,25,0,0,0,-25,-0.25,0,0,-25,-0.25,0,3.3893333333333335,25,0.25,0.01,3.3893333333333335,0,0
34,1.99,0.01,625,618.75,612.56,0.0,321.75,49.75,24.75,37.75,-0.25,24.75,11.75,0,325,25,38,0.25,25,12,0,0,13,-25,-24.75,-13,169,-12,-11.75,13,325.0013333333333,25,24.75,0.99,325.0013333333333,0,13
35,1.99,0.01,625,618.75,612.56,0.0,618.75,49.75,24.75,49.75,-0.25,24.75,-0.25,0,625,25,50,0.25,25,0,0,0,25,-25,-24.75,-25,625,0,0.25,25,327.888,25,24.75,0.99,327.888,0,25
36,1.01,0.99,169,1.69,0.02,3.25,3.25,13.13,25.13,25.13,-12.87,-24.87,-24.87,325,325,38,38,12.87,-12,-12,625,625,50,12,24.87,0,625,12,24.87,0,348.01,13,0.13,0.01000000168537027,323.01,25,25
37,1.99,0.01,625,618.75,612.56,618.75,321.75,49.75,49.75,37.75,-0.25,-0.25,11.75,625,325,50,38,0.25,0,12,625,325,38,0,0.25,12,169,-12,-11.75,-12,349.998,25,24.75,0.99,324.998,25,13
38,1.99,0.01,169,167.31,165.64,0.0,321.75,25.87,12.87,37.87,-0.13,12.87,-12.13,0,325,13,38,0.13,13,-12,0,0,25,-13,-12.87,-25,625,12,12.13,25,93.40666666666667,13,12.87,0.99,93.40666666666667,0,25
39,1.99,0.01,225,222.75,220.52,0.0,371.25,29.85,14.85,39.85,-0.15,14.85,-10.15,0,375,15,40,0.15,15,-10,0,0,25,-15,-14.85,-25,625,10,10.15,25,122.576,15,14.85,0.99,122.576,0,25
40,1.99,0.01,1,0.99,0.98,0.0,0.99,1.99,0.99,1.99,-0.01,0.99,-0.01,0,1,1,2,0.01,1,0,0,0,1,-1,-0.99,-1,1,0,0.01,1,1.0,1,0.99,0.99,1.0,0,1
41,1.99,0.01,625,618.75,612.56,618.75,0.0,49.75,49.75,24.75,-0.25,-0.25,24.75,625,0,50,25,0.25,0,25,625,0,25,0,0.25,25,0,-25,-24.75,-25,346.75733333333335,25,24.75,0.99,321.75733333333335,25,0
42,1.99,0.01,1,0.99,0.98,0.0,0.0,1.99,0.99,0.99,-0.01,0.99,0.99,0,0,1,1,0.01,1,1,0,0,0,-1,-0.99,0,0,-1,-0.99,0,0.992,1,0.99,0.99,0.992,0,0
43,1.99,0.01,625,618.75,612.56,0.0,0.0,49.75,24.75,24.75,-0.25,24.75,24.75,0,0,25,25,0.25,25,25,0,0,0,-25,-24.75,0,0,-25,-24.75,0,321.89866666666666,25,24.75,0.99,321.89866666666666,0,0
44,1.01,0.99,1,0.01,0.0,0.0,0.25,1.01,0.01,25.01,-0.99,0.01,-24.99,0,25,1,26,0.99,1,-24,0,0,25,-1,-0.01,-25,625,24,24.99,25,24.744,1,0.01,0.01,24.744,0,25
45,1.99,0.01,1,0.99,0.98,0.0,0.99,1.99,0.99,1.99,-0.01,0.99,-0.01,0,1,1,2,0.01,1,0,0,0,1,-1,-0.99,-1,1,0,0.01,1,1.0,1,0.99,0.99,1.0,0,1
46,1.99,0.01,625,618.75,612.56,618.75,0.0,49.75,49.75,24.75,-0.25,-0.25,24.75,625,0,50,25,0.25,0,25,625,0,25,0,0.25,25,0,-25,-24.75,-25,347.122,25,24.75,0.99,322.122,25,0
47,1.01,0.99,144,1.44,0.01,3.0,3.0,12.12,25.12,25.12,-11.88,-24.88,-24.88,300,300,37,37,11.88,-13,-13,625,625,50,13,24.88,0,625,13,24.88,0,322.718,12,0.12,0.01,297.718,25,25
48,1.99,0.01,1,0.99,0.98,0.0,0.0,1.99,0.99,0.99,-0.01,0.99,0.99,0,0,1,1,0.01,1,1,0,0,0,-1,-0.99,0,0,-1,-0.99,0,0.9913333333333333,1,0.99,0.99,0.9913333333333333,0,0
49,1.99,0.01,625,618.75,612.56,0.0,0.0,49.75,24.75,24.75,-0.25,24.75,24.75,0,0,25,25,0.25,25,25,0,0,0,-25,-24.75,0,0,-25,-24.75,0,321.768,25,24.75,0.99,321.768,0,0
50,1.99,0.01,169,167.31,165.64,321.75,321.75,25.87,37.87,37.87,-0.13,-12.13,-12.13,325,325,38,38,0.13,-12,-12,625,625,50,12,12.13,0,625,12,12.13,0,118.42333333333333,13,12.87,0.99,93.42333333333333,25,25
51,1.99,0.01,625,618.75,612.56,0.0,297.0,49.75,24.75,36.75,-0.25,24.75,12.75,0,300,25,37,0.25,25,13,0,0,12,-25,-24.75,-12,144,-13,-12.75,12,324.81333333333333,25,24.75,0.99,324.81333333333333,0,12
52,1.01,0.99,625,6.25,0.06,6.25,6.25,25.25,25.25,25.25,-24.75,-24.75,-24.75,625,625,50,50,24.75,0,0,625,625,50,0,24.75,0,625,0,24.75,0,647.2113333333333,25,0.25,0.01,622.2113333333333,25,25
53,1.99,0.01,169,167.31,165.64,0.0,321.75,25.87,12.87,37.87,-0.13,12.87,-12.13,0,325,13,38,0.13,13,-12,0,0,25,-13,-12.87,-25,625,12,12.13,25,93.29933333333334,13,12.87,0.99,93.29933333333334,0,25
54,1.99,0.01,625,618.75,612.56,0.0,618.75,49.75,24.75,49.75,-0.25,24.75,-0.25,0,625,25,50,0.25,25,0,0,0,25,-25,-24.75,-25,625,0,0.25,25,328.0106666666667,25,24.75,0.99,328.0106666666667,0,25
55,1.01,0.99,1,0.01,0.0,0.24,0.25,1.01,24.01,25.01,-0.99,-23.99,-24.99,24,25,25,26,0.99,-23,-24,576,600,49,23,23.99,-1,625,24,24.99,1,48.792,1,0.01,0.01,24.792,24,25
56,1.99,0.01,4,3.96,3.92,0.0,0.0,3.98,1.98,1.98,-0.02,1.98,1.98,0,0,2,2,0.02,2,2,0,0,0,-2,-1.98,0,0,-2,-1.98,0,2.966666666666667,2,1.98,0.99,2.966666666666667,0,0
57,1.99,0.01,1,0.99,0.98,0.0,0.0,1.99,0.99,0.99,-0.01,0.99,0.99,0,0,1,1,0.01,1,1,0,0,0,-1,-0.99,0,0,-1,-0.99,0,0.988,1,0.99,0.99,0.988,0,0
58,1.01,0.99,169,1.69,0.02,0.0,0.0,13.13,0.13,0.13,-12.87,0.13,0.13,0,0,13,13,12.87,13,13,0,0,0,-13,-0.13,0,0,-13,-0.13,0,0.878,13,0.13,0.01,0.878,0,0
59,1.99,0.01,1,0.99,0.98,0.0,24.75,1.99,0.99,25.99,-0.01,0.99,-24.01,0,25,1,26,0.01,1,-24,0,0,25,-1,-0.99,-25,625,24,24.01,25,1.176,1,0.99,0.99,1.176,0,25
60,1.01,0.99,1,0.01,0.0,0.0,0.0,1.01,0.01,0.01,-0.99,0.01,0.01,0,0,1,1,0.99,1,1,0,0,0,-1,-0.01,0,0,-1,-0.01,0,0.008,1,0.01,0.01,0.008,0,0
61,1.09,0.91,625,57.4,5.27,0.0,57.4,27.3,2.3,27.3,-22.7,2.3,-22.7,0,625,25,50,22.7,25,0,0,0,25,-25,-2.3,-25,625,0,22.7,25,597.2773333333333,25,2.3,0.09183458033420318,597.2773333333333,0,25
62,1.99,0.01,1,0.99,0.98,0.0,0.0,1.99,0.99,0.99,-0.01,0.99,0.99,0,0,1,1,0.01,1,1,0,0,0,-1,-0.99,0,0,-1,-0.99,0,0.9906666666666667,1,0.99,0.99,0.9906666666666667,0,0
63,1.99,0.01,625,618.75,612.56,0.0,0.0,49.75,24.75,24.75,-0.25,24.75,24.75,0,0,25,25,0.25,25,25,0,0,0,-25,-24.75,0,0,-25,-24.75,0,321.50733333333335,25,24.75,0.99,321.50733333333335,0,0
64,1.99,0.01,1,0.99,0.98,24.75,24.75,1.99,25.99,25.99,-0.01,-24.01,-24.01,25,25,26,26,0.01,-24,-24,625,625,50,24,24.01,0,625,24,24.01,0,26.176,1,0.99,0.99,1.1759999999999984,25,25
65,1.01,0.99,4,0.04,0.0,0.5,0.0,2.02,25.02,0.02,-1.98,-24.98,0.02,50,0,27,2,1.98,-23,2,625,0,25,23,24.98,25,0,-2,-0.02,-25,25.032666666666668,2,0.02,0.01,0.03266666666666751,25,0
66,1.99,0.01,1,0.99,0.98,24.75,0.0,1.99,25.99,0.99,-0.01,-24.01,0.99,25,0,26,1,0.01,-24,1,625,0,25,24,24.01,25,0,-1,-0.99,-25,25.994666666666667,1,0.99,0.99,0.9946666666666673,25,0
67,1.01,0.99,625,6.25,0.06,0.0,0.0,25.25,0.25,0.25,-24.75,0.25,0.25,0,0,25,25,24.75,25,25,0,0,0,-25,-0.25,0,0,-25,-0.25,0,3.138,25,0.25,0.01,3.138,0,0
68,1.01,0.99,1,0.01,0.0,0.24,0.25,1.01,24.01,25.01,-0.99,-23.99,-24.99,24,25,25,26,0.99,-23,-24,576,600,49,23,23.99,-1,625,24,24.99,1,48.728,1,0.01,0.01,24.728,24,25
69,1.99,0.01,4,3.96,3.92,0.0,0.0,3.98,1.98,1.98,-0.02,1.98,1.98,0,0,2,2,0.02,2,2,0,0,0,-2,-1.98,0,0,-2,-1.98,0,2.966,2,1.98,0.99,2.966,0,0
70,1.83,0.17,625,517.5,428.49,517.5,248.4,45.7,45.7,32.7,-4.3,-4.3,8.7,625,300,50,37,4.3,0,13,625,300,37,0,4.3,13,144,-13,-8.7,-13,346.1206666666667,25,20.7,0.827999775353927,321.1206666666667,25,12
71,1.99,0.01,625,618.75,612.56,0.0,618.75,49.75,24.75,49.75,-0.25,24.75,-0.25,0,625,25,50,0.25,25,0,0,0,25,-25,-24.75,-25,625,0,0.25,25,328.07533333333333,25,24.75,0.99,328.07533333333333,0,25
72,1.99,0.01,1,0.99,0.98,0.0,0.0,1.99,0.99,0.99,-0.01,0.99,0.99,0,0,1,1,0.01,1,1,0,0,0,-1,-0.99,0,0,-1,-0.99,0,0.9846666666666667,1,0.99,0.99,0.9846666666666667,0,0
73,1.01,0.99,625,6.25,0.06,0.0,0.0,25.25,0.25,0.25,-24.75,0.25,0.25,0,0,25,25,24.75,25,25,0,0,0,-25,-0.25,0,0,-25,-0.25,0,3.3893333333333335,25,0.25,0.01,3.3893333333333335,0,0
74,1.99,0.01,625,618.75,612.56,0.0,321.75,49.75,24.75,37.75,-0.25,24.75,11.75,0,325,25,38,0.25,25,12,0,0,13,-25,-24.75,-13,169,-12,-11.75,13,325.0013333333333,25,24.75,0.99,325.0013333333333,0,13
75,1.99,0.01,625,618.75,612.56,0.0,618.75,49.75,24.75,49.75,-0.25,24.75,-0.25,0,625,25,50,0.25,25,0,0,0,25,-25,-24.75,-25,625,0,0.25,25,327.888,25,24.75,0.99,327.888,0,25
76,1.01,0.99,169,1.69,0.02,3.25,3.25,13.13,25.13,25.13,-12.87,-24.87,-24.87,325,325,38,38,12.87,-12,-12,625,625,50,12,24.87,0,625,12,24.87,0,348.01,13,0.13,0.01000000168537027,323.01,25,25
77,1.99,0.01,625,618.75,612.56,618.75,321.75,49.75,49.75,37.75,-0.25,-0.25,11.75,625,325,50,38,0.25,0,12,625,325,38,0,0.25,12,169,-12,-11.75,-12,349.998,25,24.75,0.99,324.998,25,13
78,1.99,0.01,169,167.31,165.64,0.0,321.75,25.87,12.87,37.87,-0.13,12.87,-12.13,0,325,13,38,0.13,13,-12,0,0,25,-13,-12.87,-25,625,12,12.13,25,93.40666666666667,13,12.87,0.99,93.40666666666667,0,25
79,1.99,0.01,225,222.75,220.52,0.0,371.25,29.85,14.85,39.85,-0.15,14.85,-10.15,0,375,15,40,0.15,15,-10,0,0,25,-15,-14.85,-25,625,10,10.15,25,122.576,15,14.85,0.99,122.576,0,25
80,1.99,0.01,1,0.99,0.98,0.0,0.99,1.99,0.99,1.99,-0.01,0.99,-0.01,0,1,1,2,0.01,1,0,0,0,1,-1,-0.99,-1,1,0,0.01,1,1.0,1,0.99,0.99,1.0,0,1
81,1.99,0.01,625,618.75,612.56,618.75,0.0,49.75,49.75,24.75,-0.25,-0.25,24.75,625,0,50,25,0.25,0,25,625,0,25,0,0.25,25,0,-25,-24.75,-25,346.75733333333335,25,24.75,0.99,321.75733333333335,25,0
82,1.99,0.01,1,0.99,0.98,0.0,0.0,1.99,0.99,0.99,-0.01,0.99,0.99,0,0,1,1,0.01,1,1,0,0,0,-1,-0.99,0,0,-1,-0.99,0,0.992,1,0.99,0.99,0.992,0,0
83,1.99,0.01,625,618.75,612.56,0.0,0.0,49.75,24.75,24.75,-0.25,24.75,24.75,0,0,25,25,0.25,25,25,0,0,0,-25,-24.75,0,0,-25,-24.75,0,321.89866666666666,25,24.75,0.99,321.89866666666666,0,0
84,1.01,0.99,1,0.01,0.0,0.0,0.25,1.01,0.01,25.01,-0.99,0.01,-24.99,0,25,1,26,0.99,1,-24,0,0,25,-1,-0.01,-25,625,24,24.99,25,24.744,1,0.01,0.01,24.744,0,25
85,1.99,0.01,1,0.99,0.98,0.0,0.99,1.99,0.99,1.99,-0.01,0.99,-0.01,0,1,1,2,0.01,1,0,0,0,1,-1,-0.99,-1,1,0,0.01,1,1.0,1,0.99,0.99,1.0,0,1
86,1.99,0.01,625,618.75,612.56,618.75,0.0,49.75,49.75,24.75,-0.25,-0.25,24.75,625,0,50,25,0.25,0,25,625,0,25,0,0.25,25,0,-25,-24.75,-25,347.122,25,24.75,0.99,322.122,25,0
87,1.01,0.99,144,1.44,0.01,3.0,3.0,12.12,25.12,25.12,-11.88,-24.88,-24.88,300,300,37,37,11.88,-13,-13,625,625,50,13,24.88,0,625,13,24.88,0,322.718,12,0.12,0.01,297.718,25,25
88,1.99,0.01,1,0.99,0.98,0.0,0.0,1.99,0.99,0.99,-0.01,0.99,0.99,0,0,1,1,0.01,1,1,0,0,0,-1,-0.99,0,0,-1,-0.99,0,0.9913333333333333,1,0.99,0.99,0.9913333333333333,0,0
89,1.99,0.01,625,618.75,612.56,0.0,0.0,49.75,24.75,24.75,-0.25,24.75,24.75,0,0,25,25,0.25,25,25,0,0,0,-25,-24.75,0,0,-25,-24.75,0,321.768,25,24.75,0.99,321.768,0,0
90,1.99,0.01,169,167.31,165.64,321.75,321.75,25.87,37.87,37.87,-0.13,-12.13,-12.13,325,325,38,38,0.13,-12,-12,625,625,50,12,12.13,0,625,12,12.13,0,118.42333333333333,13,12.87,0.99,93.42333333333333,25,25
91,1.99,0.01,625,618.75,612.56,0.0,297.0,49.75,24.75,36.75,-0.25,24.75,12.75,0,300,25,37,0.25,25,13,0,0,12,-25,-24.75,-12,144,-13,-12.75,12,324.81333333333333,25,24.75,0.99,324.81333333333333,0,12
92,1.01,0.99,625,6.25,0.06,6.25,6.25,25.25,25.25,25.25,-24.75,-24.75,-24.75,625,625,50,50,24.75,0,0,625,625,50,0,24.75,0,625,0,24.75,0,647.2113333333333,25,0.25,0.01,622.2113333333333,25,25
93,1.99,0.01,169,167.31,165.64,0.0,321.75,25.87,12.87,37.87,-0.13,12.87,-12.13,0,325,13,38,0.13,13,-12,0,0,25,-13,-12.87,-25,625,12,12.13,25,93.29933333333334,13,12.87,0.99,93.29933333333334,0,25
94,1.99,0.01,625,618.75,612.56,0.0,618.75,49.75,24.75,49.75,-0.25,24.75,-0.25,0,625,25,50,0.25,25,0,0,0,25,-25,-24.75,-25,625,0,0.25,25,328.0106666666667,25,24.75,0.99,328.0106666666667,0,25
95,1.01,0.99,1,0.01,0.0,0.24,0.25,1.01,24.01,25.01,-0.99,-23.99,-24.99,24,25,25,26,0.99,-23,-24,576,600,49,23,23.99,-1,625,24,24.99,1,48.792,1,0.01,0.01,24.792,24,25
96,1.99,0.01,4,3.96,3.92,0.0,0.0,3.98,1.98,1.98,-0.02,1.98,1.98,0,0,2,2,0.02,2,2,0,0,0,-2,-1.98,0,0,-2,-1.98,0,2.966666666666667,2,1.98,0.99,2.966666666666667,0,0
97,1.99,0.01,1,0.99,0.98,0.0,0.0,1.99,0.99,0.99,-0.01,0.99,0.99,0,0,1,1,0.01,1,1,0,0,0,-1,-0.99,0,0,-1,-0.99,0,0.988,1,0.99,0.99,0.988,0,0
98,1.01,0.99,169,1.69,0.02,0.0,0.0,13.13,0.13,0.13,-12.87,0.13,0.13,0,0,13,13,12.87,13,13,0,0,0,-13,-0.13,0,0,-13,-0.13,0,0.878,13,0.13,0.01,0.878,0,0
99,1.99,0.01,1,0.99,0.98,0.0,24.75,1.99,0.99,25.99,-0.01,0.99,-24.01,0,25,1,26,0.01,1,-24,0,0,25,-1,-0.99,-25,625,24,24.01,25,1.176,1,0.99,0.99,1.176,0,25
100,1.01,0.99,1,0.01,0.0,0.0,0.0,1.01,0.01,0.01,-0.99,0.01,0.01,0,0,1,1,0.99,1,1,0,0,0,-1,-0.01,0,0,-1,-0.01,0,0.008,1,0.01,0.01,0.008,0,0
101,1.09,0.91,625,57.4,5.27,0.0,57.4,27.3,2.3,27.3,-22.7,2.3,-22.7,0,625,25,50,22.7,25,0,0,0,25,-25,-2.3,-25,625,0,22.7,25,597.2773333333333,25,2.3,0.09183458033420318,597.2773333333333,0,25
102,1.99,0.01,1,0.99,0.98,0.0,0.0,1.99,0.99,0.99,-0.01,0.99,0.99,0,0,1,1,0.01,1,1,0,0,0,-1,-0.99,0,0,-1,-0.99,0,0.9906666666666667,1,0.99,0.99,0.9906666666666667,0,0
103,1.99,0.01,625,618.75,612.56,0.0,0.0,49.75,24.75,24.75,-0.25,24.75,24.75,0,0,25,25,0.25,25,25,0,0,0,-25,-24.75,0,0,-25,-24.75,0,321.50733333333335,25,24.75,0.99,321.50733333333335,0,0
104,1.99,0.01,1,0.99,0.98,24.75,24.75,1.99,25.99,25.99,-0.01,-24.01,-24.01,25,25,26,26,0.01,-24,-24,625,625,50,24,24.01,0,625,24,24.01,0,26.176,1,0.99,0.99,1.1759999999999984,25,25
105,1.01,0.99,4,0.04,0.0,0.5,0.0,2.02,25.02,0.02,-1.98,-24.98,0.02,50,0,27,2,1.98,-23,2,625,0,25,23,24.98,25,0,-2,-0.02,-25,25.032666666666668,2,0.02,0.01,0.03266666666666751,25,0
106,1.99,0.01,1,0.99,0.98,24.75,0.0,1.99,25.99,0.99,-0.01,-24.01,0.99,25,0,26,1,0.01,-24,1,625,0,25,24,24.01,25,0,-1,-0.99,-25,25.994666666666667,1,0.99,0.99,0.9946666666666673,25,0
107,1.01,0.99,625,6.25,0.06,0.0,0.0,25.25,0.25,0.25,-24.75,0.25,0.25,0,0,25,25,24.75,25,25,0,0,0,-25,-0.25,0,0,-25,-0.25,0,3.138,25,0.25,0.01,3.138,0,0
108,1.01,0.99,1,0.01,0.0,0.24,0.25,1.01,24.01,25.01,-0.99,-23.99,-24.99,24,25,25,26,0.99,-23,-24,576,600,49,23,23.99,-1,625,24,24.99,1,48.728,1,0.01,0.01,24.728,24,25
109,1.99,0.01,4,3.96,3.92,0.0,0.0,3.98,1.98,1.98,-0.02,1.98,1.98,0,0,2,2,0.02,2,2,0,0,0,-2,-1.98,0,0,-2,-1.98,0,2.966,2,1.98,0.99,2.966,0,0
110,1.83,0.17,625,517.5,428.49,517.5,248.4,45.7,45.7,32.7,-4.3,-4.3,8.7,625,300,50,37,4.3,0,13,625,300,37,0,4.3,13,144,-13,-8.7,-13,346.1206666666667,25,20.7,0.827999775353927,321.1206666666667,25,12
111,1.99,0.01,625,618.75,612.56,0.0,618.75,49.75,24.75,49.75,-0.25,24.75,-0.25,0,625,25,50,0.25,25,0,0,0,25,-25,-24.75,-25,625,0,0.25,25,328.07533333333333,25,24.75,0.99,328.07533333333333,0,25
112,1.99,0.01,1,0.99,0.98,0.0,0.0,1.99,0.99,0.99,-0.01,0.99,0.99,0,0,1,1,0.01,1,1,0,0,0,-1,-0.99,0,0,-1,-0.99,0,0.9846666666666667,1,0.99,0.99,0.9846666666666667,0,0
113,1.01,0.99,625,6.25,0.06,0.0,0.0,25.25,0.25,0.25,-24.75,0.25,0.25,0,0,25,25,24.75,25,25,0,0,0,-25,-0.25,0,0,-25,-0.25,0,3.3893333333333335,25,0.25,0.01,3.3893333333333335,0,0
114,1.99,0.01,625,618.75,612.56,0.0,321.75,49.75,24.75,37.75,-0.25,24.75,11.75,0,325,25,38,0.25,25,12,0,0,13,-25,-24.75,-13,169,-12,-11.75,13,325.0013333333333,25,24.75,0.99,325.0013333333333,0,13
115,1.99,0.01,625,618.75,612.56,0.0,618.75,49.75,24.75,49.75,-0.25,24.75,-0.25,0,625,25,50,0.25,25,0,0,0,25,-25,-24.75,-25,625,0,0.25,25,327.888,25,24.75,0.99,327.888,0,25
116,1.01,0.99,169,1.69,0.02,3.25,3.25,13.13,25.13,25.13,-12.87,-24.87,-24.87,325,325,38,38,12.87,-12,-12,625,625,50,12,24.87,0,625,12,24.87,0,348.01,13,0.13,0.01000000168537027,323.01,25,25
117,1.99,0.01,625,618.75,612.56,618.75,321.75,49.75,49.75,37.75,-0.25,-0.25,11.75,625,325,50,38,0.25,0,12,625,325,38,0,0.25,12,169,-12,-11.75,-12,349.998,25,24.75,0.99,324.998,25,13
118,1.99,0.01,169,167.31,165.64,0.0,321.75,25.87,12.87,37.87,-0.13,12.87,-12.13,0,325,13,38,0.13,13,-12,0,0,25,-13,-12.87,-25,625,12,12.13,25,93.40666666666667,13,12.87,0.99,93.40666666666667,0,25
119,1.99,0.01,225,222.75,220.52,0.0,371.25,29.85,14.85,39.85,-0.15,14.85,-10.15,0,375,15,40,0.15,15,-10,0,0,25,-15,-14.85,-25,625,10,10.15,25,122.576,15,14.85,0.99,122.576,0,25
120,1.99,0.01,1,0.99,0.98,0.0,0.99,1.99,0.99,1.99,-0.01,0.99,-0.01,0,1,1,2,0.01,1,0,0,0,1,-1,-0.99,-1,1,0,0.01,1,1.0,1,0.99,0.99,1.0,0,1
121,1.99,0.01,625,618.75,612.56,618.75,0.0,49.75,49.75,24.75,-0.25,-0.25,24.75,625,0,50,25,0.25,0,25,625,0,25,0,0.25,25,0,-25,-24.75,-25,346.75733333333335,25,24.75,0.99,321.75733333333335,25,0
122,1.99,0.01,1,0.99,0.98,0.0,0.0,1.99,0.99,0.99,-0.01,0.99,0.99,0,0,1,1,0.01,1,1,0,0,0,-1,-0.99,0,0,-1,-0.99,0,0.992,1,0.99,0.99,0.992,0,0
123,1.99,0.01,625,618.75,612.56,0.0,0.0,49.75,24.75,24.75,-0.25,24.75,24.75,0,0,25,25,0.25,25,25,0,0,0,-25,-24.75,0,0,-25,-24.75,0,321.89866666666666,25,24.75,0.99,321.89866666666666,0,0
124,1.01,0.99,1,0.01,0.0,0.0,0.25,1.01,0.01,25.01,-0.99,0.01,-24.99,0,25,1,26,0.99,1,-24,0,0,25,-1,-0.01,-25,625,24,24.99,25,24.744,1,0.01,0.01,24.744,0,25
125,1.99,0.01,1,0.99,0.98,0.0,0.99,1.99,0.99,1.99,-0.01,0.99,-0.01,0,1,1,2,0.01,1,0,0,0,1,-1,-0.99,-1,1,0,0.01,1,1.0,1,0.99,0.99,1.0,0,1
126,1.99,0.01,625,618.75,612.56,618.75,0.0,49.75,49.75,24.75,-0.25,-0.25,24.75,625,0,50,25,0.25,0,25,625,0,25,0,0.25,25,0,-25,-24.75,-25,347.122,25,24.75,0.99,322.122,25,0
127,1.01,0.99,144,1.44,0.01,3.0,3.0,12.12,25.12,25.12,-11.88,-24.88,-24.88,300,300,37,37,11.88,-13,-13,625,625,50,13,24.88,0,625,13,24.88,0,322.718,12,0.12,0.01,297.718,25,25
128,1.99,0.01,1,0.99,0.98,0.0,0.0,1.99,0.99,0.99,-0.01,0.99,0.99,0,0,1,1,0.01,1,1,0,0,0,-1,-0.99,0,0,-1,-0.99,0,0.9913333333333333,1,0.99,0.99,0.9913333333333333,0,0
129,1.99,0.01,625,618.75,612.56,0.0,0.0,49.75,24.75,24.75,-0.25,24.75,24.75,0,0,25,25,0.25,25,25,0,0,0,-25,-24.75,0,0,-25,-24.75,0,321.768,25,24.75,0.99,321.768,0,0
130,1.99,0.01,169,167.31,165.64,321.75,321.75,25.87,37.87,37.87,-0.13,-12.13,-12.13,325,325,38,38,0.13,-12,-12,625,625,50,12,12.13,0,625,12,12.13,0,118.42333333333333,13,12.87,0.99,93.42333333333333,25,25
131,1.99,0.01,625,618.75,612.56,0.0,297.0,49.75,24.75,36.75,-0.25,24.75,12.75,0,300,25,37,0.25,25,13,0,0,12,-25,-24.75,-12,144,-13,-12.75,12,324.81333333333333,25,24.75,0.99,324.81333333333333,0,12
132,1.01,0.99,625,6.25,0.06,6.25,6.25,25.25,25.25,25.25,-24.75,-24.75,-24.75,625,625,50,50,24.75,0,0,625,625,50,0,24.75,0,625,0,24.75,0,647.2113333333333,25,0.25,0.01,622.2113333333333,25,25
133,1.99,0.01,169,167.31,165.64,0.0,321.75,25.87,12.87,37.87,-0.13,12.87,-12.13,0,325,13,38,0.13,13,-12,0,0,25,-13,-12.87,-25,625,12,12.13,25,93.29933333333334,13,12.87,0.99,93.29933333333334,0,25
134,1.99,0.01,625,618.75,612.56,0.0,618.75,49.75,24.75,49.75,-0.25,24.75,-0.25,0,625,25,50,0.25,25,0,0,0,25,-25,-24.75,-25,625,0,0.25,25,328.0106666666667,25,24.75,0.99,328.0106666666667,0,25
135,1.01,0.99,1,0.01,0.0,0.24,0.25,1.01,24.01,25.01,-0.99,-23.99,-24.99,24,25,25,26,0.99,-23,-24,576,600,49,23,23.99,-1,625,24,24.99,1,48.792,1,0.01,0.01,24.792,24,25
136,1.99,0.01,4,3.96,3.92,0.0,0.0,3.98,1.98,1.98,-0.02,1.98,1.98,0,0,2,2,0.02,2,2,0,0,0,-2,-1.98,0,0,-2,-1.98,0,2.966666666666667,2,1.98,0.99,2.966666666666667,0,0
137,1.99,0.01,1,0.99,0.98,0.0,0.0,1.99,0.99,0.99,-0.01,0.99,0.99,0,0,1,1,0.01,1,1,0,0,0,-1,-0.99,0,0,-1,-0.99,0,0.988,1,0.99,0.99,0.988,0,0
138,1.01,0.99,169,1.69,0.02,0.0,0.0,13.13,0.13,0.13,-12.87,0.13,0.13,0,0,13,13,12.87,13,13,0,0,0,-13,-0.13,0,0,-13,-0.13,0,0.878,13,0.13,0.01,0.878,0,0
139,1.99,0.01,1,0.99,0.98,0.0,24.75,1.99,0.99,25.99,-0.01,0.99,-24.01,0,25,1,26,0.01,1,-24,0,0,25,-1,-0.99,-25,625,24,24.01,25,1.176,1,0.99,0.99,1.176,0,25
140,1.01,0.99,1,0.01,0.0,0.0,0.0,1.01,0.01,0.01,-0.99,0.01,0.01,0,0,1,1,0.99,1,1,0,0,0,-1,-0.01,0,0,-1,-0.01,0,0.008,1,0.01,0.01,0.008,0,0
141,1.09,0.91,625,57.4,5.27,0.0,57.4,27.3,2.3,27.3,-22.7,2.3,-22.7,0,625,25,50,22.7,25,0,0,0,25,-25,-2.3,-25,625,0,22.7,25,597.2773333333333,25,2.3,0.09183458033420318,597.2773333333333,0,25
142,1.99,0.01,1,0.99,0.98,0.0,0.0,1.99,0.99,0.99,-0.01,0.99,0.99,0,0,1,1,0.01,1,1,0,0,0,-1,-0.99,0,0,-1,-0.99,0,0.9906666666666667,1,0.99,0.99,0.9906666666666667,0,0
143,1.99,0.01,625,618.75,612.56,0.0,0.0,49.75,24.75,24.75,-0.25,24.75,24.75,0,0,25,25,0.25,25,25,0,0,0,-25,-24.75,0,0,-25,-24.75,0,321.50733333333335,25,24.75,0.99,321.50733333333335,0,0
144,1.99,0.01,1,0.99,0.98,24.75,24.75,1.99,25.99,25.99,-0.01,-24.01,-24.01,25,25,26,26,0.01,-24,-24,625,625,50,24,24.01,0,625,24,24.01,0,26.176,1,0.99,0.99,1.1759999999999984,25,25
145,1.01,0.99,4,0.04,0.0,0.5,0.0,2.02,25.02,0.02,-1.98,-24.98,0.02,50,0,27,2,1.98,-23,2,625,0,25,23,24.98,25,0,-2,-0.02,-25,25.032666666666668,2,0.02,0.01,0.03266666666666751,25,0
146,1.99,0.01,1,0.99,0.98,24.75,0.0,1.99,25.99,0.99,-0.01,-24.01,0.99,25,0,26,1,0.01,-24,1,625,0,25,24,24.01,25,0,-1,-0.99,-25,25.994666666666667,1,0.99,0.99,0.9946666666666673,25,0
147,1.01,0.99,625,6.25,0.06,0.0,0.0,25.25,0.25,0.25,-24.75,0.25,0.25,0,0,25,25,24.75,25,25,0,0,0,-25,-0.25,0,0,-25,-0.25,0,3.138,25,0.25,0.01,3.138,0,0
148,1.01,0.99,1,0.01,0.0,0.24,0.25,1.01,24.01,25.01,-0.99,-23.99,-24.99,24,25,25,26,0.99,-23,-24,576,600,49,23,23.99,-1,625,24,24.99,1,48.728,1,0.01,0.01,24.728,24,25
149,1.99,0.01,4,3.96,3.92,0.0,0.0,3.98,1.98,1.98,-0.02,1.98,1.98,0,0,2,2,0.02,2,2,0,0,0,-2,-1.98,0,0,-2,-1.98,0,2.966,2,1.98,0.99,2.966,0,0
150,1.83,0.17,625,517.5,428.49,517.5,248.4,45.7,45.7,32.7,-4.3,-4.3,8.7,625,300,50,37,4.3,0,13,625,300,37,0,4.3,13,144,-13,-8.7,-13,346.1206666666667,25,20.7,0.827999775353927,321.1206666666667,25,12
151,1.99,0.01,625,618.75,612.56,0.0,618.75,49.75,24.75,49.75,-0.25,24.75,-0.25,0,625,25,50,0.25,25,0,0,0,25,-25,-24.75,-25,625,0,0.25,25,328.07533333333333,25,24.75,0.99,328.07533333333333,0,25
152,1.99,0.01,1,0.99,0.98,0.0,0.0,1.99,0.99,0.99,-0.01,0.99,0.99,0,0,1,1,0.01,1,1,0,0,0,-1,-0.99,0,0,-1,-0.99,0,0.9846666666666667,1,0.99,0.99,0.9846666666666667,0,0
153,1.01,0.99,625,6.25,0.06,0.0,0.0,25.25,0.25,0.25,-24.75,0.25,0.25,0,0,25,25,24.75,25,25,0,0,0,-25,-0.25,0,0,-25,-0.25,0,3.3893333333333335,25,0.25,0.01,3.3893333333333335,0,0
154,1.99,0.01,625,618.75,612.56,0.0,321.75,49.75,24.75,37.75,-0.25,24.75,11.75,0,325,25,38,0.25,25,12,0,0,13,-25,-24.75,-13,169,-12,-11.75,13,325.0013333333333,25,24.75,0.99,325.0013333333333,0,13
155,1.99,0.01,625,618.75,612.56,0.0,618.75,49.75,24.75,49.75,-0.25,24.75,-0.25,0,625,25,50,0.25,25,0,0,0,25,-25,-24.75,-25,625,0,0.25,25,327.888,25,24.75,0.99,327.888,0,25
156,1.01,0.99,169,1.69,0.02,3.25,3.25,13.13,25.13,25.13,-12.87,-24.87,-24.87,325,325,38,38,12.87,-12,-12,625,625,50,12,24.87,0,625,12,24.87,0,348.01,13,0.13,0.01000000168537027,323.01,25,25
157,1.99,0.01,625,618.75,612.56,618.75,321.75,49.75,49.75,37.75,-0.25,-0.25,11.75,625,325,50,38,0.25,0,12,625,325,38,0,0.25,12,169,-12,-11.75,-12,349.998,25,24.75,0.99,324.998,25,13
158,1.99,0.01,169,167.31,165.64,0.0,321.75,25.87,12.87,37.87,-0.13,12.87,-12.13,0,325,13,38,0.13,13,-12,0,0,25,-13,-12.87,-25,625,12,12.13,25,93.40666666666667,13,12.87,0.99,93.40666666666667,0,25
159,1.99,0.01,225,222.75,220.52,0.0,371.25,29.85,14.85,39.85,-0.15,14.85,-10.15,0,375,15,40,0.15,15,-10,0,0,25,-15,-14.85,-25,625,10,10.15,25,122.576,15,14.85,0.99,122.576,0,25
160,1.99,0.01,1,0.99,0.98,0.0,0.99,1.99,0.99,1.99,-0.01,0.99,-0.01,0,1,1,2,0.01,1,0,0,0,1,-1,-0.99,-1,1,0,0.01,1,1.0,1,0.99,0.99,1.0,0,1
161,1.99,0.01,625,618.75,612.56,618.75,0.0,49.75,49.75,24.75,-0.25,-0.25,24.75,625,0,50,25,0.25,0,25,625,0,25,0,0.25,25,0,-25,-24.75,-25,346.75733333333335,25,24.75,0.99,321.75733333333335,25,0
162,1.99,0.01,1,0.99,0.98,0.0,0.0,1.99,0.99,0.99,-0.01,0.99,0.99,0,0,1,1,0.01,1,1,0,0,0,-1,-0.99,0,0,-1,-0.99,0,0.992,1,0.99,0.99,0.992,0,0
163,1.99,0.01,625,618.75,612.56,0.0,0.0,49.75,24.75,24.75,-0.25,24.75,24.75,0,0,25,25,0.25,25,25,0,0,0,-25,-24.75,0,0,-25,-24.75,0,321.89866666666666,25,24.75,0.99,321.89866666666666,0,0
164,1.01,0.99,1,0.01,0.0,0.0,0.25,1.01,0.01,25.01,-0.99,0.01,-24.99,0,25,1,26,0.99,1,-24,0,0,25,-1,-0.01,-25,625,24,24.99,25,24.744,1,0.01,0.01,24.744,0,25
165,1.99,0.01,1,0.99,0.98,0.0,0.99,1.99,0.99,1.99,-0.01,0.99,-0.01,0,1,1,2,0.01,1,0,0,0,1,-1,-0.99,-1,1,0,0.01,1,1.0,1,0.99,0.99,1.0,0,1
166,1.99,0.01,625,618.75,612.56,618.75,0.0,49.75,49.75,24.75,-0.25,-0.25,24.75,625,0,50,25,0.25,0,25,625,0,25,0,0.25,25,0,-25,-24.75,-25,347.122,25,24.75,0.99,322.122,25,0
167,1.01,0.99,144,1.44,0.01,3.0,3.0,12.12,25.12,25.12,-11.88,-24.88,-24.88,300,300,37,37,11.88,-13,-13,625,625,50,13,24.88,0,625,13,24.88,0,322.718,12,0.12,0.01,297.718,25,25
168,1.99,0.01,1,0.99,0.98,0.0,0.0,1.99,0.99,0.99,-0.01,0.99,0.99,0,0,1,1,0.01,1,1,0,0,0,-1,-0.99,0,0,-1,-0.99,0,0.9913333333333333,1,0.99,0.99,0.9913333333333333,0,0
169,1.99,0.01,625,618.75,612.56,0.0,0.0,49.75,24.75,24.75,-0.25,24.75,24.75,0,0,25,25,0.25,25,25,0,0,0,-25,-24.75,0,0,-25,-24.75,0,321.768,25,24.75,0.99,321.768,0,0
170,1.99,0.01,169,167.31,165.64,321.75,321.75,25.87,37.87,37.87,-0.13,-12.13,-12.13,325,325,38,38,0.13,-12,-12,625,625,50,12,12.13,0,625,12,12.13,0,118.42333333333333,13,12.87,0.99,93.42333333333333,25,25
171,1.99,0.01,625,618.75,612.56,0.0,297.0,49.75,24.75,36.75,-0.25,24.75,12.75,0,300,25,37,0.25,25,13,0,0,12,-25,-24.75,-12,144,-13,-12.75,12,324.81333333333333,25,24.75,0.99,324.81333333333333,0,12
172,1.01,0.99,625,6.25,0.06,6.25,6.25,25.25,25.25,25.25,-24.75,-24.75,-24.75,625,625,50,50,24.75,0,0,625,625,50,0,24.75,0,625,0,24.75,0,647.2113333333333,25,0.25,0.01,622.2113333333333,25,25
173,1.99,0.01,169,167.31,165.64,0.0,321.75,25.87,12.87,37.87,-0.13,12.87,-12.13,0,325,13,38,0.13,13,-12,0,0,25,-13,-12.87,-25,625,12,12.13,25,93.29933333333334,13,12.87,0.99,93.29933333333334,0,25
174,1.99,0.01,625,618.75,612.56,0.0,618.75,49.75,24.75,49.75,-0.25,24.75,-0.25,0,625,25,50,0.25,25,0,0,0,25,-25,-24.75,-25,625,0,0.25,25,328.0106666666667,25,24.75,0.99,328.0106666666667,0,25
175,1.01,0.99,1,0.01,0.0,0.24,0.25,1.01,24.01,25.01,-0.99,-23.99,-24.99,24,25,25,26,0.99,-23,-24,576,600,49,23,23.99,-1,625,24,24.99,1,48.792,1,0.01,0.01,24.792,24,25
176,1.99,0.01,4,3.96,3.92,0.0,0.0,3.98,1.98,1.98,-0.02,1.98,1.98,0,0,2,2,0.02,2,2,0,0,0,-2,-1.98,0,0,-2,-1.98,0,2.966666666666667,2,1.98,0.99,2.966666666666667,0,0
177,1.99,0.01,1,0.99,0.98,0.0,0.0,1.99,0.99,0.99,-0.01,0.99,0.99,0,0,1,1,0.01,1,1,0,0,0,-1,-0.99,0,0,-1,-0.99,0,0.988,1,0.99,0.99,0.988,0,0
178,1.01,0.99,169,1.69,0.02,0.0,0.0,13.13,0.13,0.13,-12.87,0.13,0.13,0,0,13,13,12.87,13,13,0,0,0,-13,-0.13,0,0,-13,-0.13,0,0.878,13,0.13,0.01,0.878,0,0
179,1.99,0.01,1,0.99,0.98,0.0,24.75,1.99,0.99,25.99,-0.01,0.99,-24.01,0,25,1,26,0.01,1,-24,0,0,25,-1,-0.99,-25,625,24,24.01,25,1.176,1,0.99,0.99,1.176,0,25
180,1.01,0.99,1,0.01,0.0,0.0,0.0,1.01,0.01,0.01,-0.99,0.01,0.01,0,0,1,1,0.99,1,1,0,0,0,-1,-0.01,0,0,-1,-0.01,0,0.008,1,0.01,0.01,0.008,0,0
181,1.09,0.91,625,57.4,5.27,0.0,57.4,27.3,2.3,27.3,-22.7,2.3,-22.7,0,625,25,50,22.7,25,0,0,0,25,-25,-2.3,-25,625,0,22.7,25,597.2773333333333,25,2.3,0.09183458033420318,597.2773333333333,0,25
182,1.99,0.01,1,0.99,0.98,0.0,0.0,1.99,0.99,0.99,-0.01,0.99,0.99,0,0,1,1,0.01,1,1,0,0,0,-1,-0.99,0,0,-1,-0.99,0,0.9906666666666667,1,0.99,0.99,0.9906666666666667,0,0
183,1.99,0.01,625,618.75,612.56,0.0,0.0,49.75,24.75,24.75,-0.25,24.75,24.75,0,0,25,25,0.25,25,25,0,0,0,-25,-24.75,0,0,-25,-24.75,0,321.50733333333335,25,24.75,0.99,321.50733333333335,0,0
184,1.99,0.01,1,0.99,0.98,24.75,24.75,1.99,25.99,25.99,-0.01,-24.01,-24.01,25,25,26,26,0.01,-24,-24,625,625,50,24,24.01,0,625,24,24.01,0,26.176,1,0.99,0.99,1.1759999999999984,25,25
185,1.01,0.99,4,0.04,0.0,0.5,0.0,2.02,25.02,0.02,-1.98,-24.98,0.02,50,0,27,2,1.98,-23,2,625,0,25,23,24.98,25,0,-2,-0.02,-25,25.032666666666668,2,0.02,0.01,0.03266666666666751,25,0
186,1.99,0.01,1,0.99,0.98,24.75,0.0,1.99,25.99,0.99,-0.01,-24.01,0.99,25,0,26,1,0.01,-24,1,625,0,25,24,24.01,25,0,-1,-0.99,-25,25.994666666666667,1,0.99,0.99,0.9946666666666673,25,0
187,1.01,0.99,625,6.25,0.06,0.0,0.0,25.25,0.25,0.25,-24.75,0.25,0.25,0,0,25,25,24.75,25,25,0,0,0,-25,-0.25,0,0,-25,-0.25,0,3.138,25,0.25,0.01,3.138,0,0
188,1.01,0.99,1,0.01,0.0,0.24,0.25,1.01,24.01,25.01,-0.99,-23.99,-24.99,24,25,25,26,0.99,-23,-24,576,600,49,23,23.99,-1,625,24,24.99,1,48.728,1,0.01,0.01,24.728,24,25
189,1.99,0.01,4,3.96,3.92,0.0,0.0,3.98,1.98,1.98,-0.02,1.98,1.98,0,0,2,2,0.02,2,2,0,0,0,-2,-1.98,0,0,-2,-1.98,0,2.966,2,1.98,0.99,2.966,0,0
190,1.83,0.17,625,517.5,428.49,517.5,248.4,45.7,45.7,32.7,-4.3,-4.3,8.7,625,300,50,37,4.3,0,13,625,300,37,0,4.3,13,144,-13,-8.7,-13,346.1206666666667,25,20.7,0.827999775353927,321.1206666666667,25,12
191,1.99,0.01,625,618.75,612.56,0.0,618.75,49.75,24.75,49.75,-0.25,24.75,-0.25,0,625,25,50,0.25,25,0,0,0,25,-25,-24.75,-25,625,0,0.25,25,328.07533333333333,25,24.75,0.99,328.07533333333333,0,25
192,1.99,0.01,1,0.99,0.98,0.0,0.0,1.99,0.99,0.99,-0.01,0.99,0.99,0,0,1,1,0.01,1,1,0,0,0,-1,-0.99,0,0,-1,-0.99,0,0.9846666666666667,1,0.99,0.99,0.9846666666666667,0,0
193,1.01,0.99,625,6.25,0.06,0.0,0.0,25.25,0.25,0.25,-24.75,0.25,0.25,0,0,25,25,24.75,25,25,0,0,0,-25,-0.25,0,0,-25,-0.25,0,3.3893333333333335,25,0.25,0.01,3.3893333333333335,0,0
194,1.99,0.01,625,618.75,612.56,0.0,321.75,49.75,24.75,37.75,-0.25,24.75,11.75,0,325,25,38,0.25,25,12,0,0,13,-25,-24.75,-13,169,-12,-11.75,13,325.0013333333333,25,24.75,0.99,325.0013333333333,0,13
195,1.99,0.01,625,618.75,612.56,0.0,618.75,49.75,24.75,49.75,-0.25,24.75,-0.25,0,625,25,50,0.25,25,0,0,0,25,-25,-24.75,-25,625,0,0.25,25,327.888,25,24.75,0.99,327.888,0,25
196,1.01,0.99,169,1.69,0.02,3.25,3.25,13.13,25.13,25.13,-12.87,-24.87,-24.87,325,325,38,38,12.87,-12,-12,625,625,50,12,24.87,0,625,12,24.87,0,348.01,13,0.13,0.01000000168537027,323.01,25,25
197,1.99,0.01,625,618.75,612.56,618.75,321.75,49.75,49.75,37.75,-0.25,-0.25,11.75,625,325,50,38,0.25,0,12,625,325,38,0,0.25,12,169,-12,-11.75,-12,349.998,25,24.75,0.99,324.998,25,13
198,1.99,0.01,169,167.31,165.64,0.0,321.75,25.87,12.87,37.87,-0.13,12.87,-12.13,0,325,13,38,0.13,13,-12,0,0,25,-13,-12.87,-25,625,12,12.13,25,93.40666666666667,13,12.87,0.99,93.40666666666667,0,25
199,1.99,0.01,225,222.75,220.52,0.0,371.25,29.85,14.85,39.85,-0.15,14.85,-10.15,0,375,15,40,0.15,15,-10,0,0,25,-15,-14.85,-25,625,10,10.15,25,122.576,15,14.85,0.99,122.576,0,25
200,1.99,0.01,1,0.99,0.98,0.0,0.99,1.99,0.99,1.99,-0.01,0.99,-0.01,0,1,1,2,0.01,1,0,0,0,1,-1,-0.99,-1,1,0,0.01,1,1.0,1,0.99,0.99,1.0,0,1
201,1.99,0.01,625,618.75,612.56,618.75,0.0,49.75,49.75,24.75,-0.25,-0.25,24.75,625,0,50,25,0.25,0,25,625,0,25,0,0.25,25,0,-25,-24.75,-25,346.75733333333335,25,24.75,0.99,321.75733333333335,25,0
202,1.99,0.01,1,0.99,0.98,0.0,0.0,1.99,0.99,0.99,-0.01,0.99,0.99,0,0,1,1,0.01,1,1,0,0,0,-1,-0.99,0,0,-1,-0.99,0,0.992,1,0.99,0.99,0.992,0,0
203,1.99,0.01,625,618.75,612.56,0.0,0.0,49.75,24.75,24.75,-0.25,24.75,24.75,0,0,25,25,0.25,25,25,0,0,0,-25,-24.75,0,0,-25,-24.75,0,321.89866666666666,25,24.75,0.99,321.89866666666666,0,0
204,1.01,0.99,1,0.01,0.0,0.0,0.25,1.01,0.01,25.01,-0.99,0.01,-24.99,0,25,1,26,0.99,1,-24,0,0,25,-1,-0.01,-25,625,24,24.99,25,24.744,1,0.01,0.01,24.744,0,25
205,1.99,0.01,1,0.99,0.98,0.0,0.99,1.99,0.99,1.99,-0.01,0.99,-0.01,0,1,1,2,0.01,1,0,0,0,1,-1,-0.99,-1,1,0,0.01,1,1.0,1,0.99,0.99,1.0,0,1
206,1.99,0.01,625,618.75,612.56,618.75,0.0,49.75,49.75,24.75,-0.25,-0.25,24.75,625,0,50,25,0.25,0,25,625,0,25,0,0.25,25,0,-25,-24.75,-25,347.122,25,24.75,0.99,322.122,25,0
207,1.01,0.99,144,1.44,0.01,3.0,3.0,12.12,25.12,25.12,-11.88,-24.88,-24.88,300,300,37,37,11.88,-13,-13,625,625,50,13,24.88,0,625,13,24.88,0,322.718,12,0.12,0.01,297.718,25,25
208,1.99,0.01,1,0.99,0.98,0.0,0.0,1.99,0.99,0.99,-0.01,0.99,0.99,0,0,1,1,0.01,1,1,0,0,0,-1,-0.99,0,0,-1,-0.99,0,0.9913333333333333,1,0.99,0.99,0.9913333333333333,0,0
209,1.99,0.01,625,618.75,612.56,0.0,0.0,49.75,24.75,24.75,-0.25,24.75,24.75,0,0,25,25,0.25,25,25,0,0,0,-25,-24.75,0,0,-25,-24.75,0,321.768,25,24.75,0.99,321.768,0,0
210,1.99,0.01,169,167.31,165.64,321.75,321.75,25.87,37.87,37.87,-0.13,-12.13,-12.13,325,325,38,38,0.13,-12,-12,625,625,50,12,12.13,0,625,12,12.13,0,118.42333333333333,13,12.87,0.99,93.42333333333333,25,25
211,1.99,0.01,625,618.75,612.56,0.0,297.0,49.75,24.75,36.75,-0.25,24.75,12.75,0,300,25,37,0.25,25,13,0,0,12,-25,-24.75,-12,144,-13,-12.75,12,324.81333333333333,25,24.75,0.99,324.81333333333333,0,12
212,1.01,0.99,625,6.25,0.06,6.25,6.25,25.25,25.25,25.25,-24.75,-24.75,-24.75,625,625,50,50,24.75,0,0,625,625,50,0,24.75,0,625,0,24.75,0,647.2113333333333,25,0.25,0.01,622.2113333333333,25,25
213,1.99,0.01,169,167.31,165.64,0.0,321.75,25.87,12.87,37.87,-0.13,12.87,-12.13,0,325,13,38,0.13,13,-12,0,0,25,-13,-12.87,-25,625,12,12.13,25,93.29933333333334,13,12.87,0.99,93.29933333333334,0,25
214,1.99,0.01,625,618.75,612.56,0.0,618.75,49.75,24.75,49.75,-0.25,24.75,-0.25,0,625,25,50,0.25,25,0,0,0,25,-25,-24.75,-25,625,0,0.25,25,328.0106666666667,25,24.75,0.99,328.0106666666667,0,25
215,1.01,0.99,1,0.01,0.0,0.24,0.25,1.01,24.01,25.01,-0.99,-23.99,-24.99,24,25,25,26,0.99,-23,-24,576,600,49,23,23.99,-1,625,24,24.99,1,48.792,1,0.01,0.01,24.792,24,25
216,1.99,0.01,4,3.96,3.92,0.0,0.0,3.98,1.98,1.98,-0.02,1.98,1.98,0,0,2,2,0.02,2,2,0,0,0,-2,-1.98,0,0,-2,-1.98,0,2.966666666666667,2,1.98,0.99,2.966666666666667,0,0
217,1.99,0.01,1,0.99,0.98,0.0,0.0,1.99,0.99,0.99,-0.01,0.99,0.99,0,0,1,1,0.01,1,1,0,0,0,-1,-0.99,0,0,-1,-0.99,0,0.988,1,0.99,0.99,0.988,0,0
218,1.01,0.99,169,1.69,0.02,0.0,0.0,13.13,0.13,0.13,-12.87,0.13,0.13,0,0,13,13,12.87,13,13,0,0,0,-13,-0.13,0,0,-13,-0.13,0,0.878,13,0.13,0.01,0.878,0,0
219,1.99,0.01,1,0.99,0.98,0.0,24.75,1.99,0.99,25.99,-0.01,0.99,-24.01,0,25,1,26,0.01,1,-24,0,0,25,-1,-0.99,-25,625,24,24.01,25,1.176,1,0.99,0.99,1.176,0,25
220,1.01,0.99,1,0.01,0.0,0.0,0.0,1.01,0.01,0.01,-0.99,0.01,0.01,0,0,1,1,0.99,1,1,0,0,0,-1,-0.01,0,0,-1,-0.01,0,0.008,1,0.01,0.01,0.008,0,0
221,1.09,0.91,625,57.4,5.27,0.0,57.4,27.3,2.3,27.3,-22.7,2.3,-22.7,0,625,25,50,22.7,25,0,0,0,25,-25,-2.3,-25,625,0,22.7,25,597.2773333333333,25,2.3,0.09183458033420318,597.2773333333333,0,25
222,1.99,0.01,1,0.99,0.98,0.0,0.0,1.99,0.99,0.99,-0.01,0.99,0.99,0,0,1,1,0.01,1,1,0,0,0,-1,-0.99,0,0,-1,-0.99,0,0.9906666666666667,1,0.99,0.99,0.9906666666666667,0,0
223,1.99,0.01,625,618.75,612.56,0.0,0.0,49.75,24.75,24.75,-0.25,24.75,24.75,0,0,25,25,0.25,25,25,0,0,0,-25,-24.75,0,0,-25,-24.75,0,321.50733333333335,25,24.75,0.99,321.50733333333335,0,0
224,1.99,0.01,1,0.99,0.98,24.75,24.75,1.99,25.99,25.99,-0.01,-24.01,-24.01,25,25,26,26,0.01,-24,-24,625,625,50,24,24.01,0,625,24,24.01,0,26.176,1,0.99,0.99,1.1759999999999984,25,25
225,1.01,0.99,4,0.04,0.0,0.5,0.0,2.02,25.02,0.02,-1.98,-24.98,0.02,50,0,27,2,1.98,-23,2,625,0,25,23,24.98,25,0,-2,-0.02,-25,25.032666666666668,2,0.02,0.01,0.03266666666666751,25,0
226,1.99,0.01,1,0.99,0.98,24.75,0.0,1.99,25.99,0.99,-0.01,-24.01,0.99,25,0,26,1,0.01,-24,1,625,0,25,24,24.01,25,0,-1,-0.99,-25,25.994666666666667,1,0.99,0.99,0.9946666666666673,25,0
227,1.01,0.99,625,6.25,0.06,0.0,0.0,25.25,0.25,0.25,-24.75,0.25,0.25,0,0,25,25,24.75,25,25,0,0,0,-25,-0.25,0,0,-25,-0.25,0,3.138,25,0.25,0.01,3.138,0,0
228,1.01,0.99,1,0.01,0.0,0.24,0.25,1.01,24.01,25.01,-0.99,-23.99,-24.99,24,25,25,26,0.99,-23,-24,576,600,49,23,23.99,-1,625,24,24.99,1,48.728,1,0.01,0.01,24.728,24,25
229,1.99,0.01,4,3.96,3.92,0.0,0.0,3.98,1.98,1.98,-0.02,1.98,1.98,0,0,2,2,0.02,2,2,0,0,0,-2,-1.98,0,0,-2,-1.98,0,2.966,2,1.98,0.99,2.966,0,0
230,1.83,0.17,625,517.5,428.49,517.5,248.4,45.7,45.7,32.7,-4.3,-4.3,8.7,625,300,50,37,4.3,0,13,625,300,37,0,4.3,13,144,-13,-8.7,-13,346.1206666666667,25,20.7,0.827999775353927,321.1206666666667,25,12
231,1.99,0.01,625,618.75,612.56,0.0,618.75,49.75,24.75,49.75,-0.25,24.75,-0.25,0,625,25,50,0.25,25,0,0,0,25,-25,-24.75,-25,625,0,0.25,25,328.07533333333333,25,24.75,0.99,328.07533333333333,0,25
232,1.99,0.01,1,0.99,0.98,0.0,0.0,1.99,0.99,0.99,-0.01,0.99,0.99,0,0,1,1,0.01,1,1,0,0,0,-1,-0.99,0,0,-1,-0.99,0,0.9846666666666667,1,0.99,0.99,0.9846666666666667,0,0
233,1.01,0.99,625,6.25,0.06,0.0,0.0,25.25,0.25,0.25,-24.75,0.25,0.25,0,0,25,25,24.75,25,25,0,0,0,-25,-0.25,0,0,-25,-0.25,0,3.3893333333333335,25,0.25,0.01,3.3893333333333335,0,0
234,1.99,0.01,625,618.75,612.56,0.0,321.75,49.75,24.75,37.75,-0.25,24.75,11.75,0,325,25,38,0.25,25,12,0,0,13,-25,-24.75,-13,169,-12,-11.75,13,325.0013333333333,25,24.75,0.99,325.0013333333333,0,13
235,1.99,0.01,625,618.75,612.56,0.0,618.75,49.75,24.75,49.75,-0.25,24.75,-0.25,0,625,25,50,0.25,25,0,0,0,25,-25,-24.75,-25,625,0,0.25,25,327.888,25,24.75,0.99,327.888,0,25
236,1.01,0.99,169,1.69,0.02,3.25,3.25,13.13,25.13,25.13,-12.87,-24.87,-24.87,325,325,38,38,12.87,-12,-12,625,625,50,12,24.87,0,625,12,24.87,0,348.01,13,0.13,0.01000000168537027,323.01,25,25
237,1.99,0.01,625,618.75,612.56,618.75,321.75,49.75,49.75,37.75,-0.25,-0.25,11.75,625,325,50,38,0.25,0,12,625,325,38,0,0.25,12,169,-12,-11.75,-12,349.998,25,24.75,0.99,324.998,25,13
238,1.99,0.01,169,167.31,165.64,0.0,321.75,25.87,12.87,37.87,-0.13,12.87,-12.13,0,325,13,38,0.13,13,-12,0,0,25,-13,-12.87,-25,625,12,12.13,25,93.40666666666667,13,12.87,0.99,93.40666666666667,0,25
239,1.99,0.01,225,222.75,220.52,0.0,371.25,29.85,14.85,39.85,-0.15,14.85,-10.15,0,375,15,40,0.15,15,-10,0,0,25,-15,-14.85,-25,625,10,10.15,25,122.576,15,14.85,0.99,122.576,0,25
240,1.99,0.01,1,0.99,0.98,0.0,0.99,1.99,0.99,1.99,-0.01,0.99,-0.01,0,1,1,2,0.01,1,0,0,0,1,-1,-0.99,-1,1,0,0.01,1,1.0,1,0.99,0.99,1.0,0,1
241,1.99,0.01,625,618.75,612.56,618.75,0.0,49.75,49.75,24.75,-0.25,-0.25,24.75,625,0,50,25,0.25,0,25,625,0,25,0,0.25,25,0,-25,-24.75,-25,346.75733333333335,25,24.75,0.99,321.75733333333335,25,0
242,1.99,0.01,1,0.99,0.98,0.0,0.0,1.99,0.99,0.99,-0.01,0.99,0.99,0,0,1,1,0.01,1,1,0,0,0,-1,-0.99,0,0,-1,-0.99,0,0.992,1,0.99,0.99,0.992,0,0
243,1.99,0.01,625,618.75,612.56,0.0,0.0,49.75,24.75,24.75,-0.25,24.75,24.75,0,0,25,25,0.25,25,25,0,0,0,-25,-24.75,0,0,-25,-24.75,0,321.89866666666666,25,24.75,0.99,321.89866666666666,0,0
244,1.01,0.99,1,0.01,0.0,0.0,0.25,1.01,0.01,25.01,-0.99,0.01,-24.99,0,25,1,26,0.99,1,-24,0,0,25,-1,-0.01,-25,625,24,24.99,25,24.744,1,0.01,0.01,24.744,0,25
245,1.99,0.01,1,0.99,0.98,0.0,0.99,1.99,0.99,1.99,-0.01,0.99,-0.01,0,1,1,2,0.01,1,0,0,0,1,-1,-0.99,-1,1,0,0.01,1,1.0,1,0.99,0.99,1.0,0,1
246,1.99,0.01,625,618.75,612.56,618.75,0.0,49.75,49.75,24.75,-0.25,-0.25,24.75,625,0,50,25,0.25,0,25,625,0,25,0,0.25,25,0,-25,-24.75,-25,347.122,25,24.75,0.99,322.122,25,0
247,1.01,0.99,144,1.44,0.01,3.0,3.0,12.12,25.12,25.12,-11.88,-24.88,-24.88,300,300,37,37,11.88,-13,-13,625,625,50,13,24.88,0,625,13,24.88,0,322.718,12,0.12,0.01,297.718,25,25
248,1.99,0.01,1,0.99,0.98,0.0,0.0,1.99,0.99,0.99,-0.01,0.99,0.99,0,0,1,1,0.01,1,1,0,0,0,-1,-0.99,0,0,-1,-0.99,0,0.9913333333333333,1,0.99,0.99,0.9913333333333333,0,0
249,1.99,0.01,625,618.75,612.56,0.0,0.0,49.75,24.75,24.75,-0.25,24.75,24.75,0,0,25,25,0.25,25,25,0,0,0,-25,-24.75,0,0,-25,-24.75,0,321.768,25,24.75,0.99,321.768,0,0
250,1.99,0.01,169,167.31,165.64,321.75,321.75,25.87,37.87,37.87,-0.13,-12.13,-12.13,325,325,38,38,0.13,-12,-12,625,625,50,12,12.13,0,625,12,12.13,0,118.42333333333333,13,12.87,0.99,93.42333333333333,25,25
251,1.99,0.01,625,618.75,612.56,0.0,297.0,49.75,24.75,36.75,-0.25,24.75,12.75,0,300,25,37,0.25,25,13,0,0,12,-25,-24.75,-12,144,-13,-12.75,12,324.81333333333333,25,24.75,0.99,324.81333333333333,0,12
252,1.01,0.99,625,6.25,0.06,6.25,6.25,25.25,25.25,25.25,-24.75,-24.75,-24.75,625,625,50,50,24.75,0,0,625,625,50,0,24.75,0,625,0,24.75,0,647.2113333333333,25,0.25,0.01,622.2113333333333,25,25
253,1.99,0.01,169,167.31,165.64,0.0,321.75,25.87,12.87,37.87,-0.13,12.87,-12.13,0,325,13,38,0.13,13,-12,0,0,25,-13,-12.87,-25,625,12,12.13,25,93.29933333333334,13,12.87,0.99,93.29933333333334,0,25
254,1.99,0.01,625,618.75,612.56,0.0,618.75,49.75,24.75,49.75,-0.25,24.75,-0.25,0,625,25,50,0.25,25,0,0,0,25,-25,-24.75,-25,625,0,0.25,25,328.0106666666667,25,24.75,0.99,328.0106666666667,0,25
255,1.01,0.99,1,0.01,0.0,0.24,0.25,1.01,24.01,25.01,-0.99,-23.99,-24.99,24,25,25,26,0.99,-23,-24,576,600,49,23,23.99,-1,625,24,24.99,1,48.792,1,0.01,0.01,24.792,24,25
256,1.99,0.01,4,3.96,3.92,0.0,0.0,3.98,1.98,1.98,-0.02,1.98,1.98,0,0,2,2,0.02,2,2,0,0,0,-2,-1.98,0,0,-2,-1.98,0,2.966666666666667,2,1.98,0.99,2.966666666666667,0,0
257,1.99,0.01,1,0.99,0.98,0.0,0.0,1.99,0.99,0.99,-0.01,0.99,0.99,0,0,1,1,0.01,1,1,0,0,0,-1,-0.99,0,0,-1,-0.99,0,0.988,1,0.99,0.99,0.988,0,0
258,1.01,0.99,169,1.69,0.02,0.0,0.0,13.13,0.13,0.13,-12.87,0.13,0.13,0,0,13,13,12.87,13,13,0,0,0,-13,-0.13,0,0,-13,-0.13,0,0.878,13,0.13,0.01,0.878,0,0
259,1.99,0.01,1,0.99,0.98,0.0,24.75,1.99,0.99,25.99,-0.01,0.99,-24.01,0,25,1,26,0.01,1,-24,0,0,25,-1,-0.99,-25,625,24,24.01,25,1.176,1,0.99,0.99,1.176,0,25
260,1.01,0.99,1,0.01,0.0,0.0,0.0,1.01,0.01,0.01,-0.99,0.01,0.01,0,0,1,1,0.99,1,1,0,0,0,-1,-0.01,0,0,-1,-0.01,0,0.008,1,0.01,0.01,0.008,0,0
261,1.09,0.91,625,57.4,5.27,0.0,57.4,27.3,2.3,27.3,-22.7,2.3,-22.7,0,625,25,50,22.7,25,0,0,0,25,-25,-2.3,-25,625,0,22.7,25,597.2773333333333,25,2.3,0.09183458033420318,597.2773333333333,0,25
262,1.99,0.01,1,0.99,0.98,0.0,0.0,1.99,0.99,0.99,-0.01,0.99,0.99,0,0,1,1,0.01,1,1,0,0,0,-1,-0.99,0,0,-1,-0.99,0,0.9906666666666667,1,0.99,0.99,0.9906666666666667,0,0
263,1.99,0.01,625,618.75,612.56,0.0,0.0,49.75,24.75,24.75,-0.25,24.75,24.75,0,0,25,25,0.25,25,25,0,0,0,-25,-24.75,0,0,-25,-24.75,0,321.50733333333335,25,24.75,0.99,321.50733333333335,0,0
264,1.99,0.01,1,0.99,0.98,24.75,24.75,1.99,25.99,25.99,-0.01,-24.01,-24.01,25,25,26,26,0.01,-24,-24,625,625,50,24,24.01,0,625,24,24.01,0,26.176,1,0.99,0.99,1.1759999999999984,25,25
265,1.01,0.99,4,0.04,0.0,0.5,0.0,2.02,25.02,0.02,-1.98,-24.98,0.02,50,0,27,2,1.98,-23,2,625,0,25,23,24.98,25,0,-2,-0.02,-25,25.032666666666668,2,0.02,0.01,0.03266666666666751,25,0
266,1.99,0.01,1,0.99,0.98,24.75,0.0,1.99,25.99,0.99,-0.01,-24.01,0.99,25,0,26,1,0.01,-24,1,625,0,25,24,24.01,25,0,-1,-0.99,-25,25.994666666666667,1,0.99,0.99,0.9946666666666673,25,0
267,1.01,0.99,625,6.25,0.06,0.0,0.0,25.25,0.25,0.25,-24.75,0.25,0.25,0,0,25,25,24.75,25,25,0,0,0,-25,-0.25,0,0,-25,-0.25,0,3.138,25,0.25,0.01,3.138,0,0
268,1.01,0.99,1,0.01,0.0,0.24,0.25,1.01,24.01,25.01,-0.99,-23.99,-24.99,24,25,25,26,0.99,-23,-24,576,600,49,23,23.99,-1,625,24,24.99,1,48.728,1,0.01,0.01,24.728,24,25
269,1.99,0.01,4,3.96,3.92,0.0,0.0,3.98,1.98,1.98,-0.02,1.98,1.98,0,0,2,2,0.02,2,2,0,0,0,-2,-1.98,0,0,-2,-1.98,0,2.966,2,1.98,0.99,2.966,0,0
270,1.83,0.17,625,517.5,428.49,517.5,248.4,45.7,45.7,32.7,-4.3,-4.3,8.7,625,300,50,37,4.3,0,13,625,300,37,0,4.3,13,144,-13,-8.7,-13,346.1206666666667,25,20.7,0.827999775353927,321.1206666666667,25,12
271,1.99,0.01,625,618.75,612.56,0.0,618.75,49.75,24.75,49.75,-0.25,24.75,-0.25,0,625,25,50,0.25,25,0,0,0,25,-25,-24.75,-25,625,0,0.25,25,328.07533333333333,25,24.75,0.99,328.07533333333333,0,25
272,1.99,0.01,1,0.99,0.98,0.0,0.0,1.99,0.99,0.99,-0.01,0.99,0.99,0,0,1,1,0.01,1,1,0,0,0,-1,-0.99,0,0,-1,-0.99,0,0.9846666666666667,1,0.99,0.99,0.9846666666666667,0,0
273,1.01,0.99,625,6.25,0.06,0.0,0.0,25.25,0.25,0.25,-24.75,0.25,0.25,0,0,25,25,24.75,25,25,0,0,0,-25,-0.25,0,0,-25,-0.25,0,3.3893333333333335,25,0.25,0.01,3.3893333333333335,0,0
274,1.99,0.01,625,618.75,612.56,0.0,321.75,49.75,24.75,37.75,-0.25,24.75,11.75,0,325,25,38,0.25,25,12,0,0,13,-25,-24.75,-13,169,-12,-11.75,13,325.0013333333333,25,24.75,0.99,325.0013333333333,0,13
275,1.99,0.01,625,618.75,612.56,0.0,618.75,49.75,24.75,49.75,-0.25,24.75,-0.25,0,625,25,50,0.25,25,0,0,0,25,-25,-24.75,-25,625,0,0.25,25,327.888,25,24.75,0.99,327.888,0,25
276,1.01,0.99,169,1.69,0.02,3.25,3.25,13.13,25.13,25.13,-12.87,-24.87,-24.87,325,325,38,38,12.87,-12,-12,625,625,50,12,24.87,0,625,12,24.87,0,348.01,13,0.13,0.01000000168537027,323.01,25,25
277,1.99,0.01,625,618.75,612.56,618.75,321.75,49.75,49.75,37.75,-0.25,-0.25,11.75,625,325,50,38,0.25,0,12,625,325,38,0,0.25,12,169,-12,-11.75,-12,349.998,25,24.75,0.99,324.998,25,13
278,1.99,0.01,169,167.31,165.64,0.0,321.75,25.87,12.87,37.87,-0.13,12.87,-12.13,0,325,13,38,0.13,13,-12,0,0,25,-13,-12.87,-25,625,12,12.13,25,93.40666666666667,13,12.87,0.99,93.40666666666667,0,25
279,1.99,0.01,225,222.75,220.52,0.0,371.25,29.85,14.85,39.85,-0.15,14.85,-10.15,0,375,15,40,0.15,15,-10,0,0,25,-15,-14.85,-25,625,10,10.15,25,122.576,15,14.85,0.99,122.576,0,25
280,1.99,0.01,1,0.99,0.98,0.0,0.99,1.99,0.99,1.99,-0.01,0.99,-0.01,0,1,1,2,0.01,1,0,0,0,1,-1,-0.99,-1,1,0,0.01,1,1.0,1,0.99,0.99,1.0,0,1
281,1.99,0.01,625,618.75,612.56,618.75,0.0,49.75,49.75,24.75,-0.25,-0.25,24.75,625,0,50,25,0.25,0,25,625,0,25,0,0.25,25,0,-25,-24.75,-25,346.75733333333335,25,24.75,0.99,321.75733333333335,25,0
282,1.99,0.01,1,0.99,0.98,0.0,0.0,1.99,0.99,0.99,-0.01,0.99,0.99,0,0,1,1,0.01,1,1,0,0,0,-1,-0.99,0,0,-1,-0.99,0,0.992,1,0.99,0.99,0.992,0,0
283,1.99,0.01,625,618.75,612.56,0.0,0.0,49.75,24.75,24.75,-0.25,24.75,24.75,0,0,25,25,0.25,25,25,0,0,0,-25,-24.75,0,0,-25,-24.75,0,321.89866666666666,25,24.75,0.99,321.89866666666666,0,0
284,1.01,0.99,1,0.01,0.0,0.0,0.25,1.01,0.01,25.01,-0.99,0.01,-24.99,0,25,1,26,0.99,1,-24,0,0,25,-1,-0.01,-25,625,24,24.99,25,24.744,1,0.01,0.01,24.744,0,25
285,1.99,0.01,1,0.99,0.98,0.0,0.99,1.99,0.99,1.99,-0.01,0.99,-0.01,0,1,1,2,0.01,1,0,0,0,1,-1,-0.99,-1,1,0,0.01,1,1.0,1,0.99,0.99,1.0,0,1
286,1.99,0.01,625,618.75,612.56,618.75,0.0,49.75,49.75,24.75,-0.25,-0.25,24.75,625,0,50,25,0.25,0,25,625,0,25,0,0.25,25,0,-25,-24.75,-25,347.122,25,24.75,0.99,322.122,25,0
287,1.01,0.99,144,1.44,0.01,3.0,3.0,12.12,25.12,25.12,-11.88,-24.88,-24.88,300,300,37,37,11.88,-13,-13,625,625,50,13,24.88,0,625,13,24.88,0,322.718,12,0.12,0.01,297.718,25,25
288,1.99,0.01,1,0.99,0.98,0.0,0.0,1.99,0.99,0.99,-0.01,0.99,0.99,0,0,1,1,0.01,1,1,0,0,0,-1,-0.99,0,0,-1,-0.99,0,0.9913333333333333,1,0.99,0.99,0.9913333333333333,0,0
289,1.99,0.01,625,618.75,612.56,0.0,0.0,49.75,24.75,24.75,-0.25,24.75,24.75,0,0,25,25,0.25,25,25,0,0,0,-25,-24.75,0,0,-25,-24.75,0,321.768,25,24.75,0.99,321.768,0,0
290,1.99,0.01,169,167.31,165.64,321.75,321.75,25.87,37.87,37.87,-0.13,-12.13,-12.13,325,325,38,38,0.13,-12,-12,625,625,50,12,12.13,0,625,12,12.13,0,118.42333333333333,13,12.87,0.99,93.42333333333333,25,25
291,1.99,0.01,625,618.75,612.56,0.0,297.0,49.75,24.75,36.75,-0.25,24.75,12.75,0,300,25,37,0.25,25,13,0,0,12,-25,-24.75,-12,144,-13,-12.75,12,324.81333333333333,25,24.75,0.99,324.81333333333333,0,12
292,1.01,0.99,625,6.25,0.06,6.25,6.25,25.25,25.25,25.25,-24.75,-24.75,-24.75,625,625,50,50,24.75,0,0,625,625,50,0,24.75,0,625,0,24.75,0,647.2113333333333,25,0.25,0.01,622.2113333333333,25,25
293,1.99,0.01,169,167.31,165.64,0.0,321.75,25.87,12.87,37.87,-0.13,12.87,-12.13,0,325,13,38,0.13,13,-12,0,0,25,-13,-12.87,-25,625,12,12.13,25,93.29933333333334,13,12.87,0.99,93.29933333333334,0,25
294,1.99,0.01,625,618.75,612.56,0.0,618.75,49.75,24.75,49.75,-0.25,24.75,-0.25,0,625,25,50,0.25,25,0,0,0,25,-25,-24.75,-25,625,0,0.25,25,328.0106666666667,25,24.75,0.99,328.0106666666667,0,25
295,1.01,0.99,1,0.01,0.0,0.24,0.25,1.01,24.01,25.01,-0.99,-23.99,-24.99,24,25,25,26,0.99,-23,-24,576,600,49,23,23.99,-1,625,24,24.99,1,48.792,1,0.01,0.01,24.792,24,25
296,1.99,0.01,4,3.96,3.92,0.0,0.0,3.98,1.98,1.98,-0.02,1.98,1.98,0,0,2,2,0.02,2,2,0,0,0,-2,-1.98,0,0,-2,-1.98,0,2.966666666666667,2,1.98,0.99,2.966666666666667,0,0
297,1.99,0.01,1,0.99,0.98,0.0,0.0,1.99,0.99,0.99,-0.01,0.99,0.99,0,0,1,1,0.01,1,1,0,0,0,-1,-0.99,0,0,-1,-0.99,0,0.988,1,0.99,0.99,0.988,0,0
298,1.01,0.99,169,1.69,0.02,0.0,0.0,13.13,0.13,0.13,-12.87,0.13,0.13,0,0,13,13,12.87,13,13,0,0,0,-13,-0.13,0,0,-13,-0.13,0,0.878,13,0.13,0.01,0.878,0,0
299,1.99,0.01,1,0.99,0.98,0.0,24.75,1.99,0.99,25.99,-0.01,0.99,-24.01,0,25,1,26,0.01,1,-24,0,0,25,-1,-0.99,-25,625,24,24.01,25,1.176,1,0.99,0.99,1.176,0,25
300,1.01,0.99,1,0.01,0.0,0.0,0.0,1.01,0.01,0.01,-0.99,0.01,0.01,0,0,1,1,0.99,1,1,0,0,0,-1,-0.01,0,0,-1,-0.01,0,0.008,1,0.01,0.01,0.008,0,0
301,1.09,0.91,625,57.4,5.27,0.0,57.4,27.3,2.3,27.3,-22.7,2.3,-22.7,0,625,25,50,22.7,25,0,0,0,25,-25,-2.3,-25,625,0,22.7,25,597.2773333333333,25,2.3,0.09183458033420318,597.2773333333333,0,25
302,1.99,0.01,1,0.99,0.98,0.0,0.0,1.99,0.99,0.99,-0.01,0.99,0.99,0,0,1,1,0.01,1,1,0,0,0,-1,-0.99,0,0,-1,-0.99,0,0.9906666666666667,1,0.99,0.99,0.9906666666666667,0,0
303,1.99,0.01,625,618.75,612.56,0.0,0.0,49.75,24.75,24.75,-0.25,24.75,24.75,0,0,25,25,0.25,25,25,0,0,0,-25,-24.75,0,0,-25,-24.75,0,321.50733333333335,25,24.75,0.99,321.50733333333335,0,0
304,1.99,0.01,1,0.99,0.98,24.75,24.75,1.99,25.99,25.99,-0.01,-24.01,-24.01,25,25,26,26,0.01,-24,-24,625,625,50,24,24.01,0,625,24,24.01,0,26.176,1,0.99,0.99,1.1759999999999984,25,25
305,1.01,0.99,4,0.04,0.0,0.5,0.0,2.02,25.02,0.02,-1.98,-24.98,0.02,50,0,27,2,1.98,-23,2,625,0,25,23,24.98,25,0,-2,-0.02,-25,25.032666666666668,2,0.02,0.01,0.03266666666666751,25,0
306,1.99,0.01,1,0.99,0.98,24.75,0.0,1.99,25.99,0.99,-0.01,-24.01,0.99,25,0,26,1,0.01,-24,1,625,0,25,24,24.01,25,0,-1,-0.99,-25,25.994666666666667,1,0.99,0.99,0.9946666666666673,25,0
307,1.01,0.99,625,6.25,0.06,0.0,0.0,25.25,0.25,0.25,-24.75,0.25,0.25,0,0,25,25,24.75,25,25,0,0,0,-25,-0.25,0,0,-25,-0.25,0,3.138,25,0.25,0.01,3.138,0,0
308,1.01,0.99,1,0.01,0.0,0.24,0.25,1.01,24.01,25.01,-0.99,-23.99,-24.99,24,25,25,26,0.99,-23,-24,576,600,49,23,23.99,-1,625,24,24.99,1,48.728,1,0.01,0.01,24.728,24,25
309,1.99,0.01,4,3.96,3.92,0.0,0.0,3.98,1.98,1.98,-0.02,1.98,1.98,0,0,2,2,0.02,2,2,0,0,0,-2,-1.98,0,0,-2,-1.98,0,2.966,2,1.98,0.99,2.966,0,0
310,1.83,0.17,625,517.5,428.49,517.5,248.4,45.7,45.7,32.7,-4.3,-4.3,8.7,625,300,50,37,4.3,0,13,625,300,37,0,4.3,13,144,-13,-8.7,-13,346.1206666666667,25,20.7,0.827999775353927,321.1206666666667,25,12
311,1.99,0.01,625,618.75,612.56,0.0,618.75,49.75,24.75,49.75,-0.25,24.75,-0.25,0,625,25,50,0.25,25,0,0,0,25,-25,-24.75,-25,625,0,0.25,25,328.07533333333333,25,24.75,0.99,328.07533333333333,0,25
312,1.99,0.01,1,0.99,0.98,0.0,0.0,1.99,0.99,0.99,-0.01,0.99,0.99,0,0,1,1,0.01,1,1,0,0,0,-1,-0.99,0,0,-1,-0.99,0,0.9846666666666667,1,0.99,0.99,0.9846666666666667,0,0
313,1.01,0.99,625,6.25,0.06,0.0,0.0,25.25,0.25,0.25,-24.75,0.25,0.25,0,0,25,25,24.75,25,25,0,0,0,-25,-0.25,0,0,-25,-0.25,0,3.3893333333333335,25,0.25,0.01,3.3893333333333335,0,0
314,1.99,0.01,625,618.75,612.56,0.0,321.75,49.75,24.75,37.75,-0.25,24.75,11.75,0,325,25,38,0.25,25,12,0,0,13,-25,-24.75,-13,169,-12,-11.75,13,325.0013333333333,25,24.75,0.99,325.0013333333333,0,13
315,1.99,0.01,625,618.75,612.56,0.0,618.75,49.75,24.75,49.75,-0.25,24.75,-0.25,0,625,25,50,0.25,25,0,0,0,25,-25,-24.75,-25,625,0,0.25,25,327.888,25,24.75,0.99,327.888,0,25
316,1.01,0.99,169,1.69,0.02,3.25,3.25,13.13,25.13,25.13,-12.87,-24.87,-24.87,325,325,38,38,12.87,-12,-12,625,625,50,12,24.87,0,625,12,24.87,0,348.01,13,0.13,0.01000000168537027,323.01,25,25
317,1.99,0.01,625,618.75,612.56,618.75,321.75,49.75,49.75,37.75,-0.25,-0.25,11.75,625,325,50,38,0.25,0,12,625,325,38,0,0.25,12,169,-12,-11.75,-12,349.998,25,24.75,0.99,324.998,25,13
318,1.99,0.01,169,167.31,165.64,0.0,321.75,25.87,12.87,37.87,-0.13,12.87,-12.13,0,325,13,38,0.13,13,-12,0,0,25,-13,-12.87,-25,625,12,12.13,25,93.40666666666667,13,12.87,0.99,93.40666666666667,0,25
319,1.99,0.01,225,222.75,220.52,0.0,371.25,29.85,14.85,39.85,-0.15,14.85,-10.15,0,375,15,40,0.15,15,-10,0,0,25,-15,-14.85,-25,625,10,10.15,25,122.576,15,14.85,0.99,122.576,0,25
320,1.99,0.01,1,0.99,0.98,0.0,0.99,1.99,0.99,1.99,-0.01,0.99,-0.01,0,1,1,2,0.01,1,0,0,0,1,-1,-0.99,-1,1,0,0.01,1,1.0,1,0.99,0.99,1.0,0,1
321,1.99,0.01,625,618.75,612.56,618.75,0.0,49.75,49.75,24.75,-0.25,-0.25,24.75,625,0,50,25,0.25,0,25,625,0,25,0,0.25,25,0,-25,-24.75,-25,346.75733333333335,25,24.75,0.99,321.75733333333335,25,0
322,1.99,0.01,1,0.99,0.98,0.0,0.0,1.99,0.99,0.99,-0.01,0.99,0.99,0,0,1,1,0.01,1,1,0,0,0,-1,-0.99,0,0,-1,-0.99,0,0.992,1,0.99,0.99,0.992,0,0
323,1.99,0.01,625,618.75,612.56,0.0,0.0,49.75,24.75,24.75,-0.25,24.75,24.75,0,0,25,25,0.25,25,25,0,0,0,-25,-24.75,0,0,-25,-24.75,0,321.89866666666666,25,24.75,0.99,321.89866666666666,0,0
324,1.01,0.99,1,0.01,0.0,0.0,0.25,1.01,0.01,25.01,-0.99,0.01,-24.99,0,25,1,26,0.99,1,-24,0,0,25,-1,-0.01,-25,625,24,24.99,25,24.744,1,0.01,0.01,24.744,0,25
325,1.99,0.01,1,0.99,0.98,0.0,0.99,1.99,0.99,1.99,-0.01,0.99,-0.01,0,1,1,2,0.01,1,0,0,0,1,-1,-0.99,-1,1,0,0.01,1,1.0,1,0.99,0.99,1.0,0,1
326,1.99,0.01,625,618.75,612.56,618.75,0.0,49.75,49.75,24.75,-0.25,-0.25,24.75,625,0,50,25,0.25,0,25,625,0,25,0,0.25,25,0,-25,-24.75,-25,347.122,25,24.75,0.99,322.122,25,0
327,1.01,0.99,144,1.44,0.01,3.0,3.0,12.12,25.12,25.12,-11.88,-24.88,-24.88,300,300,37,37,11.88,-13,-13,625,625,50,13,24.88,0,625,13,24.88,0,322.718,12,0.12,0.01,297.718,25,25
328,1.99,0.01,1,0.99,0.98,0.0,0.0,1.99,0.99,0.99,-0.01,0.99,0.99,0,0,1,1,0.01,1,1,0,0,0,-1,-0.99,0,0,-1,-0.99,0,0.9913333333333333,1,0.99,0.99,0.9913333333333333,0,0
329,1.99,0.01,625,618.75,612.56,0.0,0.0,49.75,24.75,24.75,-0.25,24.75,24.75,0,0,25,25,0.25,25,25,0,0,0,-25,-24.75,0,0,-25,-24.75,0,321.768,25,24.75,0.99,321.768,0,0
330,1.99,0.01,169,167.31,165.64,321.75,321.75,25.87,37.87,37.87,-0.13,-12.13,-12.13,325,325,38,38,0.13,-12,-12,625,625,50,12,12.13,0,625,12,12.13,0,118.42333333333333,13,12.87,0.99,93.42333333333333,25,25
331,1.99,0.01,625,618.75,612.56,0.0,297.0,49.75,24.75,36.75,-0.25,24.75,12.75,0,300,25,37,0.25,25,13,0,0,12,-25,-24.75,-12,144,-13,-12.75,12,324.81333333333333,25,24.75,0.99,324.81333333333333,0,12
332,1.01,0.99,625,6.25,0.06,6.25,6.25,25.25,25.25,25.25,-24.75,-24.75,-24.75,625,625,50,50,24.75,0,0,625,625,50,0,24.75,0,625,0,24.75,0,647.2113333333333,25,0.25,0.01,622.2113333333333,25,25
333,1.99,0.01,169,167.31,165.64,0.0,321.75,25.87,12.87,37.87,-0.13,12.87,-12.13,0,325,13,38,0.13,13,-12,0,0,25,-13,-12.87,-25,625,12,12.13,25,93.29933333333334,13,12.87,0.99,93.29933333333334,0,25
334,1.99,0.01,625,618.75,612.56,0.0,618.75,49.75,24.75,49.75,-0.25,24.75,-0.25,0,625,25,50,0.25,25,0,0,0,25,-25,-24.75,-25,625,0,0.25,25,328.0106666666667,25,24.75,0.99,328.0106666666667,0,25
335,1.01,0.99,1,0.01,0.0,0.24,0.25,1.01,24.01,25.01,-0.99,-23.99,-24.99,24,25,25,26,0.99,-23,-24,576,600,49,23,23.99,-1,625,24,24.99,1,48.792,1,0.01,0.01,24.792,24,25
336,1.99,0.01,4,3.96,3.92,0.0,0.0,3.98,1.98,1.98,-0.02,1.98,1.98,0,0,2,2,0.02,2,2,0,0,0,-2,-1.98,0,0,-2,-1.98,0,2.966666666666667,2,1.98,0.99,2.966666666666667,0,0
337,1.99,0.01,1,0.99,0.98,0.0,0.0,1.99,0.99,0.99,-0.01,0.99,0.99,0,0,1,1,0.01,1,1,0,0,0,-1,-0.99,0,0,-1,-0.99,0,0.988,1,0.99,0.99,0.988,0,0
338,1.01,0.99,169,1.69,0.02,0.0,0.0,13.13,0.13,0.13,-12.87,0.13,0.13,0,0,13,13,12.87,13,13,0,0,0,-13,-0.13,0,0,-13,-0.13,0,0.878,13,0.13,0.01,0.878,0,0
339,1.99,0.01,1,0.99,0.98,0.0,24.75,1.99,0.99,25.99,-0.01,0.99,-24.01,0,25,1,26,0.01,1,-24,0,0,25,-1,-0.99,-25,625,24,24.01,25,1.176,1,0.99,0.99,1.176,0,25
340,1.01,0.99,1,0.01,0.0,0.0,0.0,1.01,0.01,0.01,-0.99,0.01,0.01,0,0,1,1,0.99,1,1,0,0,0,-1,-0.01,0,0,-1,-0.01,0,0.008,1,0.01,0.01,0.008,0,0
341,1.09,0.91,625,57.4,5.27,0.0,57.4,27.3,2.3,27.3,-22.7,2.3,-22.7,0,625,25,50,22.7,25,0,0,0,25,-25,-2.3,-25,625,0,22.7,25,597.2773333333333,25,2.3,0.09183458033420318,597.2773333333333,0,25
342,1.99,0.01,1,0.99,0.98,0.0,0.0,1.99,0.99,0.99,-0.01,0.99,0.99,0,0,1,1,0.01,1,1,0,0,0,-1,-0.99,0,0,-1,-0.99,0,0.9906666666666667,1,0.99,0.99,0.9906666666666667,0,0
343,1.99,0.01,625,618.75,612.56,0.0,0.0,49.75,24.75,24.75,-0.25,24.75,24.75,0,0,25,25,0.25,25,25,0,0,0,-25,-24.75,0,0,-25,-24.75,0,321.50733333333335,25,24.75,0.99,321.50733333333335,0,0
344,1.99,0.01,1,0.99,0.98,24.75,24.75,1.99,25.99,25.99,-0.01,-24.01,-24.01,25,25,26,26,0.01,-24,-24,625,625,50,24,24.01,0,625,24,24.01,0,26.176,1,0.99,0.99,1.1759999999999984,25,25
345,1.01,0.99,4,0.04,0.0,0.5,0.0,2.02,25.02,0.02,-1.98,-24.98,0.02,50,0,27,2,1.98,-23,2,625,0,25,23,24.98,25,0,-2,-0.02,-25,25.032666666666668,2,0.02,0.01,0.03266666666666751,25,0
346,1.99,0.01,1,0.99,0.98,24.75,0.0,1.99,25.99,0.99,-0.01,-24.01,0.99,25,0,26,1,0.01,-24,1,625,0,25,24,24.01,25,0,-1,-0.99,-25,25.994666666666667,1,0.99,0.99,0.9946666666666673,25,0
347,1.01,0.99,625,6.25,0.06,0.0,0.0,25.25,0.25,0.25,-24.75,0.25,0.25,0,0,25,25,24.75,25,25,0,0,0,-25,-0.25,0,0,-25,-0.25,0,3.138,25,0.25,0.01,3.138,0,0
348,1.01,0.99,1,0.01,0.0,0.24,0.25,1.01,24.01,25.01,-0.99,-23.99,-24.99,24,25,25,26,0.99,-23,-24,576,600,49,23,23.99,-1,625,24,24.99,1,48.728,1,0.01,0.01,24.728,24,25
349,1.99,0.01,4,3.96,3.92,0.0,0.0,3.98,1.98,1.98,-0.02,1.98,1.98,0,0,2,2,0.02,2,2,0,0,0,-2,-1.98,0,0,-2,-1.98,0,2.966,2,1.98,0.99,2.966,0,0
350,1.83,0.17,625,517.5,428.49,517.5,248.4,45.7,45.7,32.7,-4.3,-4.3,8.7,625,300,50,37,4.3,0,13,625,300,37,0,4.3,13,144,-13,-8.7,-13,346.1206666666667,25,20.7,0.827999775353927,321.1206666666667,25,12
351,1.99,0.01,625,618.75,612.56,0.0,618.75,49.75,24.75,49.75,-0.25,24.75,-0.25,0,625,25,50,0.25,25,0,0,0,25,-25,-24.75,-25,625,0,0.25,25,328.07533333333333,25,24.75,0.99,328.07533333333333,0,25
352,1.99,0.01,1,0.99,0.98,0.0,0.0,1.99,0.99,0.99,-0.01,0.99,0.99,0,0,1,1,0.01,1,1,0,0,0,-1,-0.99,0,0,-1,-0.99,0,0.9846666666666667,1,0.99,0.99,0.9846666666666667,0,0
353,1.01,0.99,625,6.25,0.06,0.0,0.0,25.25,0.25,0.25,-24.75,0.25,0.25,0,0,25,25,24.75,25,25,0,0,0,-25,-0.25,0,0,-25,-0.25,0,3.3893333333333335,25,0.25,0.01,3.3893333333333335,0,0
354,1.99,0.01,625,618.75,612.56,0.0,321.75,49.75,24.75,37.75,-0.25,24.75,11.75,0,325,25,38,0.25,25,12,0,0,13,-25,-24.75,-13,169,-12,-11.75,13,325.0013333333333,25,24.75,0.99,325.0013333333333,0,13
355,1.99,0.01,625,618.75,612.56,0.0,618.75,49.75,24.75,49.75,-0.25,24.75,-0.25,0,625,25,50,0.25,25,0,0,0,25,-25,-24.75,-25,625,0,0.25,25,327.888,25,24.75,0.99,327.888,0,25
356,1.01,0.99,169,1.69,0.02,3.25,3.25,13.13,25.13,25.13,-12.87,-24.87,-24.87,325,325,38,38,12.87,-12,-12,625,625,50,12,24.87,0,625,12,24.87,0,348.01,13,0.13,0.01000000168537027,323.01,25,25
357,1.99,0.01,625,618.75,612.56,618.75,321.75,49.75,49.75,37.75,-0.25,-0.25,11.75,625,325,50,38,0.25,0,12,625,325,38,0,0.25,12,169,-12,-11.75,-12,349.998,25,24.75,0.99,324.998,25,13
358,1.99,0.01,169,167.31,165.64,0.0,321.75,25.87,12.87,37.87,-0.13,12.87,-12.13,0,325,13,38,0.13,13,-12,0,0,25,-13,-12.87,-25,625,12,12.13,25,93.40666666666667,13,12.87,0.99,93.40666666666667,0,25
359,1.99,0.01,225,222.75,220.52,0.0,371.25,29.85,14.85,39.85,-0.15,14.85,-10.15,0,375,15,40,0.15,15,-10,0,0,25,-15,-14.85,-25,625,10,10.15,25,122.576,15,14.85,0.99,122.576,0,25
360,1.99,0.01,1,0.99,0.98,0.0,0.99,1.99,0.99,1.99,-0.01,0.99,-0.01,0,1,1,2,0.01,1,0,0,0,1,-1,-0.99,-1,1,0,0.01,1,1.0,1,0.99,0.99,1.0,0,1
361,1.99,0.01,625,618.75,612.56,618.75,0.0,49.75,49.75,24.75,-0.25,-0.25,24.75,625,0,50,25,0.25,0,25,625,0,25,0,0.25,25,0,-25,-24.75,-25,346.75733333333335,25,24.75,0.99,321.75733333333335,25,0
362,1.99,0.01,1,0.99,0.98,0.0,0.0,1.99,0.99,0.99,-0.01,0.99,0.99,0,0,1,1,0.01,1,1,0,0,0,-1,-0.99,0,0,-1,-0.99,0,0.992,1,0.99,0.99,0.992,0,0
363,1.99,0.01,625,618.75,612.56,0.0,0.0,49.75,24.75,24.75,-0.25,24.75,24.75,0,0,25,25,0.25,25,25,0,0,0,-25,-24.75,0,0,-25,-24.75,0,321.89866666666666,25,24.75,0.99,321.89866666666666,0,0
364,1.01,0.99,1,0.01,0.0,0.0,0.25,1.01,0.01,25.01,-0.99,0.01,-24.99,0,25,1,26,0.99,1,-24,0,0,25,-1,-0.01,-25,625,24,24.99,25,24.744,1,0.01,0.01,24.744,0,25
365,1.99,0.01,1,0.99,0.98,0.0,0.99,1.99,0.99,1.99,-0.01,0.99,-0.01,0,1,1,2,0.01,1,0,0,0,1,-1,-0.99,-1,1,0,0.01,1,1.0,1,0.99,0.99,1.0,0,1
366,1.99,0.01,625,618.75,612.56,618.75,0.0,49.75,49.75,24.75,-0.25,-0.25,24.75,625,0,50,25,0.25,0,25,625,0,25,0,0.25,25,0,-25,-24.75,-25,347.122,25,24.75,0.99,322.122,25,0
367,1.01,0.99,144,1.44,0.01,3.0,3.0,12.12,25.12,25.12,-11.88,-24.88,-24.88,300,300,37,37,11.88,-13,-13,625,625,50,13,24.88,0,625,13,24.88,0,322.718,12,0.12,0.01,297.718,25,25
368,1.99,0.01,1,0.99,0.98,0.0,0.0,1.99,0.99,0.99,-0.01,0.99,0.99,0,0,1,1,0.01,1,1,0,0,0,-1,-0.99,0,0,-1,-0.99,0,0.9913333333333333,1,0.99,0.99,0.9913333333333333,0,0
369,1.99,0.01,625,618.75,612.56,0.0,0.0,49.75,24.75,24.75,-0.25,24.75,24.75,0,0,25,25,0.25,25,25,0,0,0,-25,-24.75,0,0,-25,-24.75,0,321.768,25,24.75,0.99,321.768,0,0
370,1.99,0.01,169,167.31,165.64,321.75,321.75,25.87,37.87,37.87,-0.13,-12.13,-12.13,325,325,38,38,0.13,-12,-12,625,625,50,12,12.13,0,625,12,12.13,0,118.42333333333333,13,12.87,0.99,93.42333333333333,25,25
371,1.99,0.01,625,618.75,612.56,0.0,297.0,49.75,24.75,36.75,-0.25,24.75,12.75,0,300,25,37,0.25,25,13,0,0,12,-25,-24.75,-12,144,-13,-12.75,12,324.81333333333333,25,24.75,0.99,324.81333333333333,0,12
372,1.01,0.99,625,6.25,0.06,6.25,6.25,25.25,25.25,25.25,-24.75,-24.75,-24.75,625,625,50,50,24.75,0,0,625,625,50,0,24.75,0,625,0,24.75,0,647.2113333333333,25,0.25,0.01,622.2113333333333,25,25
373,1.99,0.01,169,167.31,165.64,0.0,321.75,25.87,12.87,37.87,-0.13,12.87,-12.13,0,325,13,38,0.13,13,-12,0,0,25,-13,-12.87,-25,625,12,12.13,25,93.29933333333334,13,12.87,0.99,93.29933333333334,0,25
374,1.99,0.01,625,618.75,612.56,0.0,618.75,49.75,24.75,49.75,-0.25,24.75,-0.25,0,625,25,50,0.25,25,0,0,0,25,-25,-24.75,-25,625,0,0.25,25,328.0106666666667,25,24.75,0.99,328.0106666666667,0,25
375,1.01,0.99,1,0.01,0.0,0.24,0.25,1.01,24.01,25.01,-0.99,-23.99,-24.99,24,25,25,26,0.99,-23,-24,576,600,49,23,23.99,-1,625,24,24.99,1,48.792,1,0.01,0.01,24.792,24,25
376,1.99,0.01,4,3.96,3.92,0.0,0.0,3.98,1.98,1.98,-0.02,1.98,1.98,0,0,2,2,0.02,2,2,0,0,0,-2,-1.98,0,0,-2,-1.98,0,2.966666666666667,2,1.98,0.99,2.966666666666667,0,0
377,1.99,0.01,1,0.99,0.98,0.0,0.0,1.99,0.99,0.99,-0.01,0.99,0.99,0,0,1,1,0.01,1,1,0,0,0,-1,-0.99,0,0,-1,-0.99,0,0.988,1,0.99,0.99,0.988,0,0
378,1.01,0.99,169,1.69,0.02,0.0,0.0,13.13,0.13,0.13,-12.87,0.13,0.13,0,0,13,13,12.87,13,13,0,0,0,-13,-0.13,0,0,-13,-0.13,0,0.878,13,0.13,0.01,0.878,0,0
379,1.99,0.01,1,0.99,0.98,0.0,24.75,1.99,0.99,25.99,-0.01,0.99,-24.01,0,25,1,26,0.01,1,-24,0,0,25,-1,-0.99,-25,625,24,24.01,25,1.176,1,0.99,0.99,1.176,0,25
380,1.01,0.99,1,0.01,0.0,0.0,0.0,1.01,0.01,0.01,-0.99,0.01,0.01,0,0,1,1,0.99,1,1,0,0,0,-1,-0.01,0,0,-1,-0.01,0,0.008,1,0.01,0.01,0.008,0,0
381,1.09,0.91,625,57.4,5.27,0.0,57.4,27.3,2.3,27.3,-22.7,2.3,-22.7,0,625,25,50,22.7,25,0,0,0,25,-25,-2.3,-25,625,0,22.7,25,597.2773333333333,25,2.3,0.09183458033420318,597.2773333333333,0,25
382,1.99,0.01,1,0.99,0.98,0.0,0.0,1.99,0.99,0.99,-0.01,0.99,0.99,0,0,1,1,0.01,1,1,0,0,0,-1,-0.99,0,0,-1,-0.99,0,0.9906666666666667,1,0.99,0.99,0.9906666666666667,0,0
383,1.99,0.01,625,618.75,612.56,0.0,0.0,49.75,24.75,24.75,-0.25,24.75,24.75,0,0,25,25,0.25,25,25,0,0,0,-25,-24.75,0,0,-25,-24.75,0,321.50733333333335,25,24.75,0.99,321.50733333333335,0,0
384,1.99,0.01,1,0.99,0.98,24.75,24.75,1.99,25.99,25.99,-0.01,-24.01,-24.01,25,25,26,26,0.01,-24,-24,625,625,50,24,24.01,0,625,24,24.01,0,26.176,1,0.99,0.99,1.1759999999999984,25,25
385,1.01,0.99,4,0.04,0.0,0.5,0.0,2.02,25.02,0.02,-1.98,-24.98,0.02,50,0,27,2,1.98,-23,2,625,0,25,23,24.98,25,0,-2,-0.02,-25,25.032666666666668,2,0.02,0.01,0.03266666666666751,25,0
386,1.99,0.01,1,0.99,0.98,24.75,0.0,1.99,25.99,0.99,-0.01,-24.01,0.99,25,0,26,1,0.01,-24,1,625,0,25,24,24.01,25,0,-1,-0.99,-25,25.994666666666667,1,0.99,0.99,0.9946666666666673,25,0
387,1.01,0.99,625,6.25,0.06,0.0,0.0,25.25,0.25,0.25,-24.75,0.25,0.25,0,0,25,25,24.75,25,25,0,0,0,-25,-0.25,0,0,-25,-0.25,0,3.138,25,0.25,0.01,3.138,0,0
388,1.01,0.99,1,0.01,0.0,0.24,0.25,1.01,24.01,25.01,-0.99,-23.99,-24.99,24,25,25,26,0.99,-23,-24,576,600,49,23,23.99,-1,625,24,24.99,1,48.728,1,0.01,0.01,24.728,24,25
389,1.99,0.01,4,3.96,3.92,0.0,0.0,3.98,1.98,1.98,-0.02,1.98,1.98,0,0,2,2,0.02,2,2,0,0,0,-2,-1.98,0,0,-2,-1.98,0,2.966,2,1.98,0.99,2.966,0,0
390,1.83,0.17,625,517.5,428.49,517.5,248.4,45.7,45.7,32.7,-4.3,-4.3,8.7,625,300,50,37,4.3,0,13,625,300,37,0,4.3,13,144,-13,-8.7,-13,346.1206666666667,25,20.7,0.827999775353927,321.1206666666667,25,12
391,1.99,0.01,625,618.75,612.56,0.0,618.75,49.75,24.75,49.75,-0.25,24.75,-0.25,0,625,25,50,0.25,25,0,0,0,25,-25,-24.75,-25,625,0,0.25,25,328.07533333333333,25,24.75,0.99,328.07533333333333,0,25
392,1.99,0.01,1,0.99,0.98,0.0,0.0,1.99,0.99,0.99,-0.01,0.99,0.99,0,0,1,1,0.01,1,1,0,0,0,-1,-0.99,0,0,-1,-0.99,0,0.9846666666666667,1,0.99,0.99,0.9846666666666667,0,0
393,1.01,0.99,625,6.25,0.06,0.0,0.0,25.25,0.25,0.25,-24.75,0.25,0.25,0,0,25,25,24.75,25,25,0,0,0,-25,-0.25,0,0,-25,-0.25,0,3.3893333333333335,25,0.25,0.01,3.3893333333333335,0,0
394,1.99,0.01,625,618.75,612.56,0.0,321.75,49.75,24.75,37.75,-0.25,24.75,11.75,0,325,25,38,0.25,25,12,0,0,13,-25,-24.75,-13,169,-12,-11.75,13,325.0013333333333,25,24.75,0.99,325.0013333333333,0,13
395,1.99,0.01,625,618.75,612.56,0.0,618.75,49.75,24.75,49.75,-0.25,24.75,-0.25,0,625,25,50,0.25,25,0,0,0,25,-25,-24.75,-25,625,0,0.25,25,327.888,25,24.75,0.99,327.888,0,25
396,1.01,0.99,169,1.69,0.02,3.25,3.25,13.13,25.13,25.13,-12.87,-24.87,-24.87,325,325,38,38,12.87,-12,-12,625,625,50,12,24.87,0,625,12,24.87,0,348.01,13,0.13,0.01000000168537027,323.01,25,25
397,1.99,0.01,625,618.75,612.56,618.75,321.75,49.75,49.75,37.75,-0.25,-0.25,11.75,625,325,50,38,0.25,0,12,625,325,38,0,0.25,12,169,-12,-11.75,-12,349.998,25,24.75,0.99,324.998,25,13
398,1.99,0.01,169,167.31,165.64,0.0,321.75,25.87,12.87,37.87,-0.13,12.87,-12.13,0,325,13,38,0.13,13,-12,0,0,25,-13,-12.87,-25,625,12,12.13,25,93.40666666666667,13,12.87,0.99,93.40666666666667,0,25
399,1.99,0.01,225,222.75,220.52,0.0,371.25,29.85,14.85,39.85,-0.15,14.85,-10.15,0,375,15,40,0.15,15,-10,0,0,25,-15,-14.85,-25,625,10,10.15,25,122.576,15,14.85,0.99,122.576,0,25
400,1.99,0.01,1,0.99,0.98,0.0,0.99,1.99,0.99,1.99,-0.01,0.99,-0.01,0,1,1,2,0.01,1,0,0,0,1,-1,-0.99,-1,1,0,0.01,1,1.0,1,0.99,0.99,1.0,0,1
401,1.99,0.01,625,618.75,612.56,618.75,0.0,49.75,49.75,24.75,-0.25,-0.25,24.75,625,0,50,25,0.25,0,25,625,0,25,0,0.25,25,0,-25,-24.75,-25,346.75733333333335,25,24.75,0.99,321.75733333333335,25,0
402,1.99,0.01,1,0.99,0.98,0.0,0.0,1.99,0.99,0.99,-0.01,0.99,0.99,0,0,1,1,0.01,1,1,0,0,0,-1,-0.99,0,0,-1,-0.99,0,0.992,1,0.99,0.99,0.992,0,0
403,1.99,0.01,625,618.75,612.56,0.0,0.0,49.75,24.75,24.75,-0.25,24.75,24.75,0,0,25,25,0.25,25,25,0,0,0,-25,-24.75,0,0,-25,-24.75,0,321.89866666666666,25,24.75,0.99,321.89866666666666,0,0
404,1.01,0.99,1,0.01,0.0,0.0,0.25,1.01,0.01,25.01,-0.99,0.01,-24.99,0,25,1,26,0.99,1,-24,0,0,25,-1,-0.01,-25,625,24,24.99,25,24.744,1,0.01,0.01,24.744,0,25
405,1.99,0.01,1,0.99,0.98,0.0,0.99,1.99,0.99,1.99,-0.01,0.99,-0.01,0,1,1,2,0.01,1,0,0,0,1,-1,-0.99,-1,1,0,0.01,1,1.0,1,0.99,0.99,1.0,0,1
406,1.99,0.01,625,618.75,612.56,618.75,0.0,49.75,49.75,24.75,-0.25,-0.25,24.75,625,0,50,25,0.25,0,25,625,0,25,0,0.25,25,0,-25,-24.75,-25,347.122,25,24.75,0.99,322.122,25,0
407,1.01,0.99,144,1.44,0.01,3.0,3.0,12.12,25.12,25.12,-11.88,-24.88,-24.88,300,300,37,37,11.88,-13,-13,625,625,50,13,24.88,0,625,13,24.88,0,322.718,12,0.12,0.01,297.718,25,25
408,1.99,0.01,1,0.99,0.98,0.0,0.0,1.99,0.99,0.99,-0.01,0.99,0.99,0,0,1,1,0.01,1,1,0,0,0,-1,-0.99,0,0,-1,-0.99,0,0.9913333333333333,1,0.99,0.99,0.9913333333333333,0,0
409,1.99,0.01,625,618.75,612.56,0.0,0.0,49.75,24.75,24.75,-0.25,24.75,24.75,0,0,25,25,0.25,25,25,0,0,0,-25,-24.75,0,0,-25,-24.75,0,321.768,25,24.75,0.99,321.768,0,0
410,1.99,0.01,169,167.31,165.64,321.75,321.75,25.87,37.87,37.87,-0.13,-12.13,-12.13,325,325,38,38,0.13,-12,-12,625,625,50,12,12.13,0,625,12,12.13,0,118.42333333333333,13,12.87,0.99,93.42333333333333,25,25
411,1.99,0.01,625,618.75,612.56,0.0,297.0,49.75,24.75,36.75,-0.25,24.75,12.75,0,300,25,37,0.25,25,13,0,0,12,-25,-24.75,-12,144,-13,-12.75,12,324.81333333333333,25,24.75,0.99,324.81333333333333,0,12
412,1.01,0.99,625,6.25,0.06,6.25,6.25,25.25,25.25,25.25,-24.75,-24.75,-24.75,625,625,50,50,24.75,0,0,625,625,50,0,24.75,0,625,0,24.75,0,647.2113333333333,25,0.25,0.01,622.2113333333333,25,25
413,1.99,0.01,169,167.31,165.64,0.0,321.75,25.87,12.87,37.87,-0.13,12.87,-12.13,0,325,13,38,0.13,13,-12,0,0,25,-13,-12.87,-25,625,12,12.13,25,93.29933333333334,13,12.87,0.99,93.29933333333334,0,25
414,1.99,0.01,625,618.75,612.56,0.0,618.75,49.75,24.75,49.75,-0.25,24.75,-0.25,0,625,25,50,0.25,25,0,0,0,25,-25,-24.75,-25,625,0,0.25,25,328.0106666666667,25,24.75,0.99,328.0106666666667,0,25
415,1.01,0.99,1,0.01,0.0,0.24,0.25,1.01,24.01,25.01,-0.99,-23.99,-24.99,24,25,25,26,0.99,-23,-24,576,600,49,23,23.99,-1,625,24,24.99,1,48.792,1,0.01,0.01,24.792,24,25
416,1.99,0.01,4,3.96,3.92,0.0,0.0,3.98,1.98,1.98,-0.02,1.98,1.98,0,0,2,2,0.02,2,2,0,0,0,-2,-1.98,0,0,-2,-1.98,0,2.966666666666667,2,1.98,0.99,2.966666666666667,0,0
417,1.99,0.01,1,0.99,0.98,0.0,0.0,1.99,0.99,0.99,-0.01,0.99,0.99,0,0,1,1,0.01,1,1,0,0,0,-1,-0.99,0,0,-1,-0.99,0,0.988,1,0.99,0.99,0.988,0,0
418,1.01,0.99,169,1.69,0.02,0.0,0.0,13.13,0.13,0.13,-12.87,0.13,0.13,0,0,13,13,12.87,13,13,0,0,0,-13,-0.13,0,0,-13,-0.13,0,0.878,13,0.13,0.01,0.878,0,0
419,1.99,0.01,1,0.99,0.98,0.0,24.75,1.99,0.99,25.99,-0.01,0.99,-24.01,0,25,1,26,0.01,1,-24,0,0,25,-1,-0.99,-25,625,24,24.01,25,1.176,1,0.99,0.99,1.176,0,25
420,1.01,0.99,1,0.01,0.0,0.0,0.0,1.01,0.01,0.01,-0.99,0.01,0.01,0,0,1,1,0.99,1,1,0,0,0,-1,-0.01,0,0,-1,-0.01,0,0.008,1,0.01,0.01,0.008,0,0
421,1.09,0.91,625,57.4,5.27,0.0,57.4,27.3,2.3,27.3,-22.7,2.3,-22.7,0,625,25,50,22.7,25,0,0,0,25,-25,-2.3,-25,625,0,22.7,25,597.2773333333333,25,2.3,0.09183458033420318,597.2773333333333,0,25
422,1.99,0.01,1,0.99,0.98,0.0,0.0,1.99,0.99,0.99,-0.01,0.99,0.99,0,0,1,1,0.01,1,1,0,0,0,-1,-0.99,0,0,-1,-0.99,0,0.9906666666666667,1,0.99,0.99,0.9906666666666667,0,0
423,1.99,0.01,625,618.75,612.56,0.0,0.0,49.75,24.75,24.75,-0.25,24.75,24.75,0,0,25,25,0.25,25,25,0,0,0,-25,-24.75,0,0,-25,-24.75,0,321.50733333333335,25,24.75,0.99,321.50733333333335,0,0
424,1.99,0.01,1,0.99,0.98,24.75,24.75,1.99,25.99,25.99,-0.01,-24.01,-24.01,25,25,26,26,0.01,-24,-24,625,625,50,24,24.01,0,625,24,24.01,0,26.176,1,0.99,0.99,1.1759999999999984,25,25
425,1.01,0.99,4,0.04,0.0,0.5,0.0,2.02,25.02,0.02,-1.98,-24.98,0.02,50,0,27,2,1.98,-23,2,625,0,25,23,24.98,25,0,-2,-0.02,-25,25.032666666666668,2,0.02,0.01,0.03266666666666751,25,0
426,1.99,0.01,1,0.99,0.98,24.75,0.0,1.99,25.99,0.99,-0.01,-24.01,0.99,25,0,26,1,0.01,-24,1,625,0,25,24,24.01,25,0,-1,-0.99,-25,25.994666666666667,1,0.99,0.99,0.9946666666666673,25,0
427,1.01,0.99,625,6.25,0.06,0.0,0.0,25.25,0.25,0.25,-24.75,0.25,0.25,0,0,25,25,24.75,25,25,0,0,0,-25,-0.25,0,0,-25,-0.25,0,3.138,25,0.25,0.01,3.138,0,0
428,1.01,0.99,1,0.01,0.0,0.24,0.25,1.01,24.01,25.01,-0.99,-23.99,-24.99,24,25,25,26,0.99,-23,-24,576,600,49,23,23.99,-1,625,24,24.99,1,48.728,1,0.01,0.01,24.728,24,25
429,1.99,0.01,4,3.96,3.92,0.0,0.0,3.98,1.98,1.98,-0.02,1.98,1.98,0,0,2,2,0.02,2,2,0,0,0,-2,-1.98,0,0,-2,-1.98,0,2.966,2,1.98,0.99,2.966,0,0
430,1.83,0.17,625,517.5,428.49,517.5,248.4,45.7,45.7,32.7,-4.3,-4.3,8.7,625,300,50,37,4.3,0,13,625,300,37,0,4.3,13,144,-13,-8.7,-13,346.1206666666667,25,20.7,0.827999775353927,321.1206666666667,25,12
431,1.99,0.01,625,618.75,612.56,0.0,618.75,49.75,24.75,49.75,-0.25,24.75,-0.25,0,625,25,50,0.25,25,0,0,0,25,-25,-24.75,-25,625,0,0.25,25,328.07533333333333,25,24.75,0.99,328.07533333333333,0,25
432,1.99,0.01,1,0.99,0.98,0.0,0.0,1.99,0.99,0.99,-0.01,0.99,0.99,0,0,1,1,0.01,1,1,0,0,0,-1,-0.99,0,0,-1,-0.99,0,0.9846666666666667,1,0.99,0.99,0.9846666666666667,0,0
433,1.01,0.99,625,6.25,0.06,0.0,0.0,25.25,0.25,0.25,-24.75,0.25,0.25,0,0,25,25,24.75,25,25,0,0,0,-25,-0.25,0,0,-25,-0.25,0,3.3893333333333335,25,0.25,0.01,3.3893333333333335,0,0
434,1.99,0.01,625,618.75,612.56,0.0,321.75,49.75,24.75,37.75,-0.25,24.75,11.75,0,325,25,38,0.25,25,12,0,0,13,-25,-24.75,-13,169,-12,-11.75,13,325.0013333333333,25,24.75,0.99,325.0013333333333,0,13
435,1.99,0.01,625,618.75,612.56,0.0,618.75,49.75,24.75,49.75,-0.25,24.75,-0.25,0,625,25,50,0.25,25,0,0,0,25,-25,-24.75,-25,625,0,0.25,25,327.888,25,24.75,0.99,327.888,0,25
436,1.01,0.99,169,1.69,0.02,3.25,3.25,13.13,25.13,25.13,-12.87,-24.87,-24.87,325,325,38,38,12.87,-12,-12,625,625,50,12,24.87,0,625,12,24.87,0,348.01,13,0.13,0.01000000168537027,323.01,25,25
437,1.99,0.01,625,618.75,612.56,618.75,321.75,49.75,49.75,37.75,-0.25,-0.25,11.75,625,325,50,38,0.25,0,12,625,325,38,0,0.25,12,169,-12,-11.75,-12,349.998,25,24.75,0.99,324.998,25,13
438,1.99,0.01,169,167.31,165.64,0.0,321.75,25.87,12.87,37.87,-0.13,12.87,-12.13,0,325,13,38,0.13,13,-12,0,0,25,-13,-12.87,-25,625,12,12.13,25,93.40666666666667,13,12.87,0.99,93.40666666666667,0,25
439,1.99,0.01,225,222.75,220.52,0.0,371.25,29.85,14.85,39.85,-0.15,14.85,-10.15,0,375,15,40,0.15,15,-10,0,0,25,-15,-14.85,-25,625,10,10.15,25,122.576,15,14.85,0.99,122.576,0,25
440,1.99,0.01,1,0.99,0.98,0.0,0.99,1.99,0.99,1.99,-0.01,0.99,-0.01,0,1,1,2,0.01,1,0,0,0,1,-1,-0.99,-1,1,0,0.01,1,1.0,1,0.99,0.99,1.0,0,1
441,1.99,0.01,625,618.75,612.56,618.75,0.0,49.75,49.75,24.75,-0.25,-0.25,24.75,625,0,50,25,0.25,0,25,625,0,25,0,0.25,25,0,-25,-24.75,-25,346.75733333333335,25,24.75,0.99,321.75733333333335,25,0
442,1.99,0.01,1,0.99,0.98,0.0,0.0,1.99,0.99,0.99,-0.01,0.99,0.99,0,0,1,1,0.01,1,1,0,0,0,-1,-0.99,0,0,-1,-0.99,0,0.992,1,0.99,0.99,0.992,0,0
443,1.99,0.01,625,618.75,612.56,0.0,0.0,49.75,24.75,24.75,-0.25,24.75,24.75,0,0,25,25,0.25,25,25,0,0,0,-25,-24.75,0,0,-25,-24.75,0,321.89866666666666,25,24.75,0.99,321.89866666666666,0,0
444,1.01,0.99,1,0.01,0.0,0.0,0.25,1.01,0.01,25.01,-0.99,0.01,-24.99,0,25,1,26,0.99,1,-24,0,0,25,-1,-0.01,-25,625,24,24.99,25,24.744,1,0.01,0.01,24.744,0,25
445,1.99,0.01,1,0.99,0.98,0.0,0.99,1.99,0.99,1.99,-0.01,0.99,-0.01,0,1,1,2,0.01,1,0,0,0,1,-1,-0.99,-1,1,0,0.01,1,1.0,1,0.99,0.99,1.0,0,1
446,1.99,0.01,625,618.75,612.56,618.75,0.0,49.75,49.75,24.75,-0.25,-0.25,24.75,625,0,50,25,0.25,0,25,625,0,25,0,0.25,25,0,-25,-24.75,-25,347.122,25,24.75,0.99,322.122,25,0
447,1.01,0.99,144,1.44,0.01,3.0,3.0,12.12,25.12,25.12,-11.88,-24.88,-24.88,300,300,37,37,11.88,-13,-13,625,625,50,13,24.88,0,625,13,24.88,0,322.718,12,0.12,0.01,297.718,25,25
448,1.99,0.01,1,0.99,0.98,0.0,0.0,1.99,0.99,0.99,-0.01,0.99,0.99,0,0,1,1,0.01,1,1,0,0,0,-1,-0.99,0,0,-1,-0.99,0,0.9913333333333333,1,0.99,0.99,0.9913333333333333,0,0
449,1.99,0.01,625,618.75,612.56,0.0,0.0,49.75,24.75,24.75,-0.25,24.75,24.75,0,0,25,25,0.25,25,25,0,0,0,-25,-24.75,0,0,-25,-24.75,0,321.768,25,24.75,0.99,321.768,0,0
450,1.99,0.01,169,167.31,165.64,321.75,321.75,25.87,37.87,37.87,-0.13,-12.13,-12.13,325,325,38,38,0.13,-12,-12,625,625,50,12,12.13,0,625,12,12.13,0,118.42333333333333,13,12.87,0.99,93.42333333333333,25,25
451,1.99,0.01,625,618.75,612.56,0.0,297.0,49.75,24.75,36.75,-0.25,24.75,12.75,0,300,25,37,0.25,25,13,0,0,12,-25,-24.75,-12,144,-13,-12.75,12,324.81333333333333,25,24.75,0.99,324.81333333333333,0,12
452,1.01,0.99,625,6.25,0.06,6.25,6.25,25.25,25.25,25.25,-24.75,-24.75,-24.75,625,625,50,50,24.75,0,0,625,625,50,0,24.75,0,625,0,24.75,0,647.2113333333333,25,0.25,0.01,622.2113333333333,25,25
453,1.99,0.01,169,167.31,165.64,0.0,321.75,25.87,12.87,37.87,-0.13,12.87,-12.13,0,325,13,38,0.13,13,-12,0,0,25,-13,-12.87,-25,625,12,12.13,25,93.29933333333334,13,12.87,0.99,93.29933333333334,0,25
454,1.99,0.01,625,618.75,612.56,0.0,618.75,49.75,24.75,49.75,-0.25,24.75,-0.25,0,625,25,50,0.25,25,0,0,0,25,-25,-24.75,-25,625,0,0.25,25,328.0106666666667,25,24.75,0.99,328.0106666666667,0,25
455,1.01,0.99,1,0.01,0.0,0.24,0.25,1.01,24.01,25.01,-0.99,-23.99,-24.99,24,25,25,26,0.99,-23,-24,576,600,49,23,23.99,-1,625,24,24.99,1,48.792,1,0.01,0.01,24.792,24,25
456,1.99,0.01,4,3.96,3.92,0.0,0.0,3.98,1.98,1.98,-0.02,1.98,1.98,0,0,2,2,0.02,2,2,0,0,0,-2,-1.98,0,0,-2,-1.98,0,2.966666666666667,2,1.98,0.99,2.966666666666667,0,0
457,1.99,0.01,1,0.99,0.98,0.0,0.0,1.99,0.99,0.99,-0.01,0.99,0.99,0,0,1,1,0.01,1,1,0,0,0,-1,-0.99,0,0,-1,-0.99,0,0.988,1,0.99,0.99,0.988,0,0
458,1.01,0.99,169,1.69,0.02,0.0,0.0,13.13,0.13,0.13,-12.87,0.13,0.13,0,0,13,13,12.87,13,13,0,0,0,-13,-0.13,0,0,-13,-0.13,0,0.878,13,0.13,0.01,0.878,0,0
459,1.99,0.01,1,0.99,0.98,0.0,24.75,1.99,0.99,25.99,-0.01,0.99,-24.01,0,25,1,26,0.01,1,-24,0,0,25,-1,-0.99,-25,625,24,24.01,25,1.176,1,0.99,0.99,1.176,0,25
460,1.01,0.99,1,0.01,0.0,0.0,0.0,1.01,0.01,0.01,-0.99,0.01,0.01,0,0,1,1,0.99,1,1,0,0,0,-1,-0.01,0,0,-1,-0.01,0,0.008,1,0.01,0.01,0.008,0,0
461,1.09,0.91,625,57.4,5.27,0.0,57.4,27.3,2.3,27.3,-22.7,2.3,-22.7,0,625,25,50,22.7,25,0,0,0,25,-25,-2.3,-25,625,0,22.7,25,597.2773333333333,25,2.3,0.09183458033420318,597.2773333333333,0,25
462,1.99,0.01,1,0.99,0.98,0.0,0.0,1.99,0.99,0.99,-0.01,0.99,0.99,0,0,1,1,0.01,1,1,0,0,0,-1,-0.99,0,0,-1,-0.99,0,0.9906666666666667,1,0.99,0.99,0.9906666666666667,0,0
463,1.99,0.01,625,618.75,612.56,0.0,0.0,49.75,24.75,24.75,-0.25,24.75,24.75,0,0,25,25,0.25,25,25,0,0,0,-25,-24.75,0,0,-25,-24.75,0,321.50733333333335,25,24.75,0.99,321.50733333333335,0,0
464,1.99,0.01,1,0.99,0.98,24.75,24.75,1.99,25.99,25.99,-0.01,-24.01,-24.01,25,25,26,26,0.01,-24,-24,625,625,50,24,24.01,0,625,24,24.01,0,26.176,1,0.99,0.99,1.1759999999999984,25,25
465,1.01,0.99,4,0.04,0.0,0.5,0.0,2.02,25.02,0.02,-1.98,-24.98,0.02,50,0,27,2,1.98,-23,2,625,0,25,23,24.98,25,0,-2,-0.02,-25,25.032666666666668,2,0.02,0.01,0.03266666666666751,25,0
466,1.99,0.01,1,0.99,0.98,24.75,0.0,1.99,25.99,0.99,-0.01,-24.01,0.99,25,0,26,1,0.01,-24,1,625,0,25,24,24.01,25,0,-1,-0.99,-25,25.994666666666667,1,0.99,0.99,0.9946666666666673,25,0
467,1.01,0.99,625,6.25,0.06,0.0,0.0,25.25,0.25,0.25,-24.75,0.25,0.25,0,0,25,25,24.75,25,25,0,0,0,-25,-0.25,0,0,-25,-0.25,0,3.138,25,0.25,0.01,3.138,0,0
468,1.01,0.99,1,0.01,0.0,0.24,0.25,1.01,24.01,25.01,-0.99,-23.99,-24.99,24,25,25,26,0.99,-23,-24,576,600,49,23,23.99,-1,625,24,24.99,1,48.728,1,0.01,0.01,24.728,24,25
469,1.99,0.01,4,3.96,3.92,0.0,0.0,3.98,1.98,1.98,-0.02,1.98,1.98,0,0,2,2,0.02,2,2,0,0,0,-2,-1.98,0,0,-2,-1.98,0,2.966,2,1.98,0.99,2.966,0,0
470,1.83,0.17,625,517.5,428.49,517.5,248.4,45.7,45.7,32.7,-4.3,-4.3,8.7,625,300,50,37,4.3,0,13,625,300,37,0,4.3,13,144,-13,-8.7,-13,346.1206666666667,25,20.7,0.827999775353927,321.1206666666667,25,12
471,1.99,0.01,625,618.75,612.56,0.0,618.75,49.75,24.75,49.75,-0.25,24.75,-0.25,0,625,25,50,0.25,25,0,0,0,25,-25,-24.75,-25,625,0,0.25,25,328.07533333333333,25,24.75,0.99,328.07533333333333,0,25
472,1.99,0.01,1,0.99,0.98,0.0,0.0,1.99,0.99,0.99,-0.01,0.99,0.99,0,0,1,1,0.01,1,1,0,0,0,-1,-0.99,0,0,-1,-0.99,0,0.9846666666666667,1,0.99,0.99,0.9846666666666667,0,0
473,1.01,0.99,625,6.25,0.06,0.0,0.0,25.25,0.25,0.25,-24.75,0.25,0.25,0,0,25,25,24.75,25,25,0,0,0,-25,-0.25,0,0,-25,-0.25,0,3.3893333333333335,25,0.25,0.01,3.3893333333333335,0,0
474,1.99,0.01,625,618.75,612.56,0.0,321.75,49.75,24.75,37.75,-0.25,24.75,11.75,0,325,25,38,0.25,25,12,0,0,13,-25,-24.75,-13,169,-12,-11.75,13,325.0013333333333,25,24.75,0.99,325.0013333333333,0,13
475,1.99,0.01,625,618.75,612.56,0.0,618.75,49.75,24.75,49.75,-0.25,24.75,-0.25,0,625,25,50,0.25,25,0,0,0,25,-25,-24.75,-25,625,0,0.25,25,327.888,25,24.75,0.99,327.888,0,25
476,1.01,0.99,169,1.69,0.02,3.25,3.25,13.13,25.13,25.13,-12.87,-24.87,-24.87,325,325,38,38,12.87,-12,-12,625,625,50,12,24.87,0,625,12,24.87,0,348.01,13,0.13,0.01000000168537027,323.01,25,25
477,1.99,0.01,625,618.75,612.56,618.75,321.75,49.75,49.75,37.75,-0.25,-0.25,11.75,625,325,50,38,0.25,0,12,625,325,38,0,0.25,12,169,-12,-11.75,-12,349.998,25,24.75,0.99,324.998,25,13
478,1.99,0.01,169,167.31,165.64,0.0,321.75,25.87,12.87,37.87,-0.13,12.87,-12.13,0,325,13,38,0.13,13,-12,0,0,25,-13,-12.87,-25,625,12,12.13,25,93.40666666666667,13,12.87,0.99,93.40666666666667,0,25
479,1.99,0.01,225,222.75,220.52,0.0,371.25,29.85,14.85,39.85,-0.15,14.85,-10.15,0,375,15,40,0.15,15,-10,0,0,25,-15,-14.85,-25,625,10,10.15,25,122.576,15,14.85,0.99,122.576,0,25
480,1.99,0.01,1,0.99,0.98,0.0,0.99,1.99,0.99,1.99,-0.01,0.99,-0.01,0,1,1,2,0.01,1,0,0,0,1,-1,-0.99,-1,1,0,0.01,1,1.0,1,0.99,0.99,1.0,0,1
481,1.99,0.01,625,618.75,612.56,618.75,0.0,49.75,49.75,24.75,-0.25,-0.25,24.75,625,0,50,25,0.25,0,25,625,0,25,0,0.25,25,0,-25,-24.75,-25,346.75733333333335,25,24.75,0.99,321.75733333333335,25,0
482,1.99,0.01,1,0.99,0.98,0.0,0.0,1.99,0.99,0.99,-0.01,0.99,0.99,0,0,1,1,0.01,1,1,0,0,0,-1,-0.99,0,0,-1,-0.99,0,0.992,1,0.99,0.99,0.992,0,0
483,1.99,0.01,625,618.75,612.56,0.0,0.0,49.75,24.75,24.75,-0.25,24.75,24.75,0,0,25,25,0.25,25,25,0,0,0,-25,-24.75,0,0,-25,-24.75,0,321.89866666666666,25,24.75,0.99,321.89866666666666,0,0
484,1.01,0.99,1,0.01,0.0,0.0,0.25,1.01,0.01,25.01,-0.99,0.01,-24.99,0,25,1,26,0.99,1,-24,0,0,25,-1,-0.01,-25,625,24,24.99,25,24.744,1,0.01,0.01,24.744,0,25
485,1.99,0.01,1,0.99,0.98,0.0,0.99,1.99,0.99,1.99,-0.01,0.99,-0.01,0,1,1,2,0.01,1,0,0,0,1,-1,-0.99,-1,1,0,0.01,1,1.0,1,0.99,0.99,1.0,0,1
486,1.99,0.01,625,618.75,612.56,618.75,0.0,49.75,49.75,24.75,-0.25,-0.25,24.75,625,0,50,25,0.25,0,25,625,0,25,0,0.25,25,0,-25,-24.75,-25,347.122,25,24.75,0.99,322.122,25,0
487,1.01,0.99,144,1.44,0.01,3.0,3.0,12.12,25.12,25.12,-11.88,-24.88,-24.88,300,300,37,37,11.88,-13,-13,625,625,50,13,24.88,0,625,13,24.88,0,322.718,12,0.12,0.01,297.718,25,25
488,1.99,0.01,1,0.99,0.98,0.0,0.0,1.99,0.99,0.99,-0.01,0.99,0.99,0,0,1,1,0.01,1,1,0,0,0,-1,-0.99,0,0,-1,-0.99,0,0.9913333333333333,1,0.99,0.99,0.9913333333333333,0,0
489,1.99,0.01,625,618.75,612.56,0.0,0.0,49.75,24.75,24.75,-0.25,24.75,24.75,0,0,25,25,0.25,25,25,0,0,0,-25,-24.75,0,0,-25,-24.75,0,321.768,25,24.75,0.99,321.768,0,0
490,1.99,0.01,169,167.31,165.64,321.75,321.75,25.87,37.87,37.87,-0.13,-12.13,-12.13,325,325,38,38,0.13,-12,-12,625,625,50,12,12.13,0,625,12,12.13,0,118.42333333333333,13,12.87,0.99,93.42333333333333,25,25
491,1.99,0.01,625,618.75,612.56,0.0,297.0,49.75,24.75,36.75,-0.25,24.75,12.75,0,300,25,37,0.25,25,13,0,0,12,-25,-24.75,-12,144,-13,-12.75,12,324.81333333333333,25,24.75,0.99,324.81333333333333,0,12
492,1.01,0.99,625,6.25,0.06,6.25,6.25,25.25,25.25,25.25,-24.75,-24.75,-24.75,625,625,50,50,24.75,0,0,625,625,50,0,24.75,0,625,0,24.75,0,647.2113333333333,25,0.25,0.01,622.2113333333333,25,25
493,1.99,0.01,169,167.31,165.64,0.0,321.75,25.87,12.87,37.87,-0.13,12.87,-12.13,0,325,13,38,0.13,13,-12,0,0,25,-13,-12.87,-25,625,12,12.13,25,93.29933333333334,13,12.87,0.99,93.29933333333334,0,25
494,1.99,0.01,625,618.75,612.56,0.0,618.75,49.75,24.75,49.75,-0.25,24.75,-0.25,0,625,25,50,0.25,25,0,0,0,25,-25,-24.75,-25,625,0,0.25,25,328.0106666666667,25,24.75,0.99,328.0106666666667,0,25
495,1.01,0.99,1,0.01,0.0,0.24,0.25,1.01,24.01,25.01,-0.99,-23.99,-24.99,24,25,25,26,0.99,-23,-24,576,600,49,23,23.99,-1,625,24,24.99,1,48.792,1,0.01,0.01,24.792,24,25
496,1.99,0.01,4,3.96,3.92,0.0,0.0,3.98,1.98,1.98,-0.02,1.98,1.98,0,0,2,2,0.02,2,2,0,0,0,-2,-1.98,0,0,-2,-1.98,0,2.966666666666667,2,1.98,0.99,2.966666666666667,0,0
497,1.99,0.01,1,0.99,0.98,0.0,0.0,1.99,0.99,0.99,-0.01,0.99,0.99,0,0,1,1,0.01,1,1,0,0,0,-1,-0.99,0,0,-1,-0.99,0,0.988,1,0.99,0.99,0.988,0,0
498,1.01,0.99,169,1.69,0.02,0.0,0.0,13.13,0.13,0.13,-12.87,0.13,0.13,0,0,13,13,12.87,13,13,0,0,0,-13,-0.13,0,0,-13,-0.13,0,0.878,13,0.13,0.01,0.878,0,0
499,1.99,0.01,1,0.99,0.98,0.0,24.75,1.99,0.99,25.99,-0.01,0.99,-24.01,0,25,1,26,0.01,1,-24,0,0,25,-1,-0.99,-25,625,24,24.01,25,1.176,1,0.99,0.99,1.176,0,25
500,1.01,0.99,1,0.01,0.0,0.0,0.0,1.01,0.01,0.01,-0.99,0.01,0.01,0,0,1,1,0.99,1,1,0,0,0,-1,-0.01,0,0,-1,-0.01,0,0.008,1,0.01,0.01,0.008,0,0
501,1.09,0.91,625,57.4,5.27,0.0,57.4,27.3,2.3,27.3,-22.7,2.3,-22.7,0,625,25,50,22.7,25,0,0,0,25,-25,-2.3,-25,625,0,22.7,25,597.2773333333333,25,2.3,0.09183458033420318,597.2773333333333,0,25
502,1.99,0.01,1,0.99,0.98,0.0,0.0,1.99,0.99,0.99,-0.01,0.99,0.99,0,0,1,1,0.01,1,1,0,0,0,-1,-0.99,0,0,-1,-0.99,0,0.9906666666666667,1,0.99,0.99,0.9906666666666667,0,0
503,1.99,0.01,625,618.75,612.56,0.0,0.0,49.75,24.75,24.75,-0.25,24.75,24.75,0,0,25,25,0.25,25,25,0,0,0,-25,-24.75,0,0,-25,-24.75,0,321.50733333333335,25,24.75,0.99,321.50733333333335,0,0
504,1.99,0.01,1,0.99,0.98,24.75,24.75,1.99,25.99,25.99,-0.01,-24.01,-24.01,25,25,26,26,0.01,-24,-24,625,625,50,24,24.01,0,625,24,24.01,0,26.176,1,0.99,0.99,1.1759999999999984,25,25
505,1.01,0.99,4,0.04,0.0,0.5,0.0,2.02,25.02,0.02,-1.98,-24.98,0.02,50,0,27,2,1.98,-23,2,625,0,25,23,24.98,25,0,-2,-0.02,-25,25.032666666666668,2,0.02,0.01,0.03266666666666751,25,0
506,1.99,0.01,1,0.99,0.98,24.75,0.0,1.99,25.99,0.99,-0.01,-24.01,0.99,25,0,26,1,0.01,-24,1,625,0,25,24,24.01,25,0,-1,-0.99,-25,25.994666666666667,1,0.99,0.99,0.9946666666666673,25,0
507,1.01,0.99,625,6.25,0.06,0.0,0.0,25.25,0.25,0.25,-24.75,0.25,0.25,0,0,25,25,24.75,25,25,0,0,0,-25,-0.25,0,0,-25,-0.25,0,3.138,25,0.25,0.01,3.138,0,0
508,1.01,0.99,1,0.01,0.0,0.24,0.25,1.01,24.01,25.01,-0.99,-23.99,-24.99,24,25,25,26,0.99,-23,-24,576,600,49,23,23.99,-1,625,24,24.99,1,48.728,1,0.01,0.01,24.728,24,25
509,1.99,0.01,4,3.96,3.92,0.0,0.0,3.98,1.98,1.98,-0.02,1.98,1.98,0,0,2,2,0.02,2,2,0,0,0,-2,-1.98,0,0,-2,-1.98,0,2.966,2,1.98,0.99,2.966,0,0
510,1.83,0.17,625,517.5,428.49,517.5,248.4,45.7,45.7,32.7,-4.3,-4.3,8.7,625,300,50,37,4.3,0,13,625,300,37,0,4.3,13,144,-13,-8.7,-13,346.1206666666667,25,20.7,0.827999775353927,321.1206666666667,25,12
511,1.99,0.01,625,618.75,612.56,0.0,618.75,49.75,24.75,49.75,-0.25,24.75,-0.25,0,625,25,50,0.25,25,0,0,0,25,-25,-24.75,-25,625,0,0.25,25,328.07533333333333,25,24.75,0.99,328.07533333333333,0,25
512,1.99,0.01,1,0.99,0.98,0.0,0.0,1.99,0.99,0.99,-0.01,0.99,0.99,0,0,1,1,0.01,1,1,0,0,0,-1,-0.99,0,0,-1,-0.99,0,0.9846666666666667,1,0.99,0.99,0.9846666666666667,0,0
513,1.01,0.99,625,6.25,0.06,0.0,0.0,25.25,0.25,0.25,-24.75,0.25,0.25,0,0,25,25,24.75,25,25,0,0,0,-25,-0.25,0,0,-25,-0.25,0,3.3893333333333335,25,0.25,0.01,3.3893333333333335,0,0
514,1.99,0.01,625,618.75,612.56,0.0,321.75,49.75,24.75,37.75,-0.25,24.75,11.75,0,325,25,38,0.25,25,12,0,0,13,-25,-24.75,-13,169,-12,-11.75,13,325.0013333333333,25,24.75,0.99,325.0013333333333,0,13
515,1.99,0.01,625,618.75,612.56,0.0,618.75,49.75,24.75,49.75,-0.25,24.75,-0.25,0,625,25,50,0.25,25,0,0,0,25,-25,-24.75,-25,625,0,0.25,25,327.888,25,24.75,0.99,327.888,0,25
516,1.01,0.99,169,1.69,0.02,3.25,3.25,13.13,25.13,25.13,-12.87,-24.87,-24.87,325,325,38,38,12.87,-12,-12,625,625,50,12,24.87,0,625,12,24.87,0,348.01,13,0.13,0.01000000168537027,323.01,25,25
517,1.99,0.01,625,618.75,612.56,618.75,321.75,49.75,49.75,37.75,-0.25,-0.25,11.75,625,325,50,38,0.25,0,12,625,325,38,0,0.25,12,169,-12,-11.75,-12,349.998,25,24.75,0.99,324.998,25,13
518,1.99,0.01,169,167.31,165.64,0.0,321.75,25.87,12.87,37.87,-0.13,12.87,-12.13,0,325,13,38,0.13,13,-12,0,0,25,-13,-12.87,-25,625,12,12.13,25,93.40666666666667,13,12.87,0.99,93.40666666666667,0,25
519,1.99,0.01,225,222.75,220.52,0.0,371.25,29.85,14.85,39.85,-0.15,14.85,-10.15,0,375,15,40,0.15,15,-10,0,0,25,-15,-14.85,-25,625,10,10.15,25,122.576,15,14.85,0.99,122.576,0,25
520,1.99,0.01,1,0.99,0.98,0.0,0.99,1.99,0.99,1.99,-0.01,0.99,-0.01,0,1,1,2,0.01,1,0,0,0,1,-1,-0.99,-1,1,0,0.01,1,1.0,1,0.99,0.99,1.0,0,1
521,1.99,0.01,625,618.75,612.56,618.75,0.0,49.75,49.75,24.75,-0.25,-0.25,24.75,625,0,50,25,0.25,0,25,625,0,25,0,0.25,25,0,-25,-24.75,-25,346.75733333333335,25,24.75,0.99,321.75733333333335,25,0
522,1.99,0.01,1,0.99,0.98,0.0,0.0,1.99,0.99,0.99,-0.01,0.99,0.99,0,0,1,1,0.01,1,1,0,0,0,-1,-0.99,0,0,-1,-0.99,0,0.992,1,0.99,0.99,0.992,0,0
523,1.99,0.01,625,618.75,612.56,0.0,0.0,49.75,24.75,24.75,-0.25,24.75,24.75,0,0,25,25,0.25,25,25,0,0,0,-25,-24.75,0,0,-25,-24.75,0,321.89866666666666,25,24.75,0.99,321.89866666666666,0,0
524,1.01,0.99,1,0.01,0.0,0.0,0.25,1.01,0.01,25.01,-0.99,0.01,-24.99,0,25,1,26,0.99,1,-24,0,0,25,-1,-0.01,-25,625,24,24.99,25,24.744,1,0.01,0.01,24.744,0,25
525,1.99,0.01,1,0.99,0.98,0.0,0.99,1.99,0.99,1.99,-0.01,0.99,-0.01,0,1,1,2,0.01,1,0,0,0,1,-1,-0.99,-1,1,0,0.01,1,1.0,1,0.99,0.99,1.0,0,1
526,1.99,0.01,625,618.75,612.56,618.75,0.0,49.75,49.75,24.75,-0.25,-0.25,24.75,625,0,50,25,0.25,0,25,625,0,25,0,0.25,25,0,-25,-24.75,-25,347.122,25,24.75,0.99,322.122,25,0
527,1.01,0.99,144,1.44,0.01,3.0,3.0,12.12,25.12,25.12,-11.88,-24.88,-24.88,300,300,37,37,11.88,-13,-13,625,625,50,13,24.88,0,625,13,24.88,0,322.718,12,0.12,0.01,297.718,25,25
528,1.99,0.01,1,0.99,0.98,0.0,0.0,1.99,0.99,0.99,-0.01,0.99,0.99,0,0,1,1,0.01,1,1,0,0,0,-1,-0.99,0,0,-1,-0.99,0,0.9913333333333333,1,0.99,0.99,0.9913333333333333,0,0
529,1.99,0.01,625,618.75,612.56,0.0,0.0,49.75,24.75,24.75,-0.25,24.75,24.75,0,0,25,25,0.25,25,25,0,0,0,-25,-24.75,0,0,-25,-24.75,0,321.768,25,24.75,0.99,321.768,0,0
530,1.99,0.01,169,167.31,165.64,321.75,321.75,25.87,37.87,37.87,-0.13,-12.13,-12.13,325,325,38,38,0.13,-12,-12,625,625,50,12,12.13,0,625,12,12.13,0,118.42333333333333,13,12.87,0.99,93.42333333333333,25,25
531,1.99,0.01,625,618.75,612.56,0.0,297.0,49.75,24.75,36.75,-0.25,24.75,12.75,0,300,25,37,0.25,25,13,0,0,12,-25,-24.75,-12,144,-13,-12.75,12,324.81333333333333,25,24.75,0.99,324.81333333333333,0,12
532,1.01,0.99,625,6.25,0.06,6.25,6.25,25.25,25.25,25.25,-24.75,-24.75,-24.75,625,625,50,50,24.75,0,0,625,625,50,0,24.75,0,625,0,24.75,0,647.2113333333333,25,0.25,0.01,622.2113333333333,25,25
533,1.99,0.01,169,167.31,165.64,0.0,321.75,25.87,12.87,37.87,-0.13,12.87,-12.13,0,325,13,38,0.13,13,-12,0,0,25,-13,-12.87,-25,625,12,12.13,25,93.29933333333334,13,12.87,0.99,93.29933333333334,0,25
534,1.99,0.01,625,618.75,612.56,0.0,618.75,49.75,24.75,49.75,-0.25,24.75,-0.25,0,625,25,50,0.25,25,0,0,0,25,-25,-24.75,-25,625,0,0.25,25,328.0106666666667,25,24.75,0.99,328.0106666666667,0,25
535,1.01,0.99,1,0.01,0.0,0.24,0.25,1.01,24.01,25.01,-0.99,-23.99,-24.99,24,25,25,26,0.99,-23,-24,576,600,49,23,23.99,-1,625,24,24.99,1,48.792,1,0.01,0.01,24.792,24,25
536,1.99,0.01,4,3.96,3.92,0.0,0.0,3.98,1.98,1.98,-0.02,1.98,1.98,0,0,2,2,0.02,2,2,0,0,0,-2,-1.98,0,0,-2,-1.98,0,2.966666666666667,2,1.98,0.99,2.966666666666667,0,0
537,1.99,0.01,1,0.99,0.98,0.0,0.0,1.99,0.99,0.99,-0.01,0.99,0.99,0,0,1,1,0.01,1,1,0,0,0,-1,-0.99,0,0,-1,-0.99,0,0.988,1,0.99,0.99,0.988,0,0
538,1.01,0.99,169,1.69,0.02,0.0,0.0,13.13,0.13,0.13,-12.87,0.13,0.13,0,0,13,13,12.87,13,13,0,0,0,-13,-0.13,0,0,-13,-0.13,0,0.878,13,0.13,0.01,0.878,0,0
539,1.99,0.01,1,0.99,0.98,0.0,24.75,1.99,0.99,25.99,-0.01,0.99,-24.01,0,25,1,26,0.01,1,-24,0,0,25,-1,-0.99,-25,625,24,24.01,25,1.176,1,0.99,0.99,1.176,0,25
540,1.01,0.99,1,0.01,0.0,0.0,0.0,1.01,0.01,0.01,-0.99,0.01,0.01,0,0,1,1,0.99,1,1,0,0,0,-1,-0.01,0,0,-1,-0.01,0,0.008,1,0.01,0.01,0.008,0,0
541,1.09,0.91,625,57.4,5.27,0.0,57.4,27.3,2.3,27.3,-22.7,2.3,-22.7,0,625,25,50,22.7,25,0,0,0,25,-25,-2.3,-25,625,0,22.7,25,597.2773333333333,25,2.3,0.09183458033420318,597.2773333333333,0,25
542,1.99,0.01,1,0.99,0.98,0.0,0.0,1.99,0.99,0.99,-0.01,0.99,0.99,0,0,1,1,0.01,1,1,0,0,0,-1,-0.99,0,0,-1,-0.99,0,0.9906666666666667,1,0.99,0.99,0.9906666666666667,0,0
543,1.99,0.01,625,618.75,612.56,0.0,0.0,49.75,24.75,24.75,-0.25,24.75,24.75,0,0,25,25,0.25,25,25,0,0,0,-25,-24.75,0,0,-25,-24.75,0,321.50733333333335,25,24.75,0.99,321.50733333333335,0,0
544,1.99,0.01,1,0.99,0.98,24.75,24.75,1.99,25.99,25.99,-0.01,-24.01,-24.01,25,25,26,26,0.01,-24,-24,625,625,50,24,24.01,0,625,24,24.01,0,26.176,1,0.99,0.99,1.1759999999999984,25,25
545,1.01,0.99,4,0.04,0.0,0.5,0.0,2.02,25.02,0.02,-1.98,-24.98,0.02,50,0,27,2,1.98,-23,2,625,0,25,23,24.98,25,0,-2,-0.02,-25,25.032666666666668,2,0.02,0.01,0.03266666666666751,25,0
546,1.99,0.01,1,0.99,0.98,24.75,0.0,1.99,25.99,0.99,-0.01,-24.01,0.99,25,0,26,1,0.01,-24,1,625,0,25,24,24.01,25,0,-1,-0.99,-25,25.994666666666667,1,0.99,0.99,0.9946666666666673,25,0
547,1.01,0.99,625,6.25,0.06,0.0,0.0,25.25,0.25,0.25,-24.75,0.25,0.25,0,0,25,25,24.75,25,25,0,0,0,-25,-0.25,0,0,-25,-0.25,0,3.138,25,0.25,0.01,3.138,0,0
548,1.01,0.99,1,0.01,0.0,0.24,0.25,1.01,24.01,25.01,-0.99,-23.99,-24.99,24,25,25,26,0.99,-23,-24,576,600,49,23,23.99,-1,625,24,24.99,1,48.728,1,0.01,0.01,24.728,24,25
549,1.99,0.01,4,3.96,3.92,0.0,0.0,3.98,1.98,1.98,-0.02,1.98,1.98,0,0,2,2,0.02,2,2,0,0,0,-2,-1.98,0,0,-2,-1.98,0,2.966,2,1.98,0.99,2.966,0,0
550,1.83,0.17,625,517.5,428.49,517.5,248.4,45.7,45.7,32.7,-4.3,-4.3,8.7,625,300,50,37,4.3,0,13,625,300,37,0,4.3,13,144,-13,-8.7,-13,346.1206666666667,25,20.7,0.827999775353927,321.1206666666667,25,12
551,1.99,0.01,625,618.75,612.56,0.0,618.75,49.75,24.75,49.75,-0.25,24.75,-0.25,0,625,25,50,0.25,25,0,0,0,25,-25,-24.75,-25,625,0,0.25,25,328.07533333333333,25,24.75,0.99,328.07533333333333,0,25
552,1.99,0.01,1,0.99,0.98,0.0,0.0,1.99,0.99,0.99,-0.01,0.99,0.99,0,0,1,1,0.01,1,1,0,0,0,-1,-0.99,0,0,-1,-0.99,0,0.9846666666666667,1,0.99,0.99,0.9846666666666667,0,0
553,1.01,0.99,625,6.25,0.06,0.0,0.0,25.25,0.25,0.25,-24.75,0.25,0.25,0,0,25,25,24.75,25,25,0,0,0,-25,-0.25,0,0,-25,-0.25,0,3.3893333333333335,25,0.25,0.01,3.3893333333333335,0,0
554,1.99,0.01,625,618.75,612.56,0.0,321.75,49.75,24.75,37.75,-0.25,24.75,11.75,0,325,25,38,0.25,25,12,0,0,13,-25,-24.75,-13,169,-12,-11.75,13,325.0013333333333,25,24.75,0.99,325.0013333333333,0,13
555,1.99,0.01,625,618.75,612.56,0.0,618.75,49.75,24.75,49.75,-0.25,24.75,-0.25,0,625,25,50,0.25,25,0,0,0,25,-25,-24.75,-25,625,0,0.25,25,327.888,25,24.75,0.99,327.888,0,25
556,1.01,0.99,169,1.69,0.02,3.25,3.25,13.13,25.13,25.13,-12.87,-24.87,-24.87,325,325,38,38,12.87,-12,-12,625,625,50,12,24.87,0,625,12,24.87,0,348.01,13,0.13,0.01000000168537027,323.01,25,25
557,1.99,0.01,625,618.75,612.56,618.75,321.75,49.75,49.75,37.75,-0.25,-0.25,11.75,625,325,50,38,0.25,0,12,625,325,38,0,0.25,12,169,-12,-11.75,-12,349.998,25,24.75,0.99,324.998,25,13
558,1.99,0.01,169,167.31,165.64,0.0,321.75,25.87,12.87,37.87,-0.13,12.87,-12.13,0,325,13,38,0.13,13,-12,0,0,25,-13,-12.87,-25,625,12,12.13,25,93.40666666666667,13,12.87,0.99,93.40666666666667,0,25
559,1.99,0.01,225,222.75,220.52,0.0,371.25,29.85,14.85,39.85,-0.15,14.85,-10.15,0,375,15,40,0.15,15,-10,0,0,25,-15,-14.85,-25,625,10,10.15,25,122.576,15,14.85,0.99,122.576,0,25
560,1.99,0.01,1,0.99,0.98,0.0,0.99,1.99,0.99,1.99,-0.01,0.99,-0.01,0,1,1,2,0.01,1,0,0,0,1,-1,-0.99,-1,1,0,0.01,1,1.0,1,0.99,0.99,1.0,0,1
561,1.99,0.01,625,618.75,612.56,618.75,0.0,49.75,49.75,24.75,-0.25,-0.25,24.75,625,0,50,25,0.25,0,25,625,0,25,0,0.25,25,0,-25,-24.75,-25,346.75733333333335,25,24.75,0.99,321.75733333333335,25,0
562,1.99,0.01,1,0.99,0.98,0.0,0.0,1.99,0.99,0.99,-0.01,0.99,0.99,0,0,1,1,0.01,1,1,0,0,0,-1,-0.99,0,0,-1,-0.99,0,0.992,1,0.99,0.99,0.992,0,0
563,1.99,0.01,625,618.75,612.56,0.0,0.0,49.75,24.75,24.75,-0.25,24.75,24.75,0,0,25,25,0.25,25,25,0,0,0,-25,-24.75,0,0,-25,-24.75,0,321.89866666666666,25,24.75,0.99,321.89866666666666,0,0
564,1.01,0.99,1,0.01,0.0,0.0,0.25,1.01,0.01,25.01,-0.99,0.01,-24.99,0,25,1,26,0.99,1,-24,0,0,25,-1,-0.01,-25,625,24,24.99,25,24.744,1,0.01,0.01,24.744,0,25
565,1.99,0.01,1,0.99,0.98,0.0,0.99,1.99,0.99,1.99,-0.01,0.99,-0.01,0,1,1,2,0.01,1,0,0,0,1,-1,-0.99,-1,1,0,0.01,1,1.0,1,0.99,0.99,1.0,0,1
566,1.99,0.01,625,618.75,612.56,618.75,0.0,49.75,49.75,24.75,-0.25,-0.25,24.75,625,0,50,25,0.25,0,25,625,0,25,0,0.25,25,0,-25,-24.75,-25,347.122,25,24.75,0.99,322.122,25,0
567,1.01,0.99,144,1.44,0.01,3.0,3.0,12.12,25.12,25.12,-11.88,-24.88,-24.88,300,300,37,37,11.88,-13,-13,625,625,50,13,24.88,0,625,13,24.88,0,322.718,12,0.12,0.01,297.718,25,25
568,1.99,0.01,1,0.99,0.98,0.0,0.0,1.99,0.99,0.99,-0.01,0.99,0.99,0,0,1,1,0.01,1,1,0,0,0,-1,-0.99,0,0,-1,-0.99,0,0.9913333333333333,1,0.99,0.99,0.9913333333333333,0,0
569,1.99,0.01,625,618.75,612.56,0.0,0.0,49.75,24.75,24.75,-0.25,24.75,24.75,0,0,25,25,0.25,25,25,0,0,0,-25,-24.75,0,0,-25,-24.75,0,321.768,25,24.75,0.99,321.768,0,0
570,1.99,0.01,169,167.31,165.64,321.75,321.75,25.87,37.87,37.87,-0.13,-12.13,-12.13,325,325,38,38,0.13,-12,-12,625,625,50,12,12.13,0,625,12,12.13,0,118.42333333333333,13,12.87,0.99,93.42333333333333,25,25
571,1.99,0.01,625,618.75,612.56,0.0,297.0,49.75,24.75,36.75,-0.25,24.75,12.75,0,300,25,37,0.25,25,13,0,0,12,-25,-24.75,-12,144,-13,-12.75,12,324.81333333333333,25,24.75,0.99,324.81333333333333,0,12
572,1.01,0.99,625,6.25,0.06,6.25,6.25,25.25,25.25,25.25,-24.75,-24.75,-24.75,625,625,50,50,24.75,0,0,625,625,50,0,24.75,0,625,0,24.75,0,647.2113333333333,25,0.25,0.01,622.2113333333333,25,25
573,1.99,0.01,169,167.31,165.64,0.0,321.75,25.87,12.87,37.87,-0.13,12.87,-12.13,0,325,13,38,0.13,13,-12,0,0,25,-13,-12.87,-25,625,12,12.13,25,93.29933333333334,13,12.87,0.99,93.29933333333334,0,25
574,1.99,0.01,625,618.75,612.56,0.0,618.75,49.75,24.75,49.75,-0.25,24.75,-0.25,0,625,25,50,0.25,25,0,0,0,25,-25,-24.75,-25,625,0,0.25,25,328.0106666666667,25,24.75,0.99,328.0106666666667,0,25
575,1.01,0.99,1,0.01,0.0,0.24,0.25,1.01,24.01,25.01,-0.99,-23.99,-24.99,24,25,25,26,0.99,-23,-24,576,600,49,23,23.99,-1,625,24,24.99,1,48.792,1,0.01,0.01,24.792,24,25
576,1.99,0.01,4,3.96,3.92,0.0,0.0,3.98,1.98,1.98,-0.02,1.98,1.98,0,0,2,2,0.02,2,2,0,0,0,-2,-1.98,0,0,-2,-1.98,0,2.966666666666667,2,1.98,0.99,2.966666666666667,0,0
577,1.99,0.01,1,0.99,0.98,0.0,0.0,1.99,0.99,0.99,-0.01,0.99,0.99,0,0,1,1,0.01,1,1,0,0,0,-1,-0.99,0,0,-1,-0.99,0,0.988,1,0.99,0.99,0.988,0,0
578,1.01,0.99,169,1.69,0.02,0.0,0.0,13.13,0.13,0.13,-12.87,0.13,0.13,0,0,13,13,12.87,13,13,0,0,0,-13,-0.13,0,0,-13,-0.13,0,0.878,13,0.13,0.01,0.878,0,0
579,1.99,0.01,1,0.99,0.98,0.0,24.75,1.99,0.99,25.99,-0.01,0.99,-24.01,0,25,1,26,0.01,1,-24,0,0,25,-1,-0.99,-25,625,24,24.01,25,1.176,1,0.99,0.99,1.176,0,25
580,1.01,0.99,1,0.01,0.0,0.0,0.0,1.01,0.01,0.01,-0.99,0.01,0.01,0,0,1,1,0.99,1,1,0,0,0,-1,-0.01,0,0,-1,-0.01,0,0.008,1,0.01,0.01,0.008,0,0
581,1.09,0.91,625,57.4,5.27,0.0,57.4,27.3,2.3,27.3,-22.7,2.3,-22.7,0,625,25,50,22.7,25,0,0,0,25,-25,-2.3,-25,625,0,22.7,25,597.2773333333333,25,2.3,0.09183458033420318,597.2773333333333,0,25
582,1.99,0.01,1,0.99,0.98,0.0,0.0,1.99,0.99,0.99,-0.01,0.99,0.99,0,0,1,1,0.01,1,1,0,0,0,-1,-0.99,0,0,-1,-0.99,0,0.9906666666666667,1,0.99,0.99,0.9906666666666667,0,0
583,1.99,0.01,625,618.75,612.56,0.0,0.0,49.75,24.75,24.75,-0.25,24.75,24.75,0,0,25,25,0.25,25,25,0,0,0,-25,-24.75,0,0,-25,-24.75,0,321.50733333333335,25,24.75,0.99,321.50733333333335,0,0
584,1.99,0.01,1,0.99,0.98,24.75,24.75,1.99,25.99,25.99,-0.01,-24.01,-24.01,25,25,26,26,0.01,-24,-24,625,625,50,24,24.01,0,625,24,24.01,0,26.176,1,0.99,0.99,1.1759999999999984,25,25
585,1.01,0.99,4,0.04,0.0,0.5,0.0,2.02,25.02,0.02,-1.98,-24.98,0.02,50,0,27,2,1.98,-23,2,625,0,25,23,24.98,25,0,-2,-0.02,-25,25.032666666666668,2,0.02,0.01,0.03266666666666751,25,0
586,1.99,0.01,1,0.99,0.98,24.75,0.0,1.99,25.99,0.99,-0.01,-24.01,0.99,25,0,26,1,0.01,-24,1,625,0,25,24,24.01,25,0,-1,-0.99,-25,25.994666666666667,1,0.99,0.99,0.9946666666666673,25,0
587,1.01,0.99,625,6.25,0.06,0.0,0.0,25.25,0.25,0.25,-24.75,0.25,0.25,0,0,25,25,24.75,25,25,0,0,0,-25,-0.25,0,0,-25,-0.25,0,3.138,25,0.25,0.01,3.138,0,0
588,1.01,0.99,1,0.01,0.0,0.24,0.25,1.01,24.01,25.01,-0.99,-23.99,-24.99,24,25,25,26,0.99,-23,-24,576,600,49,23,23.99,-1,625,24,24.99,1,48.728,1,0.01,0.01,24.728,24,25
589,1.99,0.01,4,3.96,3.92,0.0,0.0,3.98,1.98,1.98,-0.02,1.98,1.98,0,0,2,2,0.02,2,2,0,0,0,-2,-1.98,0,0,-2,-1.98,0,2.966,2,1.98,0.99,2.966,0,0
590,1.83,0.17,625,517.5,428.49,517.5,248.4,45.7,45.7,32.7,-4.3,-4.3,8.7,625,300,50,37,4.3,0,13,625,300,37,0,4.3,13,144,-13,-8.7,-13,346.1206666666667,25,20.7,0.827999775353927,321.1206666666667,25,12
591,1.99,0.01,625,618.75,612.56,0.0,618.75,49.75,24.75,49.75,-0.25,24.75,-0.25,0,625,25,50,0.25,25,0,0,0,25,-25,-24.75,-25,625,0,0.25,25,328.07533333333333,25,24.75,0.99,328.07533333333333,0,25
592,1.99,0.01,1,0.99,0.98,0.0,0.0,1.99,0.99,0.99,-0.01,0.99,0.99,0,0,1,1,0.01,1,1,0,0,0,-1,-0.99,0,0,-1,-0.99,0,0.9846666666666667,1,0.99,0.99,0.9846666666666667,0,0
593,1.01,0.99,625,6.25,0.06,0.0,0.0,25.25,0.25,0.25,-24.75,0.25,0.25,0,0,25,25,24.75,25,25,0,0,0,-25,-0.25,0,0,-25,-0.25,0,3.3893333333333335,25,0.25,0.01,3.3893333333333335,0,0
594,1.99,0.01,625,618.75,612.56,0.0,321.75,49.75,24.75,37.75,-0.25,24.75,11.75,0,325,25,38,0.25,25,12,0,0,13,-25,-24.75,-13,169,-12,-11.75,13,325.0013333333333,25,24.75,0.99,325.0013333333333,0,13
595,1.99,0.01,625,618.75,612.56,0.0,618.75,49.75,24.75,49.75,-0.25,24.75,-0.25,0,625,25,50,0.25,25,0,0,0,25,-25,-24.75,-25,625,0,0.25,25,327.888,25,24.75,0.99,327.888,0,25
596,1.01,0.99,169,1.69,0.02,3.25,3.25,13.13,25.13,25.13,-12.87,-24.87,-24.87,325,325,38,38,12.87,-12,-12,625,625,50,12,24.87,0,625,12,24.87,0,348.01,13,0.13,0.01000000168537027,323.01,25,25
597,1.99,0.01,625,618.75,612.56,618.75,321.75,49.75,49.75,37.75,-0.25,-0.25,11.75,625,325,50,38,0.25,0,12,625,325,38,0,0.25,12,169,-12,-11.75,-12,349.998,25,24.75,0.99,324.998,25,13
598,1.99,0.01,169,167.31,165.64,0.0,321.75,25.87,12.87,37.87,-0.13,12.87,-12.13,0,325,13,38,0.13,13,-12,0,0,25,-13,-12.87,-25,625,12,12.13,25,93.40666666666667,13,12.87,0.99,93.40666666666667,0,25
599,1.99,0.01,225,222.75,220.52,0.0,371.25,29.85,14.85,39.85,-0.15,14.85,-10.15,0,375,15,40,0.15,15,-10,0,0,25,-15,-14.85,-25,625,10,10.15,25,122.576,15,14.85,0.99,122.576,0,25
600,1.99,0.01,1,0.99,0.98,0.0,0.99,1.99,0.99,1.99,-0.01,0.99,-0.01,0,1,1,2,0.01,1,0,0,0,1,-1,-0.99,-1,1,0,0.01,1,1.0,1,0.99,0.99,1.0,0,1
601,1.99,0.01,625,618.75,612.56,618.75,0.0,49.75,49.75,24.75,-0.25,-0.25,24.75,625,0,50,25,0.25,0,25,625,0,25,0,0.25,25,0,-25,-24.75,-25,346.75733333333335,25,24.75,0.99,321.75733333333335,25,0
602,1.99,0.01,1,0.99,0.98,0.0,0.0,1.99,0.99,0.99,-0.01,0.99,0.99,0,0,1,1,0.01,1,1,0,0,0,-1,-0.99,0,0,-1,-0.99,0,0.992,1,0.99,0.99,0.992,0,0
603,1.99,0.01,625,618.75,612.56,0.0,0.0,49.75,24.75,24.75,-0.25,24.75,24.75,0,0,25,25,0.25,25,25,0,0,0,-25,-24.75,0,0,-25,-24.75,0,321.89866666666666,25,24.75,0.99,321.89866666666666,0,0
604,1.01,0.99,1,0.01,0.0,0.0,0.25,1.01,0.01,25.01,-0.99,0.01,-24.99,0,25,1,26,0.99,1,-24,0,0,25,-1,-0.01,-25,625,24,24.99,25,24.744,1,0.01,0.01,24.744,0,25
605,1.99,0.01,1,0.99,0.98,0.0,0.99,1.99,0.99,1.99,-0.01,0.99,-0.01,0,1,1,2,0.01,1,0,0,0,1,-1,-0.99,-1,1,0,0.01,1,1.0,1,0.99,0.99,1.0,0,1
606,1.99,0.01,625,618.75,612.56,618.75,0.0,49.75,49.75,24.75,-0.25,-0.25,24.75,625,0,50,25,0.25,0,25,625,0,25,0,0.25,25,0,-25,-24.75,-25,347.122,25,24.75,0.99,322.122,25,0
607,1.01,0.99,144,1.44,0.01,3.0,3.0,12.12,25.12,25.12,-11.88,-24.88,-24.88,300,300,37,37,11.88,-13,-13,625,625,50,13,24.88,0,625,13,24.88,0,322.718,12,0.12,0.01,297.718,25,25
608,1.99,0.01,1,0.99,0.98,0.0,0.0,1.99,0.99,0.99,-0.01,0.99,0.99,0,0,1,1,0.01,1,1,0,0,0,-1,-0.99,0,0,-1,-0.99,0,0.9913333333333333,1,0.99,0.99,0.9913333333333333,0,0
609,1.99,0.01,625,618.75,612.56,0.0,0.0,49.75,24.75,24.75,-0.25,24.75,24.75,0,0,25,25,0.25,25,25,0,0,0,-25,-24.75,0,0,-25,-24.75,0,321.768,25,24.75,0.99,321.768,0,0
610,1.99,0.01,169,167.31,165.64,321.75,321.75,25.87,37.87,37.87,-0.13,-12.13,-12.13,325,325,38,38,0.13,-12,-12,625,625,50,12,12.13,0,625,12,12.13,0,118.42333333333333,13,12.87,0.99,93.42333333333333,25,25
611,1.99,0.01,625,618.75,612.56,0.0,297.0,49.75,24.75,36.75,-0.25,24.75,12.75,0,300,25,37,0.25,25,13,0,0,12,-25,-24.75,-12,144,-13,-12.75,12,324.81333333333333,25,24.75,0.99,324.81333333333333,0,12
612,1.01,0.99,625,6.25,0.06,6.25,6.25,25.25,25.25,25.25,-24.75,-24.75,-24.75,625,625,50,50,24.75,0,0,625,625,50,0,24.75,0,625,0,24.75,0,647.2113333333333,25,0.25,0.01,622.2113333333333,25,25
613,1.99,0.01,169,167.31,165.64,0.0,321.75,25.87,12.87,37.87,-0.13,12.87,-12.13,0,325,13,38,0.13,13,-12,0,0,25,-13,-12.87,-25,625,12,12.13,25,93.29933333333334,13,12.87,0.99,93.29933333333334,0,25
614,1.99,0.01,625,618.75,612.56,0.0,618.75,49.75,24.75,49.75,-0.25,24.75,-0.25,0,625,25,50,0.25,25,0,0,0,25,-25,-24.75,-25,625,0,0.25,25,328.0106666666667,25,24.75,0.99,328.0106666666667,0,25
615,1.01,0.99,1,0.01,0.0,0.24,0.25,1.01,24.01,25.01,-0.99,-23.99,-24.99,24,25,25,26,0.99,-23,-24,576,600,49,23,23.99,-1,625,24,24.99,1,48.792,1,0.01,0.01,24.792,24,25
616,1.99,0.01,4,3.96,3.92,0.0,0.0,3.98,1.98,1.98,-0.02,1.98,1.98,0,0,2,2,0.02,2,2,0,0,0,-2,-1.98,0,0,-2,-1.98,0,2.966666666666667,2,1.98,0.99,2.966666666666667,0,0
617,1.99,0.01,1,0.99,0.98,0.0,0.0,1.99,0.99,0.99,-0.01,0.99,0.99,0,0,1,1,0.01,1,1,0,0,0,-1,-0.99,0,0,-1,-0.99,0,0.988,1,0.99,0.99,0.988,0,0
618,1.01,0.99,169,1.69,0.02,0.0,0.0,13.13,0.13,0.13,-12.87,0.13,0.13,0,0,13,13,12.87,13,13,0,0,0,-13,-0.13,0,0,-13,-0.13,0,0.878,13,0.13,0.01,0.878,0,0
619,1.99,0.01,1,0.99,0.98,0.0,24.75,1.99,0.99,25.99,-0.01,0.99,-24.01,0,25,1,26,0.01,1,-24,0,0,25,-1,-0.99,-25,625,24,24.01,25,1.176,1,0.99,0.99,1.176,0,25
620,1.01,0.99,1,0.01,0.0,0.0,0.0,1.01,0.01,0.01,-0.99,0.01,0.01,0,0,1,1,0.99,1,1,0,0,0,-1,-0.01,0,0,-1,-0.01,0,0.008,1,0.01,0.01,0.008,0,0
621,1.09,0.91,625,57.4,5.27,0.0,57.4,27.3,2.3,27.3,-22.7,2.3,-22.7,0,625,25,50,22.7,25,0,0,0,25,-25,-2.3,-25,625,0,22.7,25,597.2773333333333,25,2.3,0.09183458033420318,597.2773333333333,0,25
622,1.99,0.01,1,0.99,0.98,0.0,0.0,1.99,0.99,0.99,-0.01,0.99,0.99,0,0,1,1,0.01,1,1,0,0,0,-1,-0.99,0,0,-1,-0.99,0,0.9906666666666667,1,0.99,0.99,0.9906666666666667,0,0
623,1.99,0.01,625,618.75,612.56,0.0,0.0,49.75,24.75,24.75,-0.25,24.75,24.75,0,0,25,25,0.25,25,25,0,0,0,-25,-24.75,0,0,-25,-24.75,0,321.50733333333335,25,24.75,0.99,321.50733333333335,0,0
624,1.99,0.01,1,0.99,0.98,24.75,24.75,1.99,25.99,25.99,-0.01,-24.01,-24.01,25,25,26,26,0.01,-24,-24,625,625,50,24,24.01,0,625,24,24.01,0,26.176,1,0.99,0.99,1.1759999999999984,25,25
625,1.01,0.99,4,0.04,0.0,0.5,0.0,2.02,25.02,0.02,-1.98,-24.98,0.02,50,0,27,2,1.98,-23,2,625,0,25,23,24.98,25,0,-2,-0.02,-25,25.032666666666668,2,0.02,0.01,0.03266666666666751,25,0
626,1.99,0.01,1,0.99,0.98,24.75,0.0,1.99,25.99,0.99,-0.01,-24.01,0.99,25,0,26,1,0.01,-24,1,625,0,25,24,24.01,25,0,-1,-0.99,-25,25.994666666666667,1,0.99,0.99,0.9946666666666673,25,0
627,1.01,0.99,625,6.25,0.06,0.0,0.0,25.25,0.25,0.25,-24.75,0.25,0.25,0,0,25,25,24.75,25,25,0,0,0,-25,-0.25,0,0,-25,-0.25,0,3.138,25,0.25,0.01,3.138,0,0
628,1.01,0.99,1,0.01,0.0,0.24,0.25,1.01,24.01,25.01,-0.99,-23.99,-24.99,24,25,25,26,0.99,-23,-24,576,600,49,23,23.99,-1,625,24,24.99,1,48.728,1,0.01,0.01,24.728,24,25
629,1.99,0.01,4,3.96,3.92,0.0,0.0,3.98,1.98,1.98,-0.02,1.98,1.98,0,0,2,2,0.02,2,2,0,0,0,-2,-1.98,0,0,-2,-1.98,0,2.966,2,1.98,0.99,2.966,0,0
630,1.83,0.17,625,517.5,428.49,517.5,248.4,45.7,45.7,32.7,-4.3,-4.3,8.7,625,300,50,37,4.3,0,13,625,300,37,0,4.3,13,144,-13,-8.7,-13,346.1206666666667,25,20.7,0.827999775353927,321.1206666666667,25,12
631,1.99,0.01,625,618.75,612.56,0.0,618.75,49.75,24.75,49.75,-0.25,24.75,-0.25,0,625,25,50,0.25,25,0,0,0,25,-25,-24.75,-25,625,0,0.25,25,328.07533333333333,25,24.75,0.99,328.07533333333333,0,25
632,1.99,0.01,1,0.99,0.98,0.0,0.0,1.99,0.99,0.99,-0.01,0.99,0.99,0,0,1,1,0.01,1,1,0,0,0,-1,-0.99,0,0,-1,-0.99,0,0.9846666666666667,1,0.99,0.99,0.9846666666666667,0,0
633,1.01,0.99,625,6.25,0.06,0.0,0.0,25.25,0.25,0.25,-24.75,0.25,0.25,0,0,25,25,24.75,25,25,0,0,0,-25,-0.25,0,0,-25,-0.25,0,3.3893333333333335,25,0.25,0.01,3.3893333333333335,0,0
634,1.99,0.01,625,618.75,612.56,0.0,321.75,49.75,24.75,37.75,-0.25,24.75,11.75,0,325,25,38,0.25,25,12,0,0,13,-25,-24.75,-13,169,-12,-11.75,13,325.0013333333333,25,24.75,0.99,325.0013333333333,0,13
635,1.99,0.01,625,618.75,612.56,0.0,618.75,49.75,24.75,49.75,-0.25,24.75,-0.25,0,625,25,50,0.25,25,0,0,0,25,-25,-24.75,-25,625,0,0.25,25,327.888,25,24.75,0.99,327.888,0,25
636,1.01,0.99,169,1.69,0.02,3.25,3.25,13.13,25.13,25.13,-12.87,-24.87,-24.87,325,325,38,38,12.87,-12,-12,625,625,50,12,24.87,0,625,12,24.87,0,348.01,13,0.13,0.01000000168537027,323.01,25,25
637,1.99,0.01,625,618.75,612.56,618.75,321.75,49.75,49.75,37.75,-0.25,-0.25,11.75,625,325,50,38,0.25,0,12,625,325,38,0,0.25,12,169,-12,-11.75,-12,349.998,25,24.75,0.99,324.998,25,13
638,1.99,0.01,169,167.31,165.64,0.0,321.75,25.87,12.87,37.87,-0.13,12.87,-12.13,0,325,13,38,0.13,13,-12,0,0,25,-13,-12.87,-25,625,12,12.13,25,93.40666666666667,13,12.87,0.99,93.40666666666667,0,25
639,1.99,0.01,225,222.75,220.52,0.0,371.25,29.85,14.85,39.85,-0.15,14.85,-10.15,0,375,15,40,0.15,15,-10,0,0,25,-15,-14.85,-25,625,10,10.15,25,122.576,15,14.85,0.99,122.576,0,25
640,1.99,0.01,1,0.99,0.98,0.0,0.99,1.99,0.99,1.99,-0.01,0.99,-0.01,0,1,1,2,0.01,1,0,0,0,1,-1,-0.99,-1,1,0,0.01,1,1.0,1,0.99,0.99,1.0,0,1
641,1.99,0.01,625,618.75,612.56,618.75,0.0,49.75,49.75,24.75,-0.25,-0.25,24.75,625,0,50,25,0.25,0,25,625,0,25,0,0.25,25,0,-25,-24.75,-25,346.75733333333335,25,24.75,0.99,321.75733333333335,25,0
642,1.99,0.01,1,0.99,0.98,0.0,0.0,1.99,0.99,0.99,-0.01,0.99,0.99,0,0,1,1,0.01,1,1,0,0,0,-1,-0.99,0,0,-1,-0.99,0,0.992,1,0.99,0.99,0.992,0,0
643,1.99,0.01,625,618.75,612.56,0.0,0.0,49.75,24.75,24.75,-0.25,24.75,24.75,0,0,25,25,0.25,25,25,0,0,0,-25,-24.75,0,0,-25,-24.75,0,321.89866666666666,25,24.75,0.99,321.89866666666666,0,0
644,1.01,0.99,1,0.01,0.0,0.0,0.25,1.01,0.01,25.01,-0.99,0.01,-24.99,0,25,1,26,0.99,1,-24,0,0,25,-1,-0.01,-25,625,24,24.99,25,24.744,1,0.01,0.01,24.744,0,25
645,1.99,0.01,1,0.99,0.98,0.0,0.99,1.99,0.99,1.99,-0.01,0.99,-0.01,0,1,1,2,0.01,1,0,0,0,1,-1,-0.99,-1,1,0,0.01,1,1.0,1,0.99,0.99,1.0,0,1
646,1.99,0.01,625,618.75,612.56,618.75,0.0,49.75,49.75,24.75,-0.25,-0.25,24.75,625,0,50,25,0.25,0,25,625,0,25,0,0.25,25,0,-25,-24.75,-25,347.122,25,24.75,0.99,322.122,25,0
647,1.01,0.99,144,1.44,0.01,3.0,3.0,12.12,25.12,25.12,-11.88,-24.88,-24.88,300,300,37,37,11.88,-13,-13,625,625,50,13,24.88,0,625,13,24.88,0,322.718,12,0.12,0.01,297.718,25,25
648,1.99,0.01,1,0.99,0.98,0.0,0.0,1.99,0.99,0.99,-0.01,0.99,0.99,0,0,1,1,0.01,1,1,0,0,0,-1,-0.99,0,0,-1,-0.99,0,0.9913333333333333,1,0.99,0.99,0.9913333333333333,0,0
649,1.99,0.01,625,618.75,612.56,0.0,0.0,49.75,24.75,24.75,-0.25,24.75,24.75,0,0,25,25,0.25,25,25,0,0,0,-25,-24.75,0,0,-25,-24.75,0,321.768,25,24.75,0.99,321.768,0,0
650,1.99,0.01,169,167.31,165.64,321.75,321.75,25.87,37.87,37.87,-0.13,-12.13,-12.13,325,325,38,38,0.13,-12,-12,625,625,50,12,12.13,0,625,12,12.13,0,118.42333333333333,13,12.87,0.99,93.42333333333333,25,25
651,1.99,0.01,625,618.75,612.56,0.0,297.0,49.75,24.75,36.75,-0.25,24.75,12.75,0,300,25,37,0.25,25,13,0,0,12,-25,-24.75,-12,144,-13,-12.75,12,324.81333333333333,25,24.75,0.99,324.81333333333333,0,12
652,1.01,0.99,625,6.25,0.06,6.25,6.25,25.25,25.25,25.25,-24.75,-24.75,-24.75,625,625,50,50,24.75,0,0,625,625,50,0,24.75,0,625,0,24.75,0,647.2113333333333,25,0.25,0.01,622.2113333333333,25,25
653,1.99,0.01,169,167.31,165.64,0.0,321.75,25.87,12.87,37.87,-0.13,12.87,-12.13,0,325,13,38,0.13,13,-12,0,0,25,-13,-12.87,-25,625,12,12.13,25,93.29933333333334,13,12.87,0.99,93.29933333333334,0,25
654,1.99,0.01,625,618.75,612.56,0.0,618.75,49.75,24.75,49.75,-0.25,24.75,-0.25,0,625,25,50,0.25,25,0,0,0,25,-25,-24.75,-25,625,0,0.25,25,328.0106666666667,25,24.75,0.99,328.0106666666667,0,25
655,1.01,0.99,1,0.01,0.0,0.24,0.25,1.01,24.01,25.01,-0.99,-23.99,-24.99,24,25,25,26,0.99,-23,-24,576,600,49,23,23.99,-1,625,24,24.99,1,48.792,1,0.01,0.01,24.792,24,25
656,1.99,0.01,4,3.96,3.92,0.0,0.0,3.98,1.98,1.98,-0.02,1.98,1.98,0,0,2,2,0.02,2,2,0,0,0,-2,-1.98,0,0,-2,-1.98,0,2.966666666666667,2,1.98,0.99,2.966666666666667,0,0
657,1.99,0.01,1,0.99,0.98,0.0,0.0,1.99,0.99,0.99,-0.01,0.99,0.99,0,0,1,1,0.01,1,1,0,0,0,-1,-0.99,0,0,-1,-0.99,0,0.988,1,0.99,0.99,0.988,0,0
658,1.01,0.99,169,1.69,0.02,0.0,0.0,13.13,0.13,0.13,-12.87,0.13,0.13,0,0,13,13,12.87,13,13,0,0,0,-13,-0.13,0,0,-13,-0.13,0,0.878,13,0.13,0.01,0.878,0,0
659,1.99,0.01,1,0.99,0.98,0.0,24.75,1.99,0.99,25.99,-0.01,0.99,-24.01,0,25,1,26,0.01,1,-24,0,0,25,-1,-0.99,-25,625,24,24.01,25,1.176,1,0.99,0.99,1.176,0,25
660,1.01,0.99,1,0.01,0.0,0.0,0.0,1.01,0.01,0.01,-0.99,0.01,0.01,0,0,1,1,0.99,1,1,0,0,0,-1,-0.01,0,0,-1,-0.01,0,0.008,1,0.01,0.01,0.008,0,0
661,1.09,0.91,625,57.4,5.27,0.0,57.4,27.3,2.3,27.3,-22.7,2.3,-22.7,0,625,25,50,22.7,25,0,0,0,25,-25,-2.3,-25,625,0,22.7,25,597.2773333333333,25,2.3,0.09183458033420318,597.2773333333333,0,25
662,1.99,0.01,1,0.99,0.98,0.0,0.0,1.99,0.99,0.99,-0.01,0.99,0.99,0,0,1,1,0.01,1,1,0,0,0,-1,-0.99,0,0,-1,-0.99,0,0.9906666666666667,1,0.99,0.99,0.9906666666666667,0,0
663,1.99,0.01,625,618.75,612.56,0.0,0.0,49.75,24.75,24.75,-0.25,24.75,24.75,0,0,25,25,0.25,25,25,0,0,0,-25,-24.75,0,0,-25,-24.75,0,321.50733333333335,25,24.75,0.99,321.50733333333335,0,0
664,1.99,0.01,1,0.99,0.98,24.75,24.75,1.99,25.99,25.99,-0.01,-24.01,-24.01,25,25,26,26,0.01,-24,-24,625,625,50,24,24.01,0,625,24,24.01,0,26.176,1,0.99,0.99,1.1759999999999984,25,25
665,1.01,0.99,4,0.04,0.0,0.5,0.0,2.02,25.02,0.02,-1.98,-24.98,0.02,50,0,27,2,1.98,-23,2,625,0,25,23,24.98,25,0,-2,-0.02,-25,25.032666666666668,2,0.02,0.01,0.03266666666666751,25,0
666,1.99,0.01,1,0.99,0.98,24.75,0.0,1.99,25.99,0.99,-0.01,-24.01,0.99,25,0,26,1,0.01,-24,1,625,0,25,24,24.01,25,0,-1,-0.99,-25,25.994666666666667,1,0.99,0.99,0.9946666666666673,25,0
667,1.01,0.99,625,6.25,0.06,0.0,0.0,25.25,0.25,0.25,-24.75,0.25,0.25,0,0,25,25,24.75,25,25,0,0,0,-25,-0.25,0,0,-25,-0.25,0,3.138,25,0.25,0.01,3.138,0,0
668,1.01,0.99,1,0.01,0.0,0.24,0.25,1.01,24.01,25.01,-0.99,-23.99,-24.99,24,25,25,26,0.99,-23,-24,576,600,49,23,23.99,-1,625,24,24.99,1,48.728,1,0.01,0.01,24.728,24,25
669,1.99,0.01,4,3.96,3.92,0.0,0.0,3.98,1.98,1.98,-0.02,1.98,1.98,0,0,2,2,0.02,2,2,0,0,0,-2,-1.98,0,0,-2,-1.98,0,2.966,2,1.98,0.99,2.966,0,0
670,1.83,0.17,625,517.5,428.49,517.5,248.4,45.7,45.7,32.7,-4.3,-4.3,8.7,625,300,50,37,4.3,0,13,625,300,37,0,4.3,13,144,-13,-8.7,-13,346.1206666666667,25,20.7,0.827999775353927,321.1206666666667,25,12
671,1.99,0.01,625,618.75,612.56,0.0,618.75,49.75,24.75,49.75,-0.25,24.75,-0.25,0,625,25,50,0.25,25,0,0,0,25,-25,-24.75,-25,625,0,0.25,25,328.07533333333333,25,24.75,0.99,328.07533333333333,0,25
672,1.99,0.01,1,0.99,0.98,0.0,0.0,1.99,0.99,0.99,-0.01,0.99,0.99,0,0,1,1,0.01,1,1,0,0,0,-1,-0.99,0,0,-1,-0.99,0,0.9846666666666667,1,0.99,0.99,0.9846666666666667,0,0
673,1.01,0.99,625,6.25,0.06,0.0,0.0,25.25,0.25,0.25,-24.75,0.25,0.25,0,0,25,25,24.75,25,25,0,0,0,-25,-0.25,0,0,-25,-0.25,0,3.3893333333333335,25,0.25,0.01,3.3893333333333335,0,0
674,1.99,0.01,625,618.75,612.56,0.0,321.75,49.75,24.75,37.75,-0.25,24.75,11.75,0,325,25,38,0.25,25,12,0,0,13,-25,-24.75,-13,169,-12,-11.75,13,325.0013333333333,25,24.75,0.99,325.0013333333333,0,13
675,1.99,0.01,625,618.75,612.56,0.0,618.75,49.75,24.75,49.75,-0.25,24.75,-0.25,0,625,25,50,0.25,25,0,0,0,25,-25,-24.75,-25,625,0,0.25,25,327.888,25,24.75,0.99,327.888,0,25
676,1.01,0.99,169,1.69,0.02,3.25,3.25,13.13,25.13,25.13,-12.87,-24.87,-24.87,325,325,38,38,12.87,-12,-12,625,625,50,12,24.87,0,625,12,24.87,0,348.01,13,0.13,0.01000000168537027,323.01,25,25
677,1.99,0.01,625,618.75,612.56,618.75,321.75,49.75,49.75,37.75,-0.25,-0.25,11.75,625,325,50,38,0.25,0,12,625,325,38,0,0.25,12,169,-12,-11.75,-12,349.998,25,24.75,0.99,324.998,25,13
678,1.99,0.01,169,167.31,165.64,0.0,321.75,25.87,12.87,37.87,-0.13,12.87,-12.13,0,325,13,38,0.13,13,-12,0,0,25,-13,-12.87,-25,625,12,12.13,25,93.40666666666667,13,12.87,0.99,93.40666666666667,0,25
679,1.99,0.01,225,222.75,220.52,0.0,371.25,29.85,14.85,39.85,-0.15,14.85,-10.15,0,375,15,40,0.15,15,-10,0,0,25,-15,-14.85,-25,625,10,10.15,25,122.576,15,14.85,0.99,122.576,0,25
680,1.99,0.01,1,0.99,0.98,0.0,0.99,1.99,0.99,1.99,-0.01,0.99,-0.01,0,1,1,2,0.01,1,0,0,0,1,-1,-0.99,-1,1,0,0.01,1,1.0,1,0.99,0.99,1.0,0,1
681,1.99,0.01,625,618.75,612.56,618.75,0.0,49.75,49.75,24.75,-0.25,-0.25,24.75,625,0,50,25,0.25,0,25,625,0,25,0,0.25,25,0,-25,-24.75,-25,346.75733333333335,25,24.75,0.99,321.75733333333335,25,0
682,1.99,0.01,1,0.99,0.98,0.0,0.0,1.99,0.99,0.99,-0.01,0.99,0.99,0,0,1,1,0.01,1,1,0,0,0,-1,-0.99,0,0,-1,-0.99,0,0.992,1,0.99,0.99,0.992,0,0
683,1.99,0.01,625,618.75,612.56,0.0,0.0,49.75,24.75,24.75,-0.25,24.75,24.75,0,0,25,25,0.25,25,25,0,0,0,-25,-24.75,0,0,-25,-24.75,0,321.89866666666666,25,24.75,0.99,321.89866666666666,0,0
684,1.01,0.99,1,0.01,0.0,0.0,0.25,1.01,0.01,25.01,-0.99,0.01,-24.99,0,25,1,26,0.99,1,-24,0,0,25,-1,-0.01,-25,625,24,24.99,25,24.744,1,0.01,0.01,24.744,0,25
685,1.99,0.01,1,0.99,0.98,0.0,0.99,1.99,0.99,1.99,-0.01,0.99,-0.01,0,1,1,2,0.01,1,0,0,0,1,-1,-0.99,-1,1,0,0.01,1,1.0,1,0.99,0.99,1.0,0,1
686,1.99,0.01,625,618.75,612.56,618.75,0.0,49.75,49.75,24.75,-0.25,-0.25,24.75,625,0,50,25,0.25,0,25,625,0,25,0,0.25,25,0,-25,-24.75,-25,347.122,25,24.75,0.99,322.122,25,0
687,1.01,0.99,144,1.44,0.01,3.0,3.0,12.12,25.12,25.12,-11.88,-24.88,-24.88,300,300,37,37,11.88,-13,-13,625,625,50,13,24.88,0,625,13,24.88,0,322.718,12,0.12,0.01,297.718,25,25
688,1.99,0.01,1,0.99,0.98,0.0,0.0,1.99,0.99,0.99,-0.01,0.99,0.99,0,0,1,1,0.01,1,1,0,0,0,-1,-0.99,0,0,-1,-0.99,0,0.9913333333333333,1,0.99,0.99,0.9913333333333333,0,0
689,1.99,0.01,625,618.75,612.56,0.0,0.0,49.75,24.75,24.75,-0.25,24.75,24.75,0,0,25,25,0.25,25,25,0,0,0,-25,-24.75,0,0,-25,-24.75,0,321.768,25,24.75,0.99,321.768,0,0
690,1.99,0.01,169,167.31,165.64,321.75,321.75,25.87,37.87,37.87,-0.13,-12.13,-12.13,325,325,38,38,0.13,-12,-12,625,625,50,12,12.13,0,625,12,12.13,0,118.42333333333333,13,12.87,0.99,93.42333333333333,25,25
691,1.99,0.01,625,618.75,612.56,0.0,297.0,49.75,24.75,36.75,-0.25,24.75,12.75,0,300,25,37,0.25,25,13,0,0,12,-25,-24.75,-12,144,-13,-12.75,12,324.81333333333333,25,24.75,0.99,324.81333333333333,0,12
692,1.01,0.99,625,6.25,0.06,6.25,6.25,25.25,25.25,25.25,-24.75,-24.75,-24.75,625,625,50,50,24.75,0,0,625,625,50,0,24.75,0,625,0,24.75,0,647.2113333333333,25,0.25,0.01,622.2113333333333,25,25
693,1.99,0.01,169,167.31,165.64,0.0,321.75,25.87,12.87,37.87,-0.13,12.87,-12.13,0,325,13,38,0.13,13,-12,0,0,25,-13,-12.87,-25,625,12,12.13,25,93.29933333333334,13,12.87,0.99,93.29933333333334,0,25
694,1.99,0.01,625,618.75,612.56,0.0,618.75,49.75,24.75,49.75,-0.25,24.75,-0.25,0,625,25,50,0.25,25,0,0,0,25,-25,-24.75,-25,625,0,0.25,25,328.0106666666667,25,24.75,0.99,328.0106666666667,0,25
695,1.01,0.99,1,0.01,0.0,0.24,0.25,1.01,24.01,25.01,-0.99,-23.99,-24.99,24,25,25,26,0.99,-23,-24,576,600,49,23,23.99,-1,625,24,24.99,1,48.792,1,0.01,0.01,24.792,24,25
696,1.99,0.01,4,3.96,3.92,0.0,0.0,3.98,1.98,1.98,-0.02,1.98,1.98,0,0,2,2,0.02,2,2,0,0,0,-2,-1.98,0,0,-2,-1.98,0,2.966666666666667,2,1.98,0.99,2.966666666666667,0,0
697,1.99,0.01,1,0.99,0.98,0.0,0.0,1.99,0.99,0.99,-0.01,0.99,0.99,0,0,1,1,0.01,1,1,0,0,0,-1,-0.99,0,0,-1,-0.99,0,0.988,1,0.99,0.99,0.988,0,0
698,1.01,0.99,169,1.69,0.02,0.0,0.0,13.13,0.13,0.13,-12.87,0.13,0.13,0,0,13,13,12.87,13,13,0,0,0,-13,-0.13,0,0,-13,-0.13,0,0.878,13,0.13,0.01,0.878,0,0
699,1.99,0.01,1,0.99,0.98,0.0,24.75,1.99,0.99,25.99,-0.01,0.99,-24.01,0,25,1,26,0.01,1,-24,0,0,25,-1,-0.99,-25,625,24,24.01,25,1.176,1,0.99,0.99,1.176,0,25
700,1.01,0.99,1,0.01,0.0,0.0,0.0,1.01,0.01,0.01,-0.99,0.01,0.01,0,0,1,1,0.99,1,1,0,0,0,-1,-0.01,0,0,-1,-0.01,0,0.008,1,0.01,0.01,0.008,0,0
701,1.09,0.91,625,57.4,5.27,0.0,57.4,27.3,2.3,27.3,-22.7,2.3,-22.7,0,625,25,50,22.7,25,0,0,0,25,-25,-2.3,-25,625,0,22.7,25,597.2773333333333,25,2.3,0.09183458033420318,597.2773333333333,0,25
702,1.99,0.01,1,0.99,0.98,0.0,0.0,1.99,0.99,0.99,-0.01,0.99,0.99,0,0,1,1,0.01,1,1,0,0,0,-1,-0.99,0,0,-1,-0.99,0,0.9906666666666667,1,0.99,0.99,0.9906666666666667,0,0
703,1.99,0.01,625,618.75,612.56,0.0,0.0,49.75,24.75,24.75,-0.25,24.75,24.75,0,0,25,25,0.25,25,25,0,0,0,-25,-24.75,0,0,-25,-24.75,0,321.50733333333335,25,24.75,0.99,321.50733333333335,0,0
704,1.99,0.01,1,0.99,0.98,24.75,24.75,1.99,25.99,25.99,-0.01,-24.01,-24.01,25,25,26,26,0.01,-24,-24,625,625,50,24,24.01,0,625,24,24.01,0,26.176,1,0.99,0.99,1.1759999999999984,25,25
705,1.01,0.99,4,0.04,0.0,0.5,0.0,2.02,25.02,0.02,-1.98,-24.98,0.02,50,0,27,2,1.98,-23,2,625,0,25,23,24.98,25,0,-2,-0.02,-25,25.032666666666668,2,0.02,0.01,0.03266666666666751,25,0
706,1.99,0.01,1,0.99,0.98,24.75,0.0,1.99,25.99,0.99,-0.01,-24.01,0.99,25,0,26,1,0.01,-24,1,625,0,25,24,24.01,25,0,-1,-0.99,-25,25.994666666666667,1,0.99,0.99,0.9946666666666673,25,0
707,1.01,0.99,625,6.25,0.06,0.0,0.0,25.25,0.25,0.25,-24.75,0.25,0.25,0,0,25,25,24.75,25,25,0,0,0,-25,-0.25,0,0,-25,-0.25,0,3.138,25,0.25,0.01,3.138,0,0
708,1.01,0.99,1,0.01,0.0,0.24,0.25,1.01,24.01,25.01,-0.99,-23.99,-24.99,24,25,25,26,0.99,-23,-24,576,600,49,23,23.99,-1,625,24,24.99,1,48.728,1,0.01,0.01,24.728,24,25
709,1.99,0.01,4,3.96,3.92,0.0,0.0,3.98,1.98,1.98,-0.02,1.98,1.98,0,0,2,2,0.02,2,2,0,0,0,-2,-1.98,0,0,-2,-1.98,0,2.966,2,1.98,0.99,2.966,0,0
710,1.83,0.17,625,517.5,428.49,517.5,248.4,45.7,45.7,32.7,-4.3,-4.3,8.7,625,300,50,37,4.3,0,13,625,300,37,0,4.3,13,144,-13,-8.7,-13,346.1206666666667,25,20.7,0.827999775353927,321.1206666666667,25,12
711,1.99,0.01,625,618.75,612.56,0.0,618.75,49.75,24.75,49.75,-0.25,24.75,-0.25,0,625,25,50,0.25,25,0,0,0,25,-25,-24.75,-25,625,0,0.25,25,328.07533333333333,25,24.75,0.99,328.07533333333333,0,25
712,1.99,0.01,1,0.99,0.98,0.0,0.0,1.99,0.99,0.99,-0.01,0.99,0.99,0,0,1,1,0.01,1,1,0,0,0,-1,-0.99,0,0,-1,-0.99,0,0.9846666666666667,1,0.99,0.99,0.9846666666666667,0,0
713,1.01,0.99,625,6.25,0.06,0.0,0.0,25.25,0.25,0.25,-24.75,0.25,0.25,0,0,25,25,24.75,25,25,0,0,0,-25,-0.25,0,0,-25,-0.25,0,3.3893333333333335,25,0.25,0.01,3.3893333333333335,0,0
714,1.99,0.01,625,618.75,612.56,0.0,321.75,49.75,24.75,37.75,-0.25,24.75,11.75,0,325,25,38,0.25,25,12,0,0,13,-25,-24.75,-13,169,-12,-11.75,13,325.0013333333333,25,24.75,0.99,325.0013333333333,0,13
715,1.99,0.01,625,618.75,612.56,0.0,618.75,49.75,24.75,49.75,-0.25,24.75,-0.25,0,625,25,50,0.25,25,0,0,0,25,-25,-24.75,-25,625,0,0.25,25,327.888,25,24.75,0.99,327.888,0,25
716,1.01,0.99,169,1.69,0.02,3.25,3.25,13.13,25.13,25.13,-12.87,-24.87,-24.87,325,325,38,38,12.87,-12,-12,625,625,50,12,24.87,0,625,12,24.87,0,348.01,13,0.13,0.01000000168537027,323.01,25,25
717,1.99,0.01,625,618.75,612.56,618.75,321.75,49.75,49.75,37.75,-0.25,-0.25,11.75,625,325,50,38,0.25,0,12,625,325,38,0,0.25,12,169,-12,-11.75,-12,349.998,25,24.75,0.99,324.998,25,13
718,1.99,0.01,169,167.31,165.64,0.0,321.75,25.87,12.87,37.87,-0.13,12.87,-12.13,0,325,13,38,0.13,13,-12,0,0,25,-13,-12.87,-25,625,12,12.13,25,93.40666666666667,13,12.87,0.99,93.40666666666667,0,25
719,1.99,0.01,225,222.75,220.52,0.0,371.25,29.85,14.85,39.85,-0.15,14.85,-10.15,0,375,15,40,0.15,15,-10,0,0,25,-15,-14.85,-25,625,10,10.15,25,122.576,15,14.85,0.99,122.576,0,25
720,1.99,0.01,1,0.99,0.98,0.0,0.99,1.99,0.99,1.99,-0.01,0.99,-0.01,0,1,1,2,0.01,1,0,0,0,1,-1,-0.99,-1,1,0,0.01,1,1.0,1,0.99,0.99,1.0,0,1
721,1.99,0.01,625,618.75,612.56,618.75,0.0,49.75,49.75,24.75,-0.25,-0.25,24.75,625,0,50,25,0.25,0,25,625,0,25,0,0.25,25,0,-25,-24.75,-25,346.75733333333335,25,24.75,0.99,321.75733333333335,25,0
722,1.99,0.01,1,0.99,0.98,0.0,0.0,1.99,0.99,0.99,-0.01,0.99,0.99,0,0,1,1,0.01,1,1,0,0,0,-1,-0.99,0,0,-1,-0.99,0,0.992,1,0.99,0.99,0.992,0,0
723,1.99,0.01,625,618.75,612.56,0.0,0.0,49.75,24.75,24.75,-0.25,24.75,24.75,0,0,25,25,0.25,25,25,0,0,0,-25,-24.75,0,0,-25,-24.75,0,321.89866666666666,25,24.75,0.99,321.89866666666666,0,0
724,1.01,0.99,1,0.01,0.0,0.0,0.25,1.01,0.01,25.01,-0.99,0.01,-24.99,0,25,1,26,0.99,1,-24,0,0,25,-1,-0.01,-25,625,24,24.99,25,24.744,1,0.01,0.01,24.744,0,25
725,1.99,0.01,1,0.99,0.98,0.0,0.99,1.99,0.99,1.99,-0.01,0.99,-0.01,0,1,1,2,0.01,1,0,0,0,1,-1,-0.99,-1,1,0,0.01,1,1.0,1,0.99,0.99,1.0,0,1
726,1.99,0.01,625,618.75,612.56,618.75,0.0,49.75,49.75,24.75,-0.25,-0.25,24.75,625,0,50,25,0.25,0,25,625,0,25,0,0.25,25,0,-25,-24.75,-25,347.122,25,24.75,0.99,322.122,25,0
727,1.01,0.99,144,1.44,0.01,3.0,3.0,12.12,25.12,25.12,-11.88,-24.88,-24.88,300,300,37,37,11.88,-13,-13,625,625,50,13,24.88,0,625,13,24.88,0,322.718,12,0.12,0.01,297.718,25,25
728,1.99,0.01,1,0.99,0.98,0.0,0.0,1.99,0.99,0.99,-0.01,0.99,0.99,0,0,1,1,0.01,1,1,0,0,0,-1,-0.99,0,0,-1,-0.99,0,0.9913333333333333,1,0.99,0.99,0.9913333333333333,0,0
729,1.99,0.01,625,618.75,612.56,0.0,0.0,49.75,24.75,24.75,-0.25,24.75,24.75,0,0,25,25,0.25,25,25,0,0,0,-25,-24.75,0,0,-25,-24.75,0,321.768,25,24.75,0.99,321.768,0,0
730,1.99,0.01,169,167.31,165.64,321.75,321.75,25.87,37.87,37.87,-0.13,-12.13,-12.13,325,325,38,38,0.13,-12,-12,625,625,50,12,12.13,0,625,12,12.13,0,118.42333333333333,13,12.87,0.99,93.42333333333333,25,25
731,1.99,0.01,625,618.75,612.56,0.0,297.0,49.75,24.75,36.75,-0.25,24.75,12.75,0,300,25,37,0.25,25,13,0,0,12,-25,-24.75,-12,144,-13,-12.75,12,324.81333333333333,25,24.75,0.99,324.81333333333333,0,12
732,1.01,0.99,625,6.25,0.06,6.25,6.25,25.25,25.25,25.25,-24.75,-24.75,-24.75,625,625,50,50,24.75,0,0,625,625,50,0,24.75,0,625,0,24.75,0,647.2113333333333,25,0.25,0.01,622.2113333333333,25,25
733,1.99,0.01,169,167.31,165.64,0.0,321.75,25.87,12.87,37.87,-0.13,12.87,-12.13,0,325,13,38,0.13,13,-12,0,0,25,-13,-12.87,-25,625,12,12.13,25,93.29933333333334,13,12.87,0.99,93.29933333333334,0,25
734,1.99,0.01,625,618.75,612.56,0.0,618.75,49.75,24.75,49.75,-0.25,24.75,-0.25,0,625,25,50,0.25,25,0,0,0,25,-25,-24.75,-25,625,0,0.25,25,328.0106666666667,25,24.75,0.99,328.0106666666667,0,25
735,1.01,0.99,1,0.01,0.0,0.24,0.25,1.01,24.01,25.01,-0.99,-23.99,-24.99,24,25,25,26,0.99,-23,-24,576,600,49,23,23.99,-1,625,24,24.99,1,48.792,1,0.01,0.01,24.792,24,25
736,1.99,0.01,4,3.96,3.92,0.0,0.0,3.98,1.98,1.98,-0.02,1.98,1.98,0,0,2,2,0.02,2,2,0,0,0,-2,-1.98,0,0,-2,-1.98,0,2.966666666666667,2,1.98,0.99,2.966666666666667,0,0
737,1.99,0.01,1,0.99,0.98,0.0,0.0,1.99,0.99,0.99,-0.01,0.99,0.99,0,0,1,1,0.01,1,1,0,0,0,-1,-0.99,0,0,-1,-0.99,0,0.988,1,0.99,0.99,0.988,0,0
738,1.01,0.99,169,1.69,0.02,0.0,0.0,13.13,0.13,0.13,-12.87,0.13,0.13,0,0,13,13,12.87,13,13,0,0,0,-13,-0.13,0,0,-13,-0.13,0,0.878,13,0.13,0.01,0.878,0,0
739,1.99,0.01,1,0.99,0.98,0.0,24.75,1.99,0.99,25.99,-0.01,0.99,-24.01,0,25,1,26,0.01,1,-24,0,0,25,-1,-0.99,-25,625,24,24.01,25,1.176,1,0.99,0.99,1.176,0,25
740,1.01,0.99,1,0.01,0.0,0.0,0.0,1.01,0.01,0.01,-0.99,0.01,0.01,0,0,1,1,0.99,1,1,0,0,0,-1,-0.01,0,0,-1,-0.01,0,0.008,1,0.01,0.01,0.008,0,0
741,1.09,0.91,625,57.4,5.27,0.0,57.4,27.3,2.3,27.3,-22.7,2.3,-22.7,0,625,25,50,22.7,25,0,0,0,25,-25,-2.3,-25,625,0,22.7,25,597.2773333333333,25,2.3,0.09183458033420318,597.2773333333333,0,25
742,1.99,0.01,1,0.99,0.98,0.0,0.0,1.99,0.99,0.99,-0.01,0.99,0.99,0,0,1,1,0.01,1,1,0,0,0,-1,-0.99,0,0,-1,-0.99,0,0.9906666666666667,1,0.99,0.99,0.9906666666666667,0,0
743,1.99,0.01,625,618.75,612.56,0.0,0.0,49.75,24.75,24.75,-0.25,24.75,24.75,0,0,25,25,0.25,25,25,0,0,0,-25,-24.75,0,0,-25,-24.75,0,321.50733333333335,25,24.75,0.99,321.50733333333335,0,0
744,1.99,0.01,1,0.99,0.98,24.75,24.75,1.99,25.99,25.99,-0.01,-24.01,-24.01,25,25,26,26,0.01,-24,-24,625,625,50,24,24.01,0,625,24,24.01,0,26.176,1,0.99,0.99,1.1759999999999984,25,25
745,1.01,0.99,4,0.04,0.0,0.5,0.0,2.02,25.02,0.02,-1.98,-24.98,0.02,50,0,27,2,1.98,-23,2,625,0,25,23,24.98,25,0,-2,-0.02,-25,25.032666666666668,2,0.02,0.01,0.03266666666666751,25,0
746,1.99,0.01,1,0.99,0.98,24.75,0.0,1.99,25.99,0.99,-0.01,-24.01,0.99,25,0,26,1,0.01,-24,1,625,0,25,24,24.01,25,0,-1,-0.99,-25,25.994666666666667,1,0.99,0.99,0.9946666666666673,25,0
747,1.01,0.99,625,6.25,0.06,0.0,0.0,25.25,0.25,0.25,-24.75,0.25,0.25,0,0,25,25,24.75,25,25,0,0,0,-25,-0.25,0,0,-25,-0.25,0,3.138,25,0.25,0.01,3.138,0,0
748,1.01,0.99,1,0.01,0.0,0.24,0.25,1.01,24.01,25.01,-0.99,-23.99,-24.99,24,25,25,26,0.99,-23,-24,576,600,49,23,23.99,-1,625,24,24.99,1,48.728,1,0.01,0.01,24.728,24,25
749,1.99,0.01,4,3.96,3.92,0.0,0.0,3.98,1.98,1.98,-0.02,1.98,1.98,0,0,2,2,0.02,2,2,0,0,0,-2,-1.98,0,0,-2,-1.98,0,2.966,2,1.98,0.99,2.966,0,0
750,1.83,0.17,625,517.5,428.49,517.5,248.4,45.7,45.7,32.7,-4.3,-4.3,8.7,625,300,50,37,4.3,0,13,625,300,37,0,4.3,13,144,-13,-8.7,-13,346.1206666666667,25,20.7,0.827999775353927,321.1206666666667,25,12
751,1.99,0.01,625,618.75,612.56,0.0,618.75,49.75,24.75,49.75,-0.25,24.75,-0.25,0,625,25,50,0.25,25,0,0,0,25,-25,-24.75,-25,625,0,0.25,25,328.07533333333333,25,24.75,0.99,328.07533333333333,0,25
752,1.99,0.01,1,0.99,0.98,0.0,0.0,1.99,0.99,0.99,-0.01,0.99,0.99,0,0,1,1,0.01,1,1,0,0,0,-1,-0.99,0,0,-1,-0.99,0,0.9846666666666667,1,0.99,0.99,0.9846666666666667,0,0
753,1.01,0.99,625,6.25,0.06,0.0,0.0,25.25,0.25,0.25,-24.75,0.25,0.25,0,0,25,25,24.75,25,25,0,0,0,-25,-0.25,0,0,-25,-0.25,0,3.3893333333333335,25,0.25,0.01,3.3893333333333335,0,0
754,1.99,0.01,625,618.75,612.56,0.0,321.75,49.75,24.75,37.75,-0.25,24.75,11.75,0,325,25,38,0.25,25,12,0,0,13,-25,-24.75,-13,169,-12,-11.75,13,325.0013333333333,25,24.75,0.99,325.0013333333333,0,13
755,1.99,0.01,625,618.75,612.56,0.0,618.75,49.75,24.75,49.75,-0.25,24.75,-0.25,0,625,25,50,0.25,25,0,0,0,25,-25,-24.75,-25,625,0,0.25,25,327.888,25,24.75,0.99,327.888,0,25
756,1.01,0.99,169,1.69,0.02,3.25,3.25,13.13,25.13,25.13,-12.87,-24.87,-24.87,325,325,38,38,12.87,-12,-12,625,625,50,12,24.87,0,625,12,24.87,0,348.01,13,0.13,0.01000000168537027,323.01,25,25
757,1.99,0.01,625,618.75,612.56,618.75,321.75,49.75,49.75,37.75,-0.25,-0.25,11.75,625,325,50,38,0.25,0,12,625,325,38,0,0.25,12,169,-12,-11.75,-12,349.998,25,24.75,0.99,324.998,25,13
758,1.99,0.01,169,167.31,165.64,0.0,321.75,25.87,12.87,37.87,-0.13,12.87,-12.13,0,325,13,38,0.13,13,-12,0,0,25,-13,-12.87,-25,625,12,12.13,25,93.40666666666667,13,12.87,0.99,93.40666666666667,0,25
759,1.99,0.01,225,222.75,220.52,0.0,371.25,29.85,14.85,39.85,-0.15,14.85,-10.15,0,375,15,40,0.15,15,-10,0,0,25,-15,-14.85,-25,625,10,10.15,25,122.576,15,14.85,0.99,122.576,0,25
760,1.99,0.01,1,0.99,0.98,0.0,0.99,1.99,0.99,1.99,-0.01,0.99,-0.01,0,1,1,2,0.01,1,0,0,0,1,-1,-0.99,-1,1,0,0.01,1,1.0,1,0.99,0.99,1.0,0,1
761,1.99,0.01,625,618.75,612.56,618.75,0.0,49.75,49.75,24.75,-0.25,-0.25,24.75,625,0,50,25,0.25,0,25,625,0,25,0,0.25,25,0,-25,-24.75,-25,346.75733333333335,25,24.75,0.99,321.75733333333335,25,0
762,1.99,0.01,1,0.99,0.98,0.0,0.0,1.99,0.99,0.99,-0.01,0.99,0.99,0,0,1,1,0.01,1,1,0,0,0,-1,-0.99,0,0,-1,-0.99,0,0.992,1,0.99,0.99,0.992,0,0
763,1.99,0.01,625,618.75,612.56,0.0,0.0,49.75,24.75,24.75,-0.25,24.75,24.75,0,0,25,25,0.25,25,25,0,0,0,-25,-24.75,0,0,-25,-24.75,0,321.89866666666666,25,24.75,0.99,321.89866666666666,0,0
764,1.01,0.99,1,0.01,0.0,0.0,0.25,1.01,0.01,25.01,-0.99,0.01,-24.99,0,25,1,26,0.99,1,-24,0,0,25,-1,-0.01,-25,625,24,24.99,25,24.744,1,0.01,0.01,24.744,0,25
765,1.99,0.01,1,0.99,0.98,0.0,0.99,1.99,0.99,1.99,-0.01,0.99,-0.01,0,1,1,2,0.01,1,0,0,0,1,-1,-0.99,-1,1,0,0.01,1,1.0,1,0.99,0.99,1.0,0,1
766,1.99,0.01,625,618.75,612.56,618.75,0.0,49.75,49.75,24.75,-0.25,-0.25,24.75,625,0,50,25,0.25,0,25,625,0,25,0,0.25,25,0,-25,-24.75,-25,347.122,25,24.75,0.99,322.122,25,0
767,1.01,0.99,144,1.44,0.01,3.0,3.0,12.12,25.12,25.12,-11.88,-24.88,-24.88,300,300,37,37,11.88,-13,-13,625,625,50,13,24.88,0,625,13,24.88,0,322.718,12,0.12,0.01,297.718,25,25
768,1.99,0.01,1,0.99,0.98,0.0,0.0,1.99,0.99,0.99,-0.01,0.99,0.99,0,0,1,1,0.01,1,1,0,0,0,-1,-0.99,0,0,-1,-0.99,0,0.9913333333333333,1,0.99,0.99,0.9913333333333333,0,0
769,1.99,0.01,625,618.75,612.56,0.0,0.0,49.75,24.75,24.75,-0.25,24.75,24.75,0,0,25,25,0.25,25,25,0,0,0,-25,-24.75,0,0,-25,-24.75,0,321.768,25,24.75,0.99,321.768,0,0
770,1.99,0.01,169,167.31,165.64,321.75,321.75,25.87,37.87,37.87,-0.13,-12.13,-12.13,325,325,38,38,0.13,-12,-12,625,625,50,12,12.13,0,625,12,12.13,0,118.42333333333333,13,12.87,0.99,93.42333333333333,25,25
771,1.99,0.01,625,618.75,612.56,0.0,297.0,49.75,24.75,36.75,-0.25,24.75,12.75,0,300,25,37,0.25,25,13,0,0,12,-25,-24.75,-12,144,-13,-12.75,12,324.81333333333333,25,24.75,0.99,324.81333333333333,0,12
772,1.01,0.99,625,6.25,0.06,6.25,6.25,25.25,25.25,25.25,-24.75,-24.75,-24.75,625,625,50,50,24.75,0,0,625,625,50,0,24.75,0,625,0,24.75,0,647.2113333333333,25,0.25,0.01,622.2113333333333,25,25
773,1.99,0.01,169,167.31,165.64,0.0,321.75,25.87,12.87,37.87,-0.13,12.87,-12.13,0,325,13,38,0.13,13,-12,0,0,25,-13,-12.87,-25,625,12,12.13,25,93.29933333333334,13,12.87,0.99,93.29933333333334,0,25
774,1.99,0.01,625,618.75,612.56,0.0,618.75,49.75,24.75,49.75,-0.25,24.75,-0.25,0,625,25,50,0.25,25,0,0,0,25,-25,-24.75,-25,625,0,0.25,25,328.0106666666667,25,24.75,0.99,328.0106666666667,0,25
775,1.01,0.99,1,0.01,0.0,0.24,0.25,1.01,24.01,25.01,-0.99,-23.99,-24.99,24,25,25,26,0.99,-23,-24,576,600,49,23,23.99,-1,625,24,24.99,1,48.792,1,0.01,0.01,24.792,24,25
776,1.99,0.01,4,3.96,3.92,0.0,0.0,3.98,1.98,1.98,-0.02,1.98,1.98,0,0,2,2,0.02,2,2,0,0,0,-2,-1.98,0,0,-2,-1.98,0,2.966666666666667,2,1.98,0.99,2.966666666666667,0,0
777,1.99,0.01,1,0.99,0.98,0.0,0.0,1.99,0.99,0.99,-0.01,0.99,0.99,0,0,1,1,0.01,1,1,0,0,0,-1,-0.99,0,0,-1,-0.99,0,0.988,1,0.99,0.99,0.988,0,0
778,1.01,0.99,169,1.69,0.02,0.0,0.0,13.13,0.13,0.13,-12.87,0.13,0.13,0,0,13,13,12.87,13,13,0,0,0,-13,-0.13,0,0,-13,-0.13,0,0.878,13,0.13,0.01,0.878,0,0
779,1.99,0.01,1,0.99,0.98,0.0,24.75,1.99,0.99,25.99,-0.01,0.99,-24.01,0,25,1,26,0.01,1,-24,0,0,25,-1,-0.99,-25,625,24,24.01,25,1.176,1,0.99,0.99,1.176,0,25
780,1.01,0.99,1,0.01,0.0,0.0,0.0,1.01,0.01,0.01,-0.99,0.01,0.01,0,0,1,1,0.99,1,1,0,0,0,-1,-0.01,0,0,-1,-0.01,0,0.008,1,0.01,0.01,0.008,0,0
781,1.09,0.91,625,57.4,5.27,0.0,57.4,27.3,2.3,27.3,-22.7,2.3,-22.7,0,625,25,50,22.7,25,0,0,0,25,-25,-2.3,-25,625,0,22.7,25,597.2773333333333,25,2.3,0.09183458033420318,597.2773333333333,0,25
782,1.99,0.01,1,0.99,0.98,0.0,0.0,1.99,0.99,0.99,-0.01,0.99,0.99,0,0,1,1,0.01,1,1,0,0,0,-1,-0.99,0,0,-1,-0.99,0,0.9906666666666667,1,0.99,0.99,0.9906666666666667,0,0
783,1.99,0.01,625,618.75,612.56,0.0,0.0,49.75,24.75,24.75,-0.25,24.75,24.75,0,0,25,25,0.25,25,25,0,0,0,-25,-24.75,0,0,-25,-24.75,0,321.50733333333335,25,24.75,0.99,321.50733333333335,0,0
784,1.99,0.01,1,0.99,0.98,24.75,24.75,1.99,25.99,25.99,-0.01,-24.01,-24.01,25,25,26,26,0.01,-24,-24,625,625,50,24,24.01,0,625,24,24.01,0,26.176,1,0.99,0.99,1.1759999999999984,25,25
785,1.01,0.99,4,0.04,0.0,0.5,0.0,2.02,25.02,0.02,-1.98,-24.98,0.02,50,0,27,2,1.98,-23,2,625,0,25,23,24.98,25,0,-2,-0.02,-25,25.032666666666668,2,0.02,0.01,0.03266666666666751,25,0
786,1.99,0.01,1,0.99,0.98,24.75,0.0,1.99,25.99,0.99,-0.01,-24.01,0.99,25,0,26,1,0.01,-24,1,625,0,25,24,24.01,25,0,-1,-0.99,-25,25.994666666666667,1,0.99,0.99,0.9946666666666673,25,0
787,1.01,0.99,625,6.25,0.06,0.0,0.0,25.25,0.25,0.25,-24.75,0.25,0.25,0,0,25,25,24.75,25,25,0,0,0,-25,-0.25,0,0,-25,-0.25,0,3.138,25,0.25,0.01,3.138,0,0
788,1.01,0.99,1,0.01,0.0,0.24,0.25,1.01,24.01,25.01,-0.99,-23.99,-24.99,24,25,25,26,0.99,-23,-24,576,600,49,23,23.99,-1,625,24,24.99,1,48.728,1,0.01,0.01,24.728,24,25
789,1.99,0.01,4,3.96,3.92,0.0,0.0,3.98,1.98,1.98,-0.02,1.98,1.98,0,0,2,2,0.02,2,2,0,0,0,-2,-1.98,0,0,-2,-1.98,0,2.966,2,1.98,0.99,2.966,0,0
790,1.83,0.17,625,517.5,428.49,517.5,248.4,45.7,45.7,32.7,-4.3,-4.3,8.7,625,300,50,37,4.3,0,13,625,300,37,0,4.3,13,144,-13,-8.7,-13,346.1206666666667,25,20.7,0.827999775353927,321.1206666666667,25,12
791,1.99,0.01,625,618.75,612.56,0.0,618.75,49.75,24.75,49.75,-0.25,24.75,-0.25,0,625,25,50,0.25,25,0,0,0,25,-25,-24.75,-25,625,0,0.25,25,328.07533333333333,25,24.75,0.99,328.07533333333333,0,25
792,1.99,0.01,1,0.99,0.98,0.0,0.0,1.99,0.99,0.99,-0.01,0.99,0.99,0,0,1,1,0.01,1,1,0,0,0,-1,-0.99,0,0,-1,-0.99,0,0.9846666666666667,1,0.99,0.99,0.9846666666666667,0,0
793,1.01,0.99,625,6.25,0.06,0.0,0.0,25.25,0.25,0.25,-24.75,0.25,0.25,0,0,25,25,24.75,25,25,0,0,0,-25,-0.25,0,0,-25,-0.25,0,3.3893333333333335,25,0.25,0.01,3.3893333333333335,0,0
794,1.99,0.01,625,618.75,612.56,0.0,321.75,49.75,24.75,37.75,-0.25,24.75,11.75,0,325,25,38,0.25,25,12,0,0,13,-25,-24.75,-13,169,-12,-11.75,13,325.0013333333333,25,24.75,0.99,325.0013333333333,0,13
795,1.99,0.01,625,618.75,612.56,0.0,618.75,49.75,24.75,49.75,-0.25,24.75,-0.25,0,625,25,50,0.25,25,0,0,0,25,-25,-24.75,-25,625,0,0.25,25,327.888,25,24.75,0.99,327.888,0,25
796,1.01,0.99,169,1.69,0.02,3.25,3.25,13.13,25.13,25.13,-12.87,-24.87,-24.87,325,325,38,38,12.87,-12,-12,625,625,50,12,24.87,0,625,12,24.87,0,348.01,13,0.13,0.01000000168537027,323.01,25,25
797,1.99,0.01,625,618.75,612.56,618.75,321.75,49.75,49.75,37.75,-0.25,-0.25,11.75,625,325,50,38,0.25,0,12,625,325,38,0,0.25,12,169,-12,-11.75,-12,349.998,25,24.75,0.99,324.998,25,13
798,1.99,0.01,169,167.31,165.64,0.0,321.75,25.87,12.87,37.87,-0.13,12.87,-12.13,0,325,13,38,0.13,13,-12,0,0,25,-13,-12.87,-25,625,12,12.13,25,93.40666666666667,13,12.87,0.99,93.40666666666667,0,25
799,1.99,0.01,225,222.75,220.52,0.0,371.25,29.85,14.85,39.85,-0.15,14.85,-10.15,0,375,15,40,0.15,15,-10,0,0,25,-15,-14.85,-25,625,10,10.15,25,122.576,15,14.85,0.99,122.576,0,25
800,1.99,0.01,1,0.99,0.98,0.0,0.99,1.99,0.99,1.99,-0.01,0.99,-0.01,0,1,1,2,0.01,1,0,0,0,1,-1,-0.99,-1,1,0,0.01,1,1.0,1,0.99,0.99,1.0,0,1
801,1.99,0.01,625,618.75,612.56,618.75,0.0,49.75,49.75,24.75,-0.25,-0.25,24.75,625,0,50,25,0.25,0,25,625,0,25,0,0.25,25,0,-25,-24.75,-25,346.75733333333335,25,24.75,0.99,321.75733333333335,25,0
802,1.99,0.01,1,0.99,0.98,0.0,0.0,1.99,0.99,0.99,-0.01,0.99,0.99,0,0,1,1,0.01,1,1,0,0,0,-1,-0.99,0,0,-1,-0.99,0,0.992,1,0.99,0.99,0.992,0,0
803,1.99,0.01,625,618.75,612.56,0.0,0.0,49.75,24.75,24.75,-0.25,24.75,24.75,0,0,25,25,0.25,25,25,0,0,0,-25,-24.75,0,0,-25,-24.75,0,321.89866666666666,25,24.75,0.99,321.89866666666666,0,0
804,1.01,0.99,1,0.01,0.0,0.0,0.25,1.01,0.01,25.01,-0.99,0.01,-24.99,0,25,1,26,0.99,1,-24,0,0,25,-1,-0.01,-25,625,24,24.99,25,24.744,1,0.01,0.01,24.744,0,25
805,1.99,0.01,1,0.99,0.98,0.0,0.99,1.99,0.99,1.99,-0.01,0.99,-0.01,0,1,1,2,0.01,1,0,0,0,1,-1,-0.99,-1,1,0,0.01,1,1.0,1,0.99,0.99,1.0,0,1
806,1.99,0.01,625,618.75,612.56,618.75,0.0,49.75,49.75,24.75,-0.25,-0.25,24.75,625,0,50,25,0.25,0,25,625,0,25,0,0.25,25,0,-25,-24.75,-25,347.122,25,24.75,0.99,322.122,25,0
807,1.01,0.99,144,1.44,0.01,3.0,3.0,12.12,25.12,25.12,-11.88,-24.88,-24.88,300,300,37,37,11.88,-13,-13,625,625,50,13,24.88,0,625,13,24.88,0,322.718,12,0.12,0.01,297.718,25,25
808,1.99,0.01,1,0.99,0.98,0.0,0.0,1.99,0.99,0.99,-0.01,0.99,0.99,0,0,1,1,0.01,1,1,0,0,0,-1,-0.99,0,0,-1,-0.99,0,0.9913333333333333,1,0.99,0.99,0.9913333333333333,0,0
809,1.99,0.01,625,618.75,612.56,0.0,0.0,49.75,24.75,24.75,-0.25,24.75,24.75,0,0,25,25,0.25,25,25,0,0,0,-25,-24.75,0,0,-25,-24.75,0,321.768,25,24.75,0.99,321.768,0,0
810,1.99,0.01,169,167.31,165.64,321.75,321.75,25.87,37.87,37.87,-0.13,-12.13,-12.13,325,325,38,38,0.13,-12,-12,625,625,50,12,12.13,0,625,12,12.13,0,118.42333333333333,13,12.87,0.99,93.42333333333333,25,25
811,1.99,0.01,625,618.75,612.56,0.0,297.0,49.75,24.75,36.75,-0.25,24.75,12.75,0,300,25,37,0.25,25,13,0,0,12,-25,-24.75,-12,144,-13,-12.75,12,324.81333333333333,25,24.75,0.99,324.81333333333333,0,12
812,1.01,0.99,625,6.25,0.06,6.25,6.25,25.25,25.25,25.25,-24.75,-24.75,-24.75,625,625,50,50,24.75,0,0,625,625,50,0,24.75,0,625,0,24.75,0,647.2113333333333,25,0.25,0.01,622.2113333333333,25,25
813,1.99,0.01,169,167.31,165.64,0.0,321.75,25.87,12.87,37.87,-0.13,12.87,-12.13,0,325,13,38,0.13,13,-12,0,0,25,-13,-12.87,-25,625,12,12.13,25,93.29933333333334,13,12.87,0.99,93.29933333333334,0,25
814,1.99,0.01,625,618.75,612.56,0.0,618.75,49.75,24.75,49.75,-0.25,24.75,-0.25,0,625,25,50,0.25,25,0,0,0,25,-25,-24.75,-25,625,0,0.25,25,328.0106666666667,25,24.75,0.99,328.0106666666667,0,25
815,1.01,0.99,1,0.01,0.0,0.24,0.25,1.01,24.01,25.01,-0.99,-23.99,-24.99,24,25,25,26,0.99,-23,-24,576,600,49,23,23.99,-1,625,24,24.99,1,48.792,1,0.01,0.01,24.792,24,25
816,1.99,0.01,4,3.96,3.92,0.0,0.0,3.98,1.98,1.98,-0.02,1.98,1.98,0,0,2,2,0.02,2,2,0,0,0,-2,-1.98,0,0,-2,-1.98,0,2.966666666666667,2,1.98,0.99,2.966666666666667,0,0
817,1.99,0.01,1,0.99,0.98,0.0,0.0,1.99,0.99,0.99,-0.01,0.99,0.99,0,0,1,1,0.01,1,1,0,0,0,-1,-0.99,0,0,-1,-0.99,0,0.988,1,0.99,0.99,0.988,0,0
818,1.01,0.99,169,1.69,0.02,0.0,0.0,13.13,0.13,0.13,-12.87,0.13,0.13,0,0,13,13,12.87,13,13,0,0,0,-13,-0.13,0,0,-13,-0.13,0,0.878,13,0.13,0.01,0.878,0,0
819,1.99,0.01,1,0.99,0.98,0.0,24.75,1.99,0.99,25.99,-0.01,0.99,-24.01,0,25,1,26,0.01,1,-24,0,0,25,-1,-0.99,-25,625,24,24.01,25,1.176,1,0.99,0.99,1.176,0,25
820,1.01,0.99,1,0.01,0.0,0.0,0.0,1.01,0.01,0.01,-0.99,0.01,0.01,0,0,1,1,0.99,1,1,0,0,0,-1,-0.01,0,0,-1,-0.01,0,0.008,1,0.01,0.01,0.008,0,0
821,1.09,0.91,625,57.4,5.27,0.0,57.4,27.3,2.3,27.3,-22.7,2.3,-22.7,0,625,25,50,22.7,25,0,0,0,25,-25,-2.3,-25,625,0,22.7,25,597.2773333333333,25,2.3,0.09183458033420318,597.2773333333333,0,25
822,1.99,0.01,1,0.99,0.98,0.0,0.0,1.99,0.99,0.99,-0.01,0.99,0.99,0,0,1,1,0.01,1,1,0,0,0,-1,-0.99,0,0,-1,-0.99,0,0.9906666666666667,1,0.99,0.99,0.9906666666666667,0,0
823,1.99,0.01,625,618.75,612.56,0.0,0.0,49.75,24.75,24.75,-0.25,24.75,24.75,0,0,25,25,0.25,25,25,0,0,0,-25,-24.75,0,0,-25,-24.75,0,321.50733333333335,25,24.75,0.99,321.50733333333335,0,0
824,1.99,0.01,1,0.99,0.98,24.75,24.75,1.99,25.99,25.99,-0.01,-24.01,-24.01,25,25,26,26,0.01,-24,-24,625,625,50,24,24.01,0,625,24,24.01,0,26.176,1,0.99,0.99,1.1759999999999984,25,25
825,1.01,0.99,4,0.04,0.0,0.5,0.0,2.02,25.02,0.02,-1.98,-24.98,0.02,50,0,27,2,1.98,-23,2,625,0,25,23,24.98,25,0,-2,-0.02,-25,25.032666666666668,2,0.02,0.01,0.03266666666666751,25,0
826,1.99,0.01,1,0.99,0.98,24.75,0.0,1.99,25.99,0.99,-0.01,-24.01,0.99,25,0,26,1,0.01,-24,1,625,0,25,24,24.01,25,0,-1,-0.99,-25,25.994666666666667,1,0.99,0.99,0.9946666666666673,25,0
827,1.01,0.99,625,6.25,0.06,0.0,0.0,25.25,0.25,0.25,-24.75,0.25,0.25,0,0,25,25,24.75,25,25,0,0,0,-25,-0.25,0,0,-25,-0.25,0,3.138,25,0.25,0.01,3.138,0,0
828,1.01,0.99,1,0.01,0.0,0.24,0.25,1.01,24.01,25.01,-0.99,-23.99,-24.99,24,25,25,26,0.99,-23,-24,576,600,49,23,23.99,-1,625,24,24.99,1,48.728,1,0.01,0.01,24.728,24,25
829,1.99,0.01,4,3.96,3.92,0.0,0.0,3.98,1.98,1.98,-0.02,1.98,1.98,0,0,2,2,0.02,2,2,0,0,0,-2,-1.98,0,0,-2,-1.98,0,2.966,2,1.98,0.99,2.966,0,0
830,1.83,0.17,625,517.5,428.49,517.5,248.4,45.7,45.7,32.7,-4.3,-4.3,8.7,625,300,50,37,4.3,0,13,625,300,37,0,4.3,13,144,-13,-8.7,-13,346.1206666666667,25,20.7,0.827999775353927,321.1206666666667,25,12
831,1.99,0.01,625,618.75,612.56,0.0,618.75,49.75,24.75,49.75,-0.25,24.75,-0.25,0,625,25,50,0.25,25,0,0,0,25,-25,-24.75,-25,625,0,0.25,25,328.07533333333333,25,24.75,0.99,328.07533333333333,0,25
832,1.99,0.01,1,0.99,0.98,0.0,0.0,1.99,0.99,0.99,-0.01,0.99,0.99,0,0,1,1,0.01,1,1,0,0,0,-1,-0.99,0,0,-1,-0.99,0,0.9846666666666667,1,0.99,0.99,0.9846666666666667,0,0
833,1.01,0.99,625,6.25,0.06,0.0,0.0,25.25,0.25,0.25,-24.75,0.25,0.25,0,0,25,25,24.75,25,25,0,0,0,-25,-0.25,0,0,-25,-0.25,0,3.3893333333333335,25,0.25,0.01,3.3893333333333335,0,0
834,1.99,0.01,625,618.75,612.56,0.0,321.75,49.75,24.75,37.75,-0.25,24.75,11.75,0,325,25,38,0.25,25,12,0,0,13,-25,-24.75,-13,169,-12,-11.75,13,325.0013333333333,25,24.75,0.99,325.0013333333333,0,13
835,1.99,0.01,625,618.75,612.56,0.0,618.75,49.75,24.75,49.75,-0.25,24.75,-0.25,0,625,25,50,0.25,25,0,0,0,25,-25,-24.75,-25,625,0,0.25,25,327.888,25,24.75,0.99,327.888,0,25
836,1.01,0.99,169,1.69,0.02,3.25,3.25,13.13,25.13,25.13,-12.87,-24.87,-24.87,325,325,38,38,12.87,-12,-12,625,625,50,12,24.87,0,625,12,24.87,0,348.01,13,0.13,0.01000000168537027,323.01,25,25
837,1.99,0.01,625,618.75,612.56,618.75,321.75,49.75,49.75,37.75,-0.25,-0.25,11.75,625,325,50,38,0.25,0,12,625,325,38,0,0.25,12,169,-12,-11.75,-12,349.998,25,24.75,0.99,324.998,25,13
838,1.99,0.01,169,167.31,165.64,0.0,321.75,25.87,12.87,37.87,-0.13,12.87,-12.13,0,325,13,38,0.13,13,-12,0,0,25,-13,-12.87,-25,625,12,12.13,25,93.40666666666667,13,12.87,0.99,93.40666666666667,0,25
839,1.99,0.01,225,222.75,220.52,0.0,371.25,29.85,14.85,39.85,-0.15,14.85,-10.15,0,375,15,40,0.15,15,-10,0,0,25,-15,-14.85,-25,625,10,10.15,25,122.576,15,14.85,0.99,122.576,0,25
840,1.99,0.01,1,0.99,0.98,0.0,0.99,1.99,0.99,1.99,-0.01,0.99,-0.01,0,1,1,2,0.01,1,0,0,0,1,-1,-0.99,-1,1,0,0.01,1,1.0,1,0.99,0.99,1.0,0,1
841,1.99,0.01,625,618.75,612.56,618.75,0.0,49.75,49.75,24.75,-0.25,-0.25,24.75,625,0,50,25,0.25,0,25,625,0,25,0,0.25,25,0,-25,-24.75,-25,346.75733333333335,25,24.75,0.99,321.75733333333335,25,0
842,1.99,0.01,1,0.99,0.98,0.0,0.0,1.99,0.99,0.99,-0.01,0.99,0.99,0,0,1,1,0.01,1,1,0,0,0,-1,-0.99,0,0,-1,-0.99,0,0.992,1,0.99,0.99,0.992,0,0
843,1.99,0.01,625,618.75,612.56,0.0,0.0,49.75,24.75,24.75,-0.25,24.75,24.75,0,0,25,25,0.25,25,25,0,0,0,-25,-24.75,0,0,-25,-24.75,0,321.89866666666666,25,24.75,0.99,321.89866666666666,0,0
844,1.01,0.99,1,0.01,0.0,0.0,0.25,1.01,0.01,25.01,-0.99,0.01,-24.99,0,25,1,26,0.99,1,-24,0,0,25,-1,-0.01,-25,625,24,24.99,25,24.744,1,0.01,0.01,24.744,0,25
845,1.99,0.01,1,0.99,0.98,0.0,0.99,1.99,0.99,1.99,-0.01,0.99,-0.01,0,1,1,2,0.01,1,0,0,0,1,-1,-0.99,-1,1,0,0.01,1,1.0,1,0.99,0.99,1.0,0,1
846,1.99,0.01,625,618.75,612.56,618.75,0.0,49.75,49.75,24.75,-0.25,-0.25,24.75,625,0,50,25,0.25,0,25,625,0,25,0,0.25,25,0,-25,-24.75,-25,347.122,25,24.75,0.99,322.122,25,0
847,1.01,0.99,144,1.44,0.01,3.0,3.0,12.12,25.12,25.12,-11.88,-24.88,-24.88,300,300,37,37,11.88,-13,-13,625,625,50,13,24.88,0,625,13,24.88,0,322.718,12,0.12,0.01,297.718,25,25
848,1.99,0.01,1,0.99,0.98,0.0,0.0,1.99,0.99,0.99,-0.01,0.99,0.99,0,0,1,1,0.01,1,1,0,0,0,-1,-0.99,0,0,-1,-0.99,0,0.9913333333333333,1,0.99,0.99,0.9913333333333333,0,0
849,1.99,0.01,625,618.75,612.56,0.0,0.0,49.75,24.75,24.75,-0.25,24.75,24.75,0,0,25,25,0.25,25,25,0,0,0,-25,-24.75,0,0,-25,-24.75,0,321.768,25,24.75,0.99,321.768,0,0
850,1.99,0.01,169,167.31,165.64,321.75,321.75,25.87,37.87,37.87,-0.13,-12.13,-12.13,325,325,38,38,0.13,-12,-12,625,625,50,12,12.13,0,625,12,12.13,0,118.42333333333333,13,12.87,0.99,93.42333333333333,25,25
851,1.99,0.01,625,618.75,612.56,0.0,297.0,49.75,24.75,36.75,-0.25,24.75,12.75,0,300,25,37,0.25,25,13,0,0,12,-25,-24.75,-12,144,-13,-12.75,12,324.81333333333333,25,24.75,0.99,324.81333333333333,0,12
852,1.01,0.99,625,6.25,0.06,6.25,6.25,25.25,25.25,25.25,-24.75,-24.75,-24.75,625,625,50,50,24.75,0,0,625,625,50,0,24.75,0,625,0,24.75,0,647.2113333333333,25,0.25,0.01,622.2113333333333,25,25
853,1.99,0.01,169,167.31,165.64,0.0,321.75,25.87,12.87,37.87,-0.13,12.87,-12.13,0,325,13,38,0.13,13,-12,0,0,25,-13,-12.87,-25,625,12,12.13,25,93.29933333333334,13,12.87,0.99,93.29933333333334,0,25
854,1.99,0.01,625,618.75,612.56,0.0,618.75,49.75,24.75,49.75,-0.25,24.75,-0.25,0,625,25,50,0.25,25,0,0,0,25,-25,-24.75,-25,625,0,0.25,25,328.0106666666667,25,24.75,0.99,328.0106666666667,0,25
855,1.01,0.99,1,0.01,0.0,0.24,0.25,1.01,24.01,25.01,-0.99,-23.99,-24.99,24,25,25,26,0.99,-23,-24,576,600,49,23,23.99,-1,625,24,24.99,1,48.792,1,0.01,0.01,24.792,24,25
856,1.99,0.01,4,3.96,3.92,0.0,0.0,3.98,1.98,1.98,-0.02,1.98,1.98,0,0,2,2,0.02,2,2,0,0,0,-2,-1.98,0,0,-2,-1.98,0,2.966666666666667,2,1.98,0.99,2.966666666666667,0,0
857,1.99,0.01,1,0.99,0.98,0.0,0.0,1.99,0.99,0.99,-0.01,0.99,0.99,0,0,1,1,0.01,1,1,0,0,0,-1,-0.99,0,0,-1,-0.99,0,0.988,1,0.99,0.99,0.988,0,0
858,1.01,0.99,169,1.69,0.02,0.0,0.0,13.13,0.13,0.13,-12.87,0.13,0.13,0,0,13,13,12.87,13,13,0,0,0,-13,-0.13,0,0,-13,-0.13,0,0.878,13,0.13,0.01,0.878,0,0
859,1.99,0.01,1,0.99,0.98,0.0,24.75,1.99,0.99,25.99,-0.01,0.99,-24.01,0,25,1,26,0.01,1,-24,0,0,25,-1,-0.99,-25,625,24,24.01,25,1.176,1,0.99,0.99,1.176,0,25
860,1.01,0.99,1,0.01,0.0,0.0,0.0,1.01,0.01,0.01,-0.99,0.01,0.01,0,0,1,1,0.99,1,1,0,0,0,-1,-0.01,0,0,-1,-0.01,0,0.008,1,0.01,0.01,0.008,0,0
861,1.09,0.91,625,57.4,5.27,0.0,57.4,27.3,2.3,27.3,-22.7,2.3,-22.7,0,625,25,50,22.7,25,0,0,0,25,-25,-2.3,-25,625,0,22.7,25,597.2773333333333,25,2.3,0.09183458033420318,597.2773333333333,0,25
862,1.99,0.01,1,0.99,0.98,0.0,0.0,1.99,0.99,0.99,-0.01,0.99,0.99,0,0,1,1,0.01,1,1,0,0,0,-1,-0.99,0,0,-1,-0.99,0,0.9906666666666667,1,0.99,0.99,0.9906666666666667,0,0
863,1.99,0.01,625,618.75,612.56,0.0,0.0,49.75,24.75,24.75,-0.25,24.75,24.75,0,0,25,25,0.25,25,25,0,0,0,-25,-24.75,0,0,-25,-24.75,0,321.50733333333335,25,24.75,0.99,321.50733333333335,0,0
864,1.99,0.01,1,0.99,0.98,24.75,24.75,1.99,25.99,25.99,-0.01,-24.01,-24.01,25,25,26,26,0.01,-24,-24,625,625,50,24,24.01,0,625,24,24.01,0,26.176,1,0.99,0.99,1.1759999999999984,25,25
865,1.01,0.99,4,0.04,0.0,0.5,0.0,2.02,25.02,0.02,-1.98,-24.98,0.02,50,0,27,2,1.98,-23,2,625,0,25,23,24.98,25,0,-2,-0.02,-25,25.032666666666668,2,0.02,0.01,0.03266666666666751,25,0
866,1.99,0.01,1,0.99,0.98,24.75,0.0,1.99,25.99,0.99,-0.01,-24.01,0.99,25,0,26,1,0.01,-24,1,625,0,25,24,24.01,25,0,-1,-0.99,-25,25.994666666666667,1,0.99,0.99,0.9946666666666673,25,0
867,1.01,0.99,625,6.25,0.06,0.0,0.0,25.25,0.25,0.25,-24.75,0.25,0.25,0,0,25,25,24.75,25,25,0,0,0,-25,-0.25,0,0,-25,-0.25,0,3.138,25,0.25,0.01,3.138,0,0
868,1.01,0.99,1,0.01,0.0,0.24,0.25,1.01,24.01,25.01,-0.99,-23.99,-24.99,24,25,25,26,0.99,-23,-24,576,600,49,23,23.99,-1,625,24,24.99,1,48.728,1,0.01,0.01,24.728,24,25
869,1.99,0.01,4,3.96,3.92,0.0,0.0,3.98,1.98,1.98,-0.02,1.98,1.98,0,0,2,2,0.02,2,2,0,0,0,-2,-1.98,0,0,-2,-1.98,0,2.966,2,1.98,0.99,2.966,0,0
870,1.83,0.17,625,517.5,428.49,517.5,248.4,45.7,45.7,32.7,-4.3,-4.3,8.7,625,300,50,37,4.3,0,13,625,300,37,0,4.3,13,144,-13,-8.7,-13,346.1206666666667,25,20.7,0.827999775353927,321.1206666666667,25,12
871,1.99,0.01,625,618.75,612.56,0.0,618.75,49.75,24.75,49.75,-0.25,24.75,-0.25,0,625,25,50,0.25,25,0,0,0,25,-25,-24.75,-25,625,0,0.25,25,328.07533333333333,25,24.75,0.99,328.07533333333333,0,25
872,1.99,0.01,1,0.99,0.98,0.0,0.0,1.99,0.99,0.99,-0.01,0.99,0.99,0,0,1,1,0.01,1,1,0,0,0,-1,-0.99,0,0,-1,-0.99,0,0.9846666666666667,1,0.99,0.99,0.9846666666666667,0,0
873,1.01,0.99,625,6.25,0.06,0.0,0.0,25.25,0.25,0.25,-24.75,0.25,0.25,0,0,25,25,24.75,25,25,0,0,0,-25,-0.25,0,0,-25,-0.25,0,3.3893333333333335,25,0.25,0.01,3.3893333333333335,0,0
874,1.99,0.01,625,618.75,612.56,0.0,321.75,49.75,24.75,37.75,-0.25,24.75,11.75,0,325,25,38,0.25,25,12,0,0,13,-25,-24.75,-13,169,-12,-11.75,13,325.0013333333333,25,24.75,0.99,325.0013333333333,0,13
875,1.99,0.01,625,618.75,612.56,0.0,618.75,49.75,24.75,49.75,-0.25,24.75,-0.25,0,625,25,50,0.25,25,0,0,0,25,-25,-24.75,-25,625,0,0.25,25,327.888,25,24.75,0.99,327.888,0,25
876,1.01,0.99,169,1.69,0.02,3.25,3.25,13.13,25.13,25.13,-12.87,-24.87,-24.87,325,325,38,38,12.87,-12,-12,625,625,50,12,24.87,0,625,12,24.87,0,348.01,13,0.13,0.01000000168537027,323.01,25,25
877,1.99,0.01,625,618.75,612.56,618.75,321.75,49.75,49.75,37.75,-0.25,-0.25,11.75,625,325,50,38,0.25,0,12,625,325,38,0,0.25,12,169,-12,-11.75,-12,349.998,25,24.75,0.99,324.998,25,13
878,1.99,0.01,169,167.31,165.64,0.0,321.75,25.87,12.87,37.87,-0.13,12.87,-12.13,0,325,13,38,0.13,13,-12,0,0,25,-13,-12.87,-25,625,12,12.13,25,93.40666666666667,13,12.87,0.99,93.40666666666667,0,25
879,1.99,0.01,225,222.75,220.52,0.0,371.25,29.85,14.85,39.85,-0.15,14.85,-10.15,0,375,15,40,0.15,15,-10,0,0,25,-15,-14.85,-25,625,10,10.15,25,122.576,15,14.85,0.99,122.576,0,25
880,1.99,0.01,1,0.99,0.98,0.0,0.99,1.99,0.99,1.99,-0.01,0.99,-0.01,0,1,1,2,0.01,1,0,0,0,1,-1,-0.99,-1,1,0,0.01,1,1.0,1,0.99,0.99,1.0,0,1
881,1.99,0.01,625,618.75,612.56,618.75,0.0,49.75,49.75,24.75,-0.25,-0.25,24.75,625,0,50,25,0.25,0,25,625,0,25,0,0.25,25,0,-25,-24.75,-25,346.75733333333335,25,24.75,0.99,321.75733333333335,25,0
882,1.99,0.01,1,0.99,0.98,0.0,0.0,1.99,0.99,0.99,-0.01,0.99,0.99,0,0,1,1,0.01,1,1,0,0,0,-1,-0.99,0,0,-1,-0.99,0,0.992,1,0.99,0.99,0.992,0,0
883,1.99,0.01,625,618.75,612.56,0.0,0.0,49.75,24.75,24.75,-0.25,24.75,24.75,0,0,25,25,0.25,25,25,0,0,0,-25,-24.75,0,0,-25,-24.75,0,321.89866666666666,25,24.75,0.99,321.89866666666666,0,0
884,1.01,0.99,1,0.01,0.0,0.0,0.25,1.01,0.01,25.01,-0.99,0.01,-24.99,0,25,1,26,0.99,1,-24,0,0,25,-1,-0.01,-25,625,24,24.99,25,24.744,1,0.01,0.01,24.744,0,25
885,1.99,0.01,1,0.99,0.98,0.0,0.99,1.99,0.99,1.99,-0.01,0.99,-0.01,0,1,1,2,0.01,1,0,0,0,1,-1,-0.99,-1,1,0,0.01,1,1.0,1,0.99,0.99,1.0,0,1
886,1.99,0.01,625,618.75,612.56,618.75,0.0,49.75,49.75,24.75,-0.25,-0.25,24.75,625,0,50,25,0.25,0,25,625,0,25,0,0.25,25,0,-25,-24.75,-25,347.122,25,24.75,0.99,322.122,25,0
887,1.01,0.99,144,1.44,0.01,3.0,3.0,12.12,25.12,25.12,-11.88,-24.88,-24.88,300,300,37,37,11.88,-13,-13,625,625,50,13,24.88,0,625,13,24.88,0,322.718,12,0.12,0.01,297.718,25,25
888,1.99,0.01,1,0.99,0.98,0.0,0.0,1.99,0.99,0.99,-0.01,0.99,0.99,0,0,1,1,0.01,1,1,0,0,0,-1,-0.99,0,0,-1,-0.99,0,0.9913333333333333,1,0.99,0.99,0.9913333333333333,0,0
889,1.99,0.01,625,618.75,612.56,0.0,0.0,49.75,24.75,24.75,-0.25,24.75,24.75,0,0,25,25,0.25,25,25,0,0,0,-25,-24.75,0,0,-25,-24.75,0,321.768,25,24.75,0.99,321.768,0,0
890,1.99,0.01,169,167.31,165.64,321.75,321.75,25.87,37.87,37.87,-0.13,-12.13,-12.13,325,325,38,38,0.13,-12,-12,625,625,50,12,12.13,0,625,12,12.13,0,118.42333333333333,13,12.87,0.99,93.42333333333333,25,25
891,1.99,0.01,625,618.75,612.56,0.0,297.0,49.75,24.75,36.75,-0.25,24.75,12.75,0,300,25,37,0.25,25,13,0,0,12,-25,-24.75,-12,144,-13,-12.75,12,324.81333333333333,25,24.75,0.99,324.81333333333333,0,12
892,1.01,0.99,625,6.25,0.06,6.25,6.25,25.25,25.25,25.25,-24.75,-24.75,-24.75,625,625,50,50,24.75,0,0,625,625,50,0,24.75,0,625,0,24.75,0,647.2113333333333,25,0.25,0.01,622.2113333333333,25,25
893,1.99,0.01,169,167.31,165.64,0.0,321.75,25.87,12.87,37.87,-0.13,12.87,-12.13,0,325,13,38,0.13,13,-12,0,0,25,-13,-12.87,-25,625,12,12.13,25,93.29933333333334,13,12.87,0.99,93.29933333333334,0,25
894,1.99,0.01,625,618.75,612.56,0.0,618.75,49.75,24.75,49.75,-0.25,24.75,-0.25,0,625,25,50,0.25,25,0,0,0,25,-25,-24.75,-25,625,0,0.25,25,328.0106666666667,25,24.75,0.99,328.0106666666667,0,25
895,1.01,0.99,1,0.01,0.0,0.24,0.25,1.01,24.01,25.01,-0.99,-23.99,-24.99,24,25,25,26,0.99,-23,-24,576,600,49,23,23.99,-1,625,24,24.99,1,48.792,1,0.01,0.01,24.792,24,25
896,1.99,0.01,4,3.96,3.92,0.0,0.0,3.98,1.98,1.98,-0.02,1.98,1.98,0,0,2,2,0.02,2,2,0,0,0,-2,-1.98,0,0,-2,-1.98,0,2.966666666666667,2,1.98,0.99,2.966666666666667,0,0
897,1.99,0.01,1,0.99,0.98,0.0,0.0,1.99,0.99,0.99,-0.01,0.99,0.99,0,0,1,1,0.01,1,1,0,0,0,-1,-0.99,0,0,-1,-0.99,0,0.988,1,0.99,0.99,0.988,0,0
898,1.01,0.99,169,1.69,0.02,0.0,0.0,13.13,0.13,0.13,-12.87,0.13,0.13,0,0,13,13,12.87,13,13,0,0,0,-13,-0.13,0,0,-13,-0.13,0,0.878,13,0.13,0.01,0.878,0,0
899,1.99,0.01,1,0.99,0.98,0.0,24.75,1.99,0.99,25.99,-0.01,0.99,-24.01,0,25,1,26,0.01,1,-24,0,0,25,-1,-0.99,-25,625,24,24.01,25,1.176,1,0.99,0.99,1.176,0,25
900,1.01,0.99,1,0.01,0.0,0.0,0.0,1.01,0.01,0.01,-0.99,0.01,0.01,0,0,1,1,0.99,1,1,0,0,0,-1,-0.01,0,0,-1,-0.01,0,0.008,1,0.01,0.01,0.008,0,0
901,1.09,0.91,625,57.4,5.27,0.0,57.4,27.3,2.3,27.3,-22.7,2.3,-22.7,0,625,25,50,22.7,25,0,0,0,25,-25,-2.3,-25,625,0,22.7,25,597.2773333333333,25,2.3,0.09183458033420318,597.2773333333333,0,25
902,1.99,0.01,1,0.99,0.98,0.0,0.0,1.99,0.99,0.99,-0.01,0.99,0.99,0,0,1,1,0.01,1,1,0,0,0,-1,-0.99,0,0,-1,-0.99,0,0.9906666666666667,1,0.99,0.99,0.9906666666666667,0,0
903,1.99,0.01,625,618.75,612.56,0.0,0.0,49.75,24.75,24.75,-0.25,24.75,24.75,0,0,25,25,0.25,25,25,0,0,0,-25,-24.75,0,0,-25,-24.75,0,321.50733333333335,25,24.75,0.99,321.50733333333335,0,0
904,1.99,0.01,1,0.99,0.98,24.75,24.75,1.99,25.99,25.99,-0.01,-24.01,-24.01,25,25,26,26,0.01,-24,-24,625,625,50,24,24.01,0,625,24,24.01,0,26.176,1,0.99,0.99,1.1759999999999984,25,25
905,1.01,0.99,4,0.04,0.0,0.5,0.0,2.02,25.02,0.02,-1.98,-24.98,0.02,50,0,27,2,1.98,-23,2,625,0,25,23,24.98,25,0,-2,-0.02,-25,25.032666666666668,2,0.02,0.01,0.03266666666666751,25,0
906,1.99,0.01,1,0.99,0.98,24.75,0.0,1.99,25.99,0.99,-0.01,-24.01,0.99,25,0,26,1,0.01,-24,1,625,0,25,24,24.01,25,0,-1,-0.99,-25,25.994666666666667,1,0.99,0.99,0.9946666666666673,25,0
907,1.01,0.99,625,6.25,0.06,0.0,0.0,25.25,0.25,0.25,-24.75,0.25,0.25,0,0,25,25,24.75,25,25,0,0,0,-25,-0.25,0,0,-25,-0.25,0,3.138,25,0.25,0.01,3.138,0,0
908,1.01,0.99,1,0.01,0.0,0.24,0.25,1.01,24.01,25.01,-0.99,-23.99,-24.99,24,25,25,26,0.99,-23,-24,576,600,49,23,23.99,-1,625,24,24.99,1,48.728,1,0.01,0.01,24.728,24,25
909,1.99,0.01,4,3.96,3.92,0.0,0.0,3.98,1.98,1.98,-0.02,1.98,1.98,0,0,2,2,0.02,2,2,0,0,0,-2,-1.98,0,0,-2,-1.98,0,2.966,2,1.98,0.99,2.966,0,0
910,1.83,0.17,625,517.5,428.49,517.5,248.4,45.7,45.7,32.7,-4.3,-4.3,8.7,625,300,50,37,4.3,0,13,625,300,37,0,4.3,13,144,-13,-8.7,-13,346.1206666666667,25,20.7,0.827999775353927,321.1206666666667,25,12
911,1.99,0.01,625,618.75,612.56,0.0,618.75,49.75,24.75,49.75,-0.25,24.75,-0.25,0,625,25,50,0.25,25,0,0,0,25,-25,-24.75,-25,625,0,0.25,25,328.07533333333333,25,24.75,0.99,328.07533333333333,0,25
912,1.99,0.01,1,0.99,0.98,0.0,0.0,1.99,0.99,0.99,-0.01,0.99,0.99,0,0,1,1,0.01,1,1,0,0,0,-1,-0.99,0,0,-1,-0.99,0,0.9846666666666667,1,0.99,0.99,0.9846666666666667,0,0
913,1.01,0.99,625,6.25,0.06,0.0,0.0,25.25,0.25,0.25,-24.75,0.25,0.25,0,0,25,25,24.75,25,25,0,0,0,-25,-0.25,0,0,-25,-0.25,0,3.3893333333333335,25,0.25,0.01,3.3893333333333335,0,0
914,1.99,0.01,625,618.75,612.56,0.0,321.75,49.75,24.75,37.75,-0.25,24.75,11.75,0,325,25,38,0.25,25,12,0,0,13,-25,-24.75,-13,169,-12,-11.75,13,325.0013333333333,25,24.75,0.99,325.0013333333333,0,13
915,1.99,0.01,625,618.75,612.56,0.0,618.75,49.75,24.75,49.75,-0.25,24.75,-0.25,0,625,25,50,0.25,25,0,0,0,25,-25,-24.75,-25,625,0,0.25,25,327.888,25,24.75,0.99,327.888,0,25
916,1.01,0.99,169,1.69,0.02,3.25,3.25,13.13,25.13,25.13,-12.87,-24.87,-24.87,325,325,38,38,12.87,-12,-12,625,625,50,12,24.87,0,625,12,24.87,0,348.01,13,0.13,0.01000000168537027,323.01,25,25
917,1.99,0.01,625,618.75,612.56,618.75,321.75,49.75,49.75,37.75,-0.25,-0.25,11.75,625,325,50,38,0.25,0,12,625,325,38,0,0.25,12,169,-12,-11.75,-12,349.998,25,24.75,0.99,324.998,25,13
918,1.99,0.01,169,167.31,165.64,0.0,321.75,25.87,12.87,37.87,-0.13,12.87,-12.13,0,325,13,38,0.13,13,-12,0,0,25,-13,-12.87,-25,625,12,12.13,25,93.40666666666667,13,12.87,0.99,93.40666666666667,0,25
919,1.99,0.01,225,222.75,220.52,0.0,371.25,29.85,14.85,39.85,-0.15,14.85,-10.15,0,375,15,40,0.15,15,-10,0,0,25,-15,-14.85,-25,625,10,10.15,25,122.576,15,14.85,0.99,122.576,0,25
920,1.99,0.01,1,0.99,0.98,0.0,0.99,1.99,0.99,1.99,-0.01,0.99,-0.01,0,1,1,2,0.01,1,0,0,0,1,-1,-0.99,-1,1,0,0.01,1,1.0,1,0.99,0.99,1.0,0,1
921,1.99,0.01,625,618.75,612.56,618.75,0.0,49.75,49.75,24.75,-0.25,-0.25,24.75,625,0,50,25,0.25,0,25,625,0,25,0,0.25,25,0,-25,-24.75,-25,346.75733333333335,25,24.75,0.99,321.75733333333335,25,0
922,1.99,0.01,1,0.99,0.98,0.0,0.0,1.99,0.99,0.99,-0.01,0.99,0.99,0,0,1,1,0.01,1,1,0,0,0,-1,-0.99,0,0,-1,-0.99,0,0.992,1,0.99,0.99,0.992,0,0
923,1.99,0.01,625,618.75,612.56,0.0,0.0,49.75,24.75,24.75,-0.25,24.75,24.75,0,0,25,25,0.25,25,25,0,0,0,-25,-24.75,0,0,-25,-24.75,0,321.89866666666666,25,24.75,0.99,321.89866666666666,0,0
924,1.01,0.99,1,0.01,0.0,0.0,0.25,1.01,0.01,25.01,-0.99,0.01,-24.99,0,25,1,26,0.99,1,-24,0,0,25,-1,-0.01,-25,625,24,24.99,25,24.744,1,0.01,0.01,24.744,0,25
925,1.99,0.01,1,0.99,0.98,0.0,0.99,1.99,0.99,1.99,-0.01,0.99,-0.01,0,1,1,2,0.01,1,0,0,0,1,-1,-0.99,-1,1,0,0.01,1,1.0,1,0.99,0.99,1.0,0,1
926,1.99,0.01,625,618.75,612.56,618.75,0.0,49.75,49.75,24.75,-0.25,-0.25,24.75,625,0,50,25,0.25,0,25,625,0,25,0,0.25,25,0,-25,-24.75,-25,347.122,25,24.75,0.99,322.122,25,0
927,1.01,0.99,144,1.44,0.01,3.0,3.0,12.12,25.12,25.12,-11.88,-24.88,-24.88,300,300,37,37,11.88,-13,-13,625,625,50,13,24.88,0,625,13,24.88,0,322.718,12,0.12,0.01,297.718,25,25
928,1.99,0.01,1,0.99,0.98,0.0,0.0,1.99,0.99,0.99,-0.01,0.99,0.99,0,0,1,1,0.01,1,1,0,0,0,-1,-0.99,0,0,-1,-0.99,0,0.9913333333333333,1,0.99,0.99,0.9913333333333333,0,0
929,1.99,0.01,625,618.75,612.56,0.0,0.0,49.75,24.75,24.75,-0.25,24.75,24.75,0,0,25,25,0.25,25,25,0,0,0,-25,-24.75,0,0,-25,-24.75,0,321.768,25,24.75,0.99,321.768,0,0
930,1.99,0.01,169,167.31,165.64,321.75,321.75,25.87,37.87,37.87,-0.13,-12.13,-12.13,325,325,38,38,0.13,-12,-12,625,625,50,12,12.13,0,625,12,12.13,0,118.42333333333333,13,12.87,0.99,93.42333333333333,25,25
931,1.99,0.01,625,618.75,612.56,0.0,297.0,49.75,24.75,36.75,-0.25,24.75,12.75,0,300,25,37,0.25,25,13,0,0,12,-25,-24.75,-12,144,-13,-12.75,12,324.81333333333333,25,24.75,0.99,324.81333333333333,0,12
932,1.01,0.99,625,6.25,0.06,6.25,6.25,25.25,25.25,25.25,-24.75,-24.75,-24.75,625,625,50,50,24.75,0,0,625,625,50,0,24.75,0,625,0,24.75,0,647.2113333333333,25,0.25,0.01,622.2113333333333,25,25
933,1.99,0.01,169,167.31,165.64,0.0,321.75,25.87,12.87,37.87,-0.13,12.87,-12.13,0,325,13,38,0.13,13,-12,0,0,25,-13,-12.87,-25,625,12,12.13,25,93.29933333333334,13,12.87,0.99,93.29933333333334,0,25
934,1.99,0.01,625,618.75,612.56,0.0,618.75,49.75,24.75,49.75,-0.25,24.75,-0.25,0,625,25,50,0.25,25,0,0,0,25,-25,-24.75,-25,625,0,0.25,25,328.0106666666667,25,24.75,0.99,328.0106666666667,0,25
935,1.01,0.99,1,0.01,0.0,0.24,0.25,1.01,24.01,25.01,-0.99,-23.99,-24.99,24,25,25,26,0.99,-23,-24,576,600,49,23,23.99,-1,625,24,24.99,1,48.792,1,0.01,0.01,24.792,24,25
936,1.99,0.01,4,3.96,3.92,0.0,0.0,3.98,1.98,1.98,-0.02,1.98,1.98,0,0,2,2,0.02,2,2,0,0,0,-2,-1.98,0,0,-2,-1.98,0,2.966666666666667,2,1.98,0.99,2.966666666666667,0,0
937,1.99,0.01,1,0.99,0.98,0.0,0.0,1.99,0.99,0.99,-0.01,0.99,0.99,0,0,1,1,0.01,1,1,0,0,0,-1,-0.99,0,0,-1,-0.99,0,0.988,1,0.99,0.99,0.988,0,0
938,1.01,0.99,169,1.69,0.02,0.0,0.0,13.13,0.13,0.13,-12.87,0.13,0.13,0,0,13,13,12.87,13,13,0,0,0,-13,-0.13,0,0,-13,-0.13,0,0.878,13,0.13,0.01,0.878,0,0
939,1.99,0.01,1,0.99,0.98,0.0,24.75,1.99,0.99,25.99,-0.01,0.99,-24.01,0,25,1,26,0.01,1,-24,0,0,25,-1,-0.99,-25,625,24,24.01,25,1.176,1,0.99,0.99,1.176,0,25
940,1.01,0.99,1,0.01,0.0,0.0,0.0,1.01,0.01,0.01,-0.99,0.01,0.01,0,0,1,1,0.99,1,1,0,0,0,-1,-0.01,0,0,-1,-0.01,0,0.008,1,0.01,0.01,0.008,0,0
941,1.09,0.91,625,57.4,5.27,0.0,57.4,27.3,2.3,27.3,-22.7,2.3,-22.7,0,625,25,50,22.7,25,0,0,0,25,-25,-2.3,-25,625,0,22.7,25,597.2773333333333,25,2.3,0.09183458033420318,597.2773333333333,0,25
942,1.99,0.01,1,0.99,0.98,0.0,0.0,1.99,0.99,0.99,-0.01,0.99,0.99,0,0,1,1,0.01,1,1,0,0,0,-1,-0.99,0,0,-1,-0.99,0,0.9906666666666667,1,0.99,0.99,0.9906666666666667,0,0
943,1.99,0.01,625,618.75,612.56,0.0,0.0,49.75,24.75,24.75,-0.25,24.75,24.75,0,0,25,25,0.25,25,25,0,0,0,-25,-24.75,0,0,-25,-24.75,0,321.50733333333335,25,24.75,0.99,321.50733333333335,0,0
944,1.99,0.01,1,0.99,0.98,24.75,24.75,1.99,25.99,25.99,-0.01,-24.01,-24.01,25,25,26,26,0.01,-24,-24,625,625,50,24,24.01,0,625,24,24.01,0,26.176,1,0.99,0.99,1.1759999999999984,25,25
945,1.01,0.99,4,0.04,0.0,0.5,0.0,2.02,25.02,0.02,-1.98,-24.98,0.02,50,0,27,2,1.98,-23,2,625,0,25,23,24.98,25,0,-2,-0.02,-25,25.032666666666668,2,0.02,0.01,0.03266666666666751,25,0
946,1.99,0.01,1,0.99,0.98,24.75,0.0,1.99,25.99,0.99,-0.01,-24.01,0.99,25,0,26,1,0.01,-24,1,625,0,25,24,24.01,25,0,-1,-0.99,-25,25.994666666666667,1,0.99,0.99,0.9946666666666673,25,0
947,1.01,0.99,625,6.25,0.06,0.0,0.0,25.25,0.25,0.25,-24.75,0.25,0.25,0,0,25,25,24.75,25,25,0,0,0,-25,-0.25,0,0,-25,-0.25,0,3.138,25,0.25,0.01,3.138,0,0
948,1.01,0.99,1,0.01,0.0,0.24,0.25,1.01,24.01,25.01,-0.99,-23.99,-24.99,24,25,25,26,0.99,-23,-24,576,600,49,23,23.99,-1,625,24,24.99,1,48.728,1,0.01,0.01,24.728,24,25
949,1.99,0.01,4,3.96,3.92,0.0,0.0,3.98,1.98,1.98,-0.02,1.98,1.98,0,0,2,2,0.02,2,2,0,0,0,-2,-1.98,0,0,-2,-1.98,0,2.966,2,1.98,0.99,2.966,0,0
950,1.83,0.17,625,517.5,428.49,517.5,248.4,45.7,45.7,32.7,-4.3,-4.3,8.7,625,300,50,37,4.3,0,13,625,300,37,0,4.3,13,144,-13,-8.7,-13,346.1206666666667,25,20.7,0.827999775353927,321.1206666666667,25,12
951,1.99,0.01,625,618.75,612.56,0.0,618.75,49.75,24.75,49.75,-0.25,24.75,-0.25,0,625,25,50,0.25,25,0,0,0,25,-25,-24.75,-25,625,0,0.25,25,328.07533333333333,25,24.75,0.99,328.07533333333333,0,25
952,1.99,0.01,1,0.99,0.98,0.0,0.0,1.99,0.99,0.99,-0.01,0.99,0.99,0,0,1,1,0.01,1,1,0,0,0,-1,-0.99,0,0,-1,-0.99,0,0.9846666666666667,1,0.99,0.99,0.9846666666666667,0,0
953,1.01,0.99,625,6.25,0.06,0.0,0.0,25.25,0.25,0.25,-24.75,0.25,0.25,0,0,25,25,24.75,25,25,0,0,0,-25,-0.25,0,0,-25,-0.25,0,3.3893333333333335,25,0.25,0.01,3.3893333333333335,0,0
954,1.99,0.01,625,618.75,612.56,0.0,321.75,49.75,24.75,37.75,-0.25,24.75,11.75,0,325,25,38,0.25,25,12,0,0,13,-25,-24.75,-13,169,-12,-11.75,13,325.0013333333333,25,24.75,0.99,325.0013333333333,0,13
955,1.99,0.01,625,618.75,612.56,0.0,618.75,49.75,24.75,49.75,-0.25,24.75,-0.25,0,625,25,50,0.25,25,0,0,0,25,-25,-24.75,-25,625,0,0.25,25,327.888,25,24.75,0.99,327.888,0,25
956,1.01,0.99,169,1.69,0.02,3.25,3.25,13.13,25.13,25.13,-12.87,-24.87,-24.87,325,325,38,38,12.87,-12,-12,625,625,50,12,24.87,0,625,12,24.87,0,348.01,13,0.13,0.01000000168537027,323.01,25,25
957,1.99,0.01,625,618.75,612.56,618.75,321.75,49.75,49.75,37.75,-0.25,-0.25,11.75,625,325,50,38,0.25,0,12,625,325,38,0,0.25,12,169,-12,-11.75,-12,349.998,25,24.75,0.99,324.998,25,13
958,1.99,0.01,169,167.31,165.64,0.0,321.75,25.87,12.87,37.87,-0.13,12.87,-12.13,0,325,13,38,0.13,13,-12,0,0,25,-13,-12.87,-25,625,12,12.13,25,93.40666666666667,13,12.87,0.99,93.40666666666667,0,25
959,1.99,0.01,225,222.75,220.52,0.0,371.25,29.85,14.85,39.85,-0.15,14.85,-10.15,0,375,15,40,0.15,15,-10,0,0,25,-15,-14.85,-25,625,10,10.15,25,122.576,15,14.85,0.99,122.576,0,25
960,1.99,0.01,1,0.99,0.98,0.0,0.99,1.99,0.99,1.99,-0.01,0.99,-0.01,0,1,1,2,0.01,1,0,0,0,1,-1,-0.99,-1,1,0,0.01,1,1.0,1,0.99,0.99,1.0,0,1
961,1.99,0.01,625,618.75,612.56,618.75,0.0,49.75,49.75,24.75,-0.25,-0.25,24.75,625,0,50,25,0.25,0,25,625,0,25,0,0.25,25,0,-25,-24.75,-25,346.75733333333335,25,24.75,0.99,321.75733333333335,25,0
962,1.99,0.01,1,0.99,0.98,0.0,0.0,1.99,0.99,0.99,-0.01,0.99,0.99,0,0,1,1,0.01,1,1,0,0,0,-1,-0.99,0,0,-1,-0.99,0,0.992,1,0.99,0.99,0.992,0,0
963,1.99,0.01,625,618.75,612.56,0.0,0.0,49.75,24.75,24.75,-0.25,24.75,24.75,0,0,25,25,0.25,25,25,0,0,0,-25,-24.75,0,0,-25,-24.75,0,321.89866666666666,25,24.75,0.99,321.89866666666666,0,0
964,1.01,0.99,1,0.01,0.0,0.0,0.25,1.01,0.01,25.01,-0.99,0.01,-24.99,0,25,1,26,0.99,1,-24,0,0,25,-1,-0.01,-25,625,24,24.99,25,24.744,1,0.01,0.01,24.744,0,25
965,1.99,0.01,1,0.99,0.98,0.0,0.99,1.99,0.99,1.99,-0.01,0.99,-0.01,0,1,1,2,0.01,1,0,0,0,1,-1,-0.99,-1,1,0,0.01,1,1.0,1,0.99,0.99,1.0,0,1
966,1.99,0.01,625,618.75,612.56,618.75,0.0,49.75,49.75,24.75,-0.25,-0.25,24.75,625,0,50,25,0.25,0,25,625,0,25,0,0.25,25,0,-25,-24.75,-25,347.122,25,24.75,0.99,322.122,25,0
967,1.01,0.99,144,1.44,0.01,3.0,3.0,12.12,25.12,25.12,-11.88,-24.88,-24.88,300,300,37,37,11.88,-13,-13,625,625,50,13,24.88,0,625,13,24.88,0,322.718,12,0.12,0.01,297.718,25,25
968,1.99,0.01,1,0.99,0.98,0.0,0.0,1.99,0.99,0.99,-0.01,0.99,0.99,0,0,1,1,0.01,1,1,0,0,0,-1,-0.99,0,0,-1,-0.99,0,0.9913333333333333,1,0.99,0.99,0.9913333333333333,0,0
969,1.99,0.01,625,618.75,612.56,0.0,0.0,49.75,24.75,24.75,-0.25,24.75,24.75,0,0,25,25,0.25,25,25,0,0,0,-25,-24.75,0,0,-25,-24.75,0,321.768,25,24.75,0.99,321.768,0,0
970,1.99,0.01,169,167.31,165.64,321.75,321.75,25.87,37.87,37.87,-0.13,-12.13,-12.13,325,325,38,38,0.13,-12,-12,625,625,50,12,12.13,0,625,12,12.13,0,118.42333333333333,13,12.87,0.99,93.42333333333333,25,25
971,1.99,0.01,625,618.75,612.56,0.0,297.0,49.75,24.75,36.75,-0.25,24.75,12.75,0,300,25,37,0.25,25,13,0,0,12,-25,-24.75,-12,144,-13,-12.75,12,324.81333333333333,25,24.75,0.99,324.81333333333333,0,12
972,1.01,0.99,625,6.25,0.06,6.25,6.25,25.25,25.25,25.25,-24.75,-24.75,-24.75,625,625,50,50,24.75,0,0,625,625,50,0,24.75,0,625,0,24.75,0,647.2113333333333,25,0.25,0.01,622.2113333333333,25,25
973,1.99,0.01,169,167.31,165.64,0.0,321.75,25.87,12.87,37.87,-0.13,12.87,-12.13,0,325,13,38,0.13,13,-12,0,0,25,-13,-12.87,-25,625,12,12.13,25,93.29933333333334,13,12.87,0.99,93.29933333333334,0,25
974,1.99,0.01,625,618.75,612.56,0.0,618.75,49.75,24.75,49.75,-0.25,24.75,-0.25,0,625,25,50,0.25,25,0,0,0,25,-25,-24.75,-25,625,0,0.25,25,328.0106666666667,25,24.75,0.99,328.0106666666667,0,25
975,1.01,0.99,1,0.01,0.0,0.24,0.25,1.01,24.01,25.01,-0.99,-23.99,-24.99,24,25,25,26,0.99,-23,-24,576,600,49,23,23.99,-1,625,24,24.99,1,48.792,1,0.01,0.01,24.792,24,25
976,1.99,0.01,4,3.96,3.92,0.0,0.0,3.98,1.98,1.98,-0.02,1.98,1.98,0,0,2,2,0.02,2,2,0,0,0,-2,-1.98,0,0,-2,-1.98,0,2.966666666666667,2,1.98,0.99,2.966666666666667,0,0
977,1.99,0.01,1,0.99,0.98,0.0,0.0,1.99,0.99,0.99,-0.01,0.99,0.99,0,0,1,1,0.01,1,1,0,0,0,-1,-0.99,0,0,-1,-0.99,0,0.988,1,0.99,0.99,0.988,0,0
978,1.01,0.99,169,1.69,0.02,0.0,0.0,13.13,0.13,0.13,-12.87,0.13,0.13,0,0,13,13,12.87,13,13,0,0,0,-13,-0.13,0,0,-13,-0.13,0,0.878,13,0.13,0.01,0.878,0,0
979,1.99,0.01,1,0.99,0.98,0.0,24.75,1.99,0.99,25.99,-0.01,0.99,-24.01,0,25,1,26,0.01,1,-24,0,0,25,-1,-0.99,-25,625,24,24.01,25,1.176,1,0.99,0.99,1.176,0,25
980,1.01,0.99,1,0.01,0.0,0.0,0.0,1.01,0.01,0.01,-0.99,0.01,0.01,0,0,1,1,0.99,1,1,0,0,0,-1,-0.01,0,0,-1,-0.01,0,0.008,1,0.01,0.01,0.008,0,0
981,1.09,0.91,625,57.4,5.27,0.0,57.4,27.3,2.3,27.3,-22.7,2.3,-22.7,0,625,25,50,22.7,25,0,0,0,25,-25,-2.3,-25,625,0,22.7,25,597.2773333333333,25,2.3,0.09183458033420318,597.2773333333333,0,25
982,1.99,0.01,1,0.99,0.98,0.0,0.0,1.99,0.99,0.99,-0.01,0.99,0.99,0,0,1,1,0.01,1,1,0,0,0,-1,-0.99,0,0,-1,-0.99,0,0.9906666666666667,1,0.99,0.99,0.9906666666666667,0,0
983,1.99,0.01,625,618.75,612.56,0.0,0.0,49.75,24.75,24.75,-0.25,24.75,24.75,0,0,25,25,0.25,25,25,0,0,0,-25,-24.75,0,0,-25,-24.75,0,321.50733333333335,25,24.75,0.99,321.50733333333335,0,0
984,1.99,0.01,1,0.99,0.98,24.75,24.75,1.99,25.99,25.99,-0.01,-24.01,-24.01,25,25,26,26,0.01,-24,-24,625,625,50,24,24.01,0,625,24,24.01,0,26.176,1,0.99,0.99,1.1759999999999984,25,25
985,1.01,0.99,4,0.04,0.0,0.5,0.0,2.02,25.02,0.02,-1.98,-24.98,0.02,50,0,27,2,1.98,-23,2,625,0,25,23,24.98,25,0,-2,-0.02,-25,25.032666666666668,2,0.02,0.01,0.03266666666666751,25,0
986,1.99,0.01,1,0.99,0.98,24.75,0.0,1.99,25.99,0.99,-0.01,-24.01,0.99,25,0,26,1,0.01,-24,1,625,0,25,24,24.01,25,0,-1,-0.99,-25,25.994666666666667,1,0.99,0.99,0.9946666666666673,25,0
987,1.01,0.99,625,6.25,0.06,0.0,0.0,25.25,0.25,0.25,-24.75,0.25,0.25,0,0,25,25,24.75,25,25,0,0,0,-25,-0.25,0,0,-25,-0.25,0,3.138,25,0.25,0.01,3.138,0,0
988,1.01,0.99,1,0.01,0.0,0.24,0.25,1.01,24.01,25.01,-0.99,-23.99,-24.99,24,25,25,26,0.99,-23,-24,576,600,49,23,23.99,-1,625,24,24.99,1,48.728,1,0.01,0.01,24.728,24,25
989,1.99,0.01,4,3.96,3.92,0.0,0.0,3.98,1.98,1.98,-0.02,1.98,1.98,0,0,2,2,0.02,2,2,0,0,0,-2,-1.98,0,0,-2,-1.98,0,2.966,2,1.98,0.99,2.966,0,0
990,1.83,0.17,625,517.5,428.49,517.5,248.4,45.7,45.7,32.7,-4.3,-4.3,8.7,625,300,50,37,4.3,0,13,625,300,37,0,4.3,13,144,-13,-8.7,-13,346.1206666666667,25,20.7,0.827999775353927,321.1206666666667,25,12
991,1.99,0.01,625,618.75,612.56,0.0,618.75,49.75,24.75,49.75,-0.25,24.75,-0.25,0,625,25,50,0.25,25,0,0,0,25,-25,-24.75,-25,625,0,0.25,25,328.07533333333333,25,24.75,0.99,328.07533333333333,0,25
992,1.99,0.01,1,0.99,0.98,0.0,0.0,1.99,0.99,0.99,-0.01,0.99,0.99,0,0,1,1,0.01,1,1,0,0,0,-1,-0.99,0,0,-1,-0.99,0,0.9846666666666667,1,0.99,0.99,0.9846666666666667,0,0
993,1.01,0.99,625,6.25,0.06,0.0,0.0,25.25,0.25,0.25,-24.75,0.25,0.25,0,0,25,25,24.75,25,25,0,0,0,-25,-0.25,0,0,-25,-0.25,0,3.3893333333333335,25,0.25,0.01,3.3893333333333335,0,0
994,1.99,0.01,625,618.75,612.56,0.0,321.75,49.75,24.75,37.75,-0.25,24.75,11.75,0,325,25,38,0.25,25,12,0,0,13,-25,-24.75,-13,169,-12,-11.75,13,325.0013333333333,25,24.75,0.99,325.0013333333333,0,13
995,1.99,0.01,625,618.75,612.56,0.0,618.75,49.75,24.75,49.75,-0.25,24.75,-0.25,0,625,25,50,0.25,25,0,0,0,25,-25,-24.75,-25,625,0,0.25,25,327.888,25,24.75,0.99,327.888,0,25
996,1.01,0.99,169,1.69,0.02,3.25,3.25,13.13,25.13,25.13,-12.87,-24.87,-24.87,325,325,38,38,12.87,-12,-12,625,625,50,12,24.87,0,625,12,24.87,0,348.01,13,0.13,0.01000000168537027,323.01,25,25
997,1.99,0.01,625,618.75,612.56,618.75,321.75,49.75,49.75,37.75,-0.25,-0.25,11.75,625,325,50,38,0.25,0,12,625,325,38,0,0.25,12,169,-12,-11.75,-12,349.998,25,24.75,0.99,324.998,25,13
998,1.99,0.01,169,167.31,165.64,0.0,321.75,25.87,12.87,37.87,-0.13,12.87,-12.13,0,325,13,38,0.13,13,-12,0,0,25,-13,-12.87,-25,625,12,12.13,25,93.40666666666667,13,12.87,0.99,93.40666666666667,0,25
999,1.99,0.01,225,222.75,220.52,0.0,371.25,29.85,14.85,39.85,-0.15,14.85,-10.15,0,375,15,40,0.15,15,-10,0,0,25,-15,-14.85,-25,625,10,10.15,25,122.576,15,14.85,0.99,122.576,0,25
1000,1.99,0.01,1,0.99,0.98,0.0,0.99,1.99,0.99,1.99,-0.01,0.99,-0.01,0,1,1,2,0.01,1,0,0,0,1,-1,-0.99,-1,1,0,0.01,1,1.0,1,0.99,0.99,1.0,0,1
1001,1.99,0.01,625,618.75,612.56,618.75,0.0,49.75,49.75,24.75,-0.25,-0.25,24.75,625,0,50,25,0.25,0,25,625,0,25,0,0.25,25,0,-25,-24.75,-25,346.75733333333335,25,24.75,0.99,321.75733333333335,25,0
1002,1.99,0.01,1,0.99,0.98,0.0,0.0,1.99,0.99,0.99,-0.01,0.99,0.99,0,0,1,1,0.01,1,1,0,0,0,-1,-0.99,0,0,-1,-0.99,0,0.992,1,0.99,0.99,0.992,0,0
1003,1.99,0.01,625,618.75,612.56,0.0,0.0,49.75,24.75,24.75,-0.25,24.75,24.75,0,0,25,25,0.25,25,25,0,0,0,-25,-24.75,0,0,-25,-24.75,0,321.89866666666666,25,24.75,0.99,321.89866666666666,0,0
1004,1.01,0.99,1,0.01,0.0,0.0,0.25,1.01,0.01,25.01,-0.99,0.01,-24.99,0,25,1,26,0.99,1,-24,0,0,25,-1,-0.01,-25,625,24,24.99,25,24.744,1,0.01,0.01,24.744,0,25
1005,1.99,0.01,1,0.99,0.98,0.0,0.99,1.99,0.99,1.99,-0.01,0.99,-0.01,0,1,1,2,0.01,1,0,0,0,1,-1,-0.99,-1,1,0,0.01,1,1.0,1,0.99,0.99,1.0,0,1
1006,1.99,0.01,625,618.75,612.56,618.75,0.0,49.75,49.75,24.75,-0.25,-0.25,24.75,625,0,50,25,0.25,0,25,625,0,25,0,0.25,25,0,-25,-24.75,-25,347.122,25,24.75,0.99,322.122,25,0
1007,1.01,0.99,144,1.44,0.01,3.0,3.0,12.12,25.12,25.12,-11.88,-24.88,-24.88,300,300,37,37,11.88,-13,-13,625,625,50,13,24.88,0,625,13,24.88,0,322.718,12,0.12,0.01,297.718,25,25
1008,1.99,0.01,1,0.99,0.98,0.0,0.0,1.99,0.99,0.99,-0.01,0.99,0.99,0,0,1,1,0.01,1,1,0,0,0,-1,-0.99,0,0,-1,-0.99,0,0.9913333333333333,1,0.99,0.99,0.9913333333333333,0,0
1009,1.99,0.01,625,618.75,612.56,0.0,0.0,49.75,24.75,24.75,-0.25,24.75,24.75,0,0,25,25,0.25,25,25,0,0,0,-25,-24.75,0,0,-25,-24.75,0,321.768,25,24.75,0.99,321.768,0,0
1010,1.99,0.01,169,167.31,165.64,321.75,321.75,25.87,37.87,37.87,-0.13,-12.13,-12.13,325,325,38,38,0.13,-12,-12,625,625,50,12,12.13,0,625,12,12.13,0,118.42333333333333,13,12.87,0.99,93.42333333333333,25,25
1011,1.99,0.01,625,618.75,612.56,0.0,297.0,49.75,24.75,36.75,-0.25,24.75,12.75,0,300,25,37,0.25,25,13,0,0,12,-25,-24.75,-12,144,-13,-12.75,12,324.81333333333333,25,24.75,0.99,324.81333333333333,0,12
1012,1.01,0.99,625,6.25,0.06,6.25,6.25,25.25,25.25,25.25,-24.75,-24.75,-24.75,625,625,50,50,24.75,0,0,625,625,50,0,24.75,0,625,0,24.75,0,647.2113333333333,25,0.25,0.01,622.2113333333333,25,25
1013,1.99,0.01,169,167.31,165.64,0.0,321.75,25.87,12.87,37.87,-0.13,12.87,-12.13,0,325,13,38,0.13,13,-12,0,0,25,-13,-12.87,-25,625,12,12.13,25,93.29933333333334,13,12.87,0.99,93.29933333333334,0,25
1014,1.99,0.01,625,618.75,612.56,0.0,618.75,49.75,24.75,49.75,-0.25,24.75,-0.25,0,625,25,50,0.25,25,0,0,0,25,-25,-24.75,-25,625,0,0.25,25,328.0106666666667,25,24.75,0.99,328.0106666666667,0,25
1015,1.01,0.99,1,0.01,0.0,0.24,0.25,1.01,24.01,25.01,-0.99,-23.99,-24.99,24,25,25,26,0.99,-23,-24,576,600,49,23,23.99,-1,625,24,24.99,1,48.792,1,0.01,0.01,24.792,24,25
1016,1.99,0.01,4,3.96,3.92,0.0,0.0,3.98,1.98,1.98,-0.02,1.98,1.98,0,0,2,2,0.02,2,2,0,0,0,-2,-1.98,0,0,-2,-1.98,0,2.966666666666667,2,1.98,0.99,2.966666666666667,0,0
1017,1.99,0.01,1,0.99,0.98,0.0,0.0,1.99,0.99,0.99,-0.01,0.99,0.99,0,0,1,1,0.01,1,1,0,0,0,-1,-0.99,0,0,-1,-0.99,0,0.988,1,0.99,0.99,0.988,0,0
1018,1.01,0.99,169,1.69,0.02,0.0,0.0,13.13,0.13,0.13,-12.87,0.13,0.13,0,0,13,13,12.87,13,13,0,0,0,-13,-0.13,0,0,-13,-0.13,0,0.878,13,0.13,0.01,0.878,0,0
1019,1.99,0.01,1,0.99,0.98,0.0,24.75,1.99,0.99,25.99,-0.01,0.99,-24.01,0,25,1,26,0.01,1,-24,0,0,25,-1,-0.99,-25,625,24,24.01,25,1.176,1,0.99,0.99,1.176,0,25
1020,1.01,0.99,1,0.01,0.0,0.0,0.0,1.01,0.01,0.01,-0.99,0.01,0.01,0,0,1,1,0.99,1,1,0,0,0,-1,-0.01,0,0,-1,-0.01,0,0.008,1,0.01,0.01,0.008,0,0
1021,1.09,0.91,625,57.4,5.27,0.0,57.4,27.3,2.3,27.3,-22.7,2.3,-22.7,0,625,25,50,22.7,25,0,0,0,25,-25,-2.3,-25,625,0,22.7,25,597.2773333333333,25,2.3,0.09183458033420318,597.2773333333333,0,25
1022,1.99,0.01,1,0.99,0.98,0.0,0.0,1.99,0.99,0.99,-0.01,0.99,0.99,0,0,1,1,0.01,1,1,0,0,0,-1,-0.99,0,0,-1,-0.99,0,0.9906666666666667,1,0.99,0.99,0.9906666666666667,0,0
1023,1.99,0.01,625,618.75,612.56,0.0,0.0,49.75,24.75,24.75,-0.25,24.75,24.75,0,0,25,25,0.25,25,25,0,0,0,-25,-24.75,0,0,-25,-24.75,0,321.50733333333335,25,24.75,0.99,321.50733333333335,0,0
1024,1.99,0.01,1,0.99,0.98,24.75,24.75,1.99,25.99,25.99,-0.01,-24.01,-24.01,25,25,26,26,0.01,-24,-24,625,625,50,24,24.01,0,625,24,24.01,0,26.176,1,0.99,0.99,1.1759999999999984,25,25
1025,1.01,0.99,4,0.04,0.0,0.5,0.0,2.02,25.02,0.02,-1.98,-24.98,0.02,50,0,27,2,1.98,-23,2,625,0,25,23,24.98,25,0,-2,-0.02,-25,25.032666666666668,2,0.02,0.01,0.03266666666666751,25,0
1026,1.99,0.01,1,0.99,0.98,24.75,0.0,1.99,25.99,0.99,-0.01,-24.01,0.99,25,0,26,1,0.01,-24,1,625,0,25,24,24.01,25,0,-1,-0.99,-25,25.994666666666667,1,0.99,0.99,0.9946666666666673,25,0
1027,1.01,0.99,625,6.25,0.06,0.0,0.0,25.25,0.25,0.25,-24.75,0.25,0.25,0,0,25,25,24.75,25,25,0,0,0,-25,-0.25,0,0,-25,-0.25,0,3.138,25,0.25,0.01,3.138,0,0
1028,1.01,0.99,1,0.01,0.0,0.24,0.25,1.01,24.01,25.01,-0.99,-23.99,-24.99,24,25,25,26,0.99,-23,-24,576,600,49,23,23.99,-1,625,24,24.99,1,48.728,1,0.01,0.01,24.728,24,25
1029,1.99,0.01,4,3.96,3.92,0.0,0.0,3.98,1.98,1.98,-0.02,1.98,1.98,0,0,2,2,0.02,2,2,0,0,0,-2,-1.98,0,0,-2,-1.98,0,2.966,2,1.98,0.99,2.966,0,0
1030,1.83,0.17,625,517.5,428.49,517.5,248.4,45.7,45.7,32.7,-4.3,-4.3,8.7,625,300,50,37,4.3,0,13,625,300,37,0,4.3,13,144,-13,-8.7,-13,346.1206666666667,25,20.7,0.827999775353927,321.1206666666667,25,12
1031,1.99,0.01,625,618.75,612.56,0.0,618.75,49.75,24.75,49.75,-0.25,24.75,-0.25,0,625,25,50,0.25,25,0,0,0,25,-25,-24.75,-25,625,0,0.25,25,328.07533333333333,25,24.75,0.99,328.07533333333333,0,25
1032,1.99,0.01,1,0.99,0.98,0.0,0.0,1.99,0.99,0.99,-0.01,0.99,0.99,0,0,1,1,0.01,1,1,0,0,0,-1,-0.99,0,0,-1,-0.99,0,0.9846666666666667,1,0.99,0.99,0.9846666666666667,0,0
1033,1.01,0.99,625,6.25,0.06,0.0,0.0,25.25,0.25,0.25,-24.75,0.25,0.25,0,0,25,25,24.75,25,25,0,0,0,-25,-0.25,0,0,-25,-0.25,0,3.3893333333333335,25,0.25,0.01,3.3893333333333335,0,0
1034,1.99,0.01,625,618.75,612.56,0.0,321.75,49.75,24.75,37.75,-0.25,24.75,11.75,0,325,25,38,0.25,25,12,0,0,13,-25,-24.75,-13,169,-12,-11.75,13,325.0013333333333,25,24.75,0.99,325.0013333333333,0,13
1035,1.99,0.01,625,618.75,612.56,0.0,618.75,49.75,24.75,49.75,-0.25,24.75,-0.25,0,625,25,50,0.25,25,0,0,0,25,-25,-24.75,-25,625,0,0.25,25,327.888,25,24.75,0.99,327.888,0,25
1036,1.01,0.99,169,1.69,0.02,3.25,3.25,13.13,25.13,25.13,-12.87,-24.87,-24.87,325,325,38,38,12.87,-12,-12,625,625,50,12,24.87,0,625,12,24.87,0,348.01,13,0.13,0.01000000168537027,323.01,25,25
1037,1.99,0.01,625,618.75,612.56,618.75,321.75,49.75,49.75,37.75,-0.25,-0.25,11.75,625,325,50,38,0.25,0,12,625,325,38,0,0.25,12,169,-12,-11.75,-12,349.998,25,24.75,0.99,324.998,25,13
1038,1.99,0.01,169,167.31,165.64,0.0,321.75,25.87,12.87,37.87,-0.13,12.87,-12.13,0,325,13,38,0.13,13,-12,0,0,25,-13,-12.87,-25,625,12,12.13,25,93.40666666666667,13,12.87,0.99,93.40666666666667,0,25
1039,1.99,0.01,225,222.75,220.52,0.0,371.25,29.85,14.85,39.85,-0.15,14.85,-10.15,0,375,15,40,0.15,15,-10,0,0,25,-15,-14.85,-25,625,10,10.15,25,122.576,15,14.85,0.99,122.576,0,25
1040,1.99,0.01,1,0.99,0.98,0.0,0.99,1.99,0.99,1.99,-0.01,0.99,-0.01,0,1,1,2,0.01,1,0,0,0,1,-1,-0.99,-1,1,0,0.01,1,1.0,1,0.99,0.99,1.0,0,1
1041,1.99,0.01,625,618.75,612.56,618.75,0.0,49.75,49.75,24.75,-0.25,-0.25,24.75,625,0,50,25,0.25,0,25,625,0,25,0,0.25,25,0,-25,-24.75,-25,346.75733333333335,25,24.75,0.99,321.75733333333335,25,0
1042,1.99,0.01,1,0.99,0.98,0.0,0.0,1.99,0.99,0.99,-0.01,0.99,0.99,0,0,1,1,0.01,1,1,0,0,0,-1,-0.99,0,0,-1,-0.99,0,0.992,1,0.99,0.99,0.992,0,0
1043,1.99,0.01,625,618.75,612.56,0.0,0.0,49.75,24.75,24.75,-0.25,24.75,24.75,0,0,25,25,0.25,25,25,0,0,0,-25,-24.75,0,0,-25,-24.75,0,321.89866666666666,25,24.75,0.99,321.89866666666666,0,0
1044,1.01,0.99,1,0.01,0.0,0.0,0.25,1.01,0.01,25.01,-0.99,0.01,-24.99,0,25,1,26,0.99,1,-24,0,0,25,-1,-0.01,-25,625,24,24.99,25,24.744,1,0.01,0.01,24.744,0,25
1045,1.99,0.01,1,0.99,0.98,0.0,0.99,1.99,0.99,1.99,-0.01,0.99,-0.01,0,1,1,2,0.01,1,0,0,0,1,-1,-0.99,-1,1,0,0.01,1,1.0,1,0.99,0.99,1.0,0,1
1046,1.99,0.01,625,618.75,612.56,618.75,0.0,49.75,49.75,24.75,-0.25,-0.25,24.75,625,0,50,25,0.25,0,25,625,0,25,0,0.25,25,0,-25,-24.75,-25,347.122,25,24.75,0.99,322.122,25,0
1047,1.01,0.99,144,1.44,0.01,3.0,3.0,12.12,25.12,25.12,-11.88,-24.88,-24.88,300,300,37,37,11.88,-13,-13,625,625,50,13,24.88,0,625,13,24.88,0,322.718,12,0.12,0.01,297.718,25,25
1048,1.99,0.01,1,0.99,0.98,0.0,0.0,1.99,0.99,0.99,-0.01,0.99,0.99,0,0,1,1,0.01,1,1,0,0,0,-1,-0.99,0,0,-1,-0.99,0,0.9913333333333333,1,0.99,0.99,0.9913333333333333,0,0
1049,1.99,0.01,625,618.75,612.56,0.0,0.0,49.75,24.75,24.75,-0.25,24.75,24.75,0,0,25,25,0.25,25,25,0,0,0,-25,-24.75,0,0,-25,-24.75,0,321.768,25,24.75,0.99,321.768,0,0
1050,1.99,0.01,169,167.31,165.64,321.75,321.75,25.87,37.87,37.87,-0.13,-12.13,-12.13,325,325,38,38,0.13,-12,-12,625,625,50,12,12.13,0,625,12,12.13,0,118.42333333333333,13,12.87,0.99,93.42333333333333,25,25
1051,1.99,0.01,625,618.75,612.56,0.0,297.0,49.75,24.75,36.75,-0.25,24.75,12.75,0,300,25,37,0.25,25,13,0,0,12,-25,-24.75,-12,144,-13,-12.75,12,324.81333333333333,25,24.75,0.99,324.81333333333333,0,12
1052,1.01,0.99,625,6.25,0.06,6.25,6.25,25.25,25.25,25.25,-24.75,-24.75,-24.75,625,625,50,50,24.75,0,0,625,625,50,0,24.75,0,625,0,24.75,0,647.2113333333333,25,0.25,0.01,622.2113333333333,25,25
1053,1.99,0.01,169,167.31,165.64,0.0,321.75,25.87,12.87,37.87,-0.13,12.87,-12.13,0,325,13,38,0.13,13,-12,0,0,25,-13,-12.87,-25,625,12,12.13,25,93.29933333333334,13,12.87,0.99,93.29933333333334,0,25
1054,1.99,0.01,625,618.75,612.56,0.0,618.75,49.75,24.75,49.75,-0.25,24.75,-0.25,0,625,25,50,0.25,25,0,0,0,25,-25,-24.75,-25,625,0,0.25,25,328.0106666666667,25,24.75,0.99,328.0106666666667,0,25
1055,1.01,0.99,1,0.01,0.0,0.24,0.25,1.01,24.01,25.01,-0.99,-23.99,-24.99,24,25,25,26,0.99,-23,-24,576,600,49,23,23.99,-1,625,24,24.99,1,48.792,1,0.01,0.01,24.792,24,25
1056,1.99,0.01,4,3.96,3.92,0.0,0.0,3.98,1.98,1.98,-0.02,1.98,1.98,0,0,2,2,0.02,2,2,0,0,0,-2,-1.98,0,0,-2,-1.98,0,2.966666666666667,2,1.98,0.99,2.966666666666667,0,0
1057,1.99,0.01,1,0.99,0.98,0.0,0.0,1.99,0.99,0.99,-0.01,0.99,0.99,0,0,1,1,0.01,1,1,0,0,0,-1,-0.99,0,0,-1,-0.99,0,0.988,1,0.99,0.99,0.988,0,0
1058,1.01,0.99,169,1.69,0.02,0.0,0.0,13.13,0.13,0.13,-12.87,0.13,0.13,0,0,13,13,12.87,13,13,0,0,0,-13,-0.13,0,0,-13,-0.13,0,0.878,13,0.13,0.01,0.878,0,0
1059,1.99,0.01,1,0.99,0.98,0.0,24.75,1.99,0.99,25.99,-0.01,0.99,-24.01,0,25,1,26,0.01,1,-24,0,0,25,-1,-0.99,-25,625,24,24.01,25,1.176,1,0.99,0.99,1.176,0,25
1060,1.01,0.99,1,0.01,0.0,0.0,0.0,1.01,0.01,0.01,-0.99,0.01,0.01,0,0,1,1,0.99,1,1,0,0,0,-1,-0.01,0,0,-1,-0.01,0,0.008,1,0.01,0.01,0.008,0,0
1061,1.09,0.91,625,57.4,5.27,0.0,57.4,27.3,2.3,27.3,-22.7,2.3,-22.7,0,625,25,50,22.7,25,0,0,0,25,-25,-2.3,-25,625,0,22.7,25,597.2773333333333,25,2.3,0.09183458033420318,597.2773333333333,0,25
1062,1.99,0.01,1,0.99,0.98,0.0,0.0,1.99,0.99,0.99,-0.01,0.99,0.99,0,0,1,1,0.01,1,1,0,0,0,-1,-0.99,0,0,-1,-0.99,0,0.9906666666666667,1,0.99,0.99,0.9906666666666667,0,0
1063,1.99,0.01,625,618.75,612.56,0.0,0.0,49.75,24.75,24.75,-0.25,24.75,24.75,0,0,25,25,0.25,25,25,0,0,0,-25,-24.75,0,0,-25,-24.75,0,321.50733333333335,25,24.75,0.99,321.50733333333335,0,0
1064,1.99,0.01,1,0.99,0.98,24.75,24.75,1.99,25.99,25.99,-0.01,-24.01,-24.01,25,25,26,26,0.01,-24,-24,625,625,50,24,24.01,0,625,24,24.01,0,26.176,1,0.99,0.99,1.1759999999999984,25,25
1065,1.01,0.99,4,0.04,0.0,0.5,0.0,2.02,25.02,0.02,-1.98,-24.98,0.02,50,0,27,2,1.98,-23,2,625,0,25,23,24.98,25,0,-2,-0.02,-25,25.032666666666668,2,0.02,0.01,0.03266666666666751,25,0
1066,1.99,0.01,1,0.99,0.98,24.75,0.0,1.99,25.99,0.99,-0.01,-24.01,0.99,25,0,26,1,0.01,-24,1,625,0,25,24,24.01,25,0,-1,-0.99,-25,25.994666666666667,1,0.99,0.99,0.9946666666666673,25,0
1067,1.01,0.99,625,6.25,0.06,0.0,0.0,25.25,0.25,0.25,-24.75,0.25,0.25,0,0,25,25,24.75,25,25,0,0,0,-25,-0.25,0,0,-25,-0.25,0,3.138,25,0.25,0.01,3.138,0,0
1068,1.01,0.99,1,0.01,0.0,0.24,0.25,1.01,24.01,25.01,-0.99,-23.99,-24.99,24,25,25,26,0.99,-23,-24,576,600,49,23,23.99,-1,625,24,24.99,1,48.728,1,0.01,0.01,24.728,24,25
1069,1.99,0.01,4,3.96,3.92,0.0,0.0,3.98,1.98,1.98,-0.02,1.98,1.98,0,0,2,2,0.02,2,2,0,0,0,-2,-1.98,0,0,-2,-1.98,0,2.966,2,1.98,0.99,2.966,0,0
1070,1.83,0.17,625,517.5,428.49,517.5,248.4,45.7,45.7,32.7,-4.3,-4.3,8.7,625,300,50,37,4.3,0,13,625,300,37,0,4.3,13,144,-13,-8.7,-13,346.1206666666667,25,20.7,0.827999775353927,321.1206666666667,25,12
1071,1.99,0.01,625,618.75,612.56,0.0,618.75,49.75,24.75,49.75,-0.25,24.75,-0.25,0,625,25,50,0.25,25,0,0,0,25,-25,-24.75,-25,625,0,0.25,25,328.07533333333333,25,24.75,0.99,328.07533333333333,0,25
1072,1.99,0.01,1,0.99,0.98,0.0,0.0,1.99,0.99,0.99,-0.01,0.99,0.99,0,0,1,1,0.01,1,1,0,0,0,-1,-0.99,0,0,-1,-0.99,0,0.9846666666666667,1,0.99,0.99,0.9846666666666667,0,0
1073,1.01,0.99,625,6.25,0.06,0.0,0.0,25.25,0.25,0.25,-24.75,0.25,0.25,0,0,25,25,24.75,25,25,0,0,0,-25,-0.25,0,0,-25,-0.25,0,3.3893333333333335,25,0.25,0.01,3.3893333333333335,0,0
1074,1.99,0.01,625,618.75,612.56,0.0,321.75,49.75,24.75,37.75,-0.25,24.75,11.75,0,325,25,38,0.25,25,12,0,0,13,-25,-24.75,-13,169,-12,-11.75,13,325.0013333333333,25,24.75,0.99,325.0013333333333,0,13
1075,1.99,0.01,625,618.75,612.56,0.0,618.75,49.75,24.75,49.75,-0.25,24.75,-0.25,0,625,25,50,0.25,25,0,0,0,25,-25,-24.75,-25,625,0,0.25,25,327.888,25,24.75,0.99,327.888,0,25
1076,1.01,0.99,169,1.69,0.02,3.25,3.25,13.13,25.13,25.13,-12.87,-24.87,-24.87,325,325,38,38,12.87,-12,-12,625,625,50,12,24.87,0,625,12,24.87,0,348.01,13,0.13,0.01000000168537027,323.01,25,25
1077,1.99,0.01,625,618.75,612.56,618.75,321.75,49.75,49.75,37.75,-0.25,-0.25,11.75,625,325,50,38,0.25,0,12,625,325,38,0,0.25,12,169,-12,-11.75,-12,349.998,25,24.75,0.99,324.998,25,13
1078,1.99,0.01,169,167.31,165.64,0.0,321.75,25.87,12.87,37.87,-0.13,12.87,-12.13,0,325,13,38,0.13,13,-12,0,0,25,-13,-12.87,-25,625,12,12.13,25,93.40666666666667,13,12.87,0.99,93.40666666666667,0,25
1079,1.99,0.01,225,222.75,220.52,0.0,371.25,29.85,14.85,39.85,-0.15,14.85,-10.15,0,375,15,40,0.15,15,-10,0,0,25,-15,-14.85,-25,625,10,10.15,25,122.576,15,14.85,0.99,122.576,0,25
1080,1.99,0.01,1,0.99,0.98,0.0,0.99,1.99,0.99,1.99,-0.01,0.99,-0.01,0,1,1,2,0.01,1,0,0,0,1,-1,-0.99,-1,1,0,0.01,1,1.0,1,0.99,0.99,1.0,0,1
1081,1.99,0.01,625,618.75,612.56,618.75,0.0,49.75,49.75,24.75,-0.25,-0.25,24.75,625,0,50,25,0.25,0,25,625,0,25,0,0.25,25,0,-25,-24.75,-25,346.75733333333335,25,24.75,0.99,321.75733333333335,25,0
1082,1.99,0.01,1,0.99,0.98,0.0,0.0,1.99,0.99,0.99,-0.01,0.99,0.99,0,0,1,1,0.01,1,1,0,0,0,-1,-0.99,0,0,-1,-0.99,0,0.992,1,0.99,0.99,0.992,0,0
1083,1.99,0.01,625,618.75,612.56,0.0,0.0,49.75,24.75,24.75,-0.25,24.75,24.75,0,0,25,25,0.25,25,25,0,0,0,-25,-24.75,0,0,-25,-24.75,0,321.89866666666666,25,24.75,0.99,321.89866666666666,0,0
1084,1.01,0.99,1,0.01,0.0,0.0,0.25,1.01,0.01,25.01,-0.99,0.01,-24.99,0,25,1,26,0.99,1,-24,0,0,25,-1,-0.01,-25,625,24,24.99,25,24.744,1,0.01,0.01,24.744,0,25
1085,1.99,0.01,1,0.99,0.98,0.0,0.99,1.99,0.99,1.99,-0.01,0.99,-0.01,0,1,1,2,0.01,1,0,0,0,1,-1,-0.99,-1,1,0,0.01,1,1.0,1,0.99,0.99,1.0,0,1
1086,1.99,0.01,625,618.75,612.56,618.75,0.0,49.75,49.75,24.75,-0.25,-0.25,24.75,625,0,50,25,0.25,0,25,625,0,25,0,0.25,25,0,-25,-24.75,-25,347.122,25,24.75,0.99,322.122,25,0
1087,1.01,0.99,144,1.44,0.01,3.0,3.0,12.12,25.12,25.12,-11.88,-24.88,-24.88,300,300,37,37,11.88,-13,-13,625,625,50,13,24.88,0,625,13,24.88,0,322.718,12,0.12,0.01,297.718,25,25
1088,1.99,0.01,1,0.99,0.98,0.0,0.0,1.99,0.99,0.99,-0.01,0.99,0.99,0,0,1,1,0.01,1,1,0,0,0,-1,-0.99,0,0,-1,-0.99,0,0.9913333333333333,1,0.99,0.99,0.9913333333333333,0,0
1089,1.99,0.01,625,618.75,612.56,0.0,0.0,49.75,24.75,24.75,-0.25,24.75,24.75,0,0,25,25,0.25,25,25,0,0,0,-25,-24.75,0,0,-25,-24.75,0,321.768,25,24.75,0.99,321.768,0,0
1090,1.99,0.01,169,167.31,165.64,321.75,321.75,25.87,37.87,37.87,-0.13,-12.13,-12.13,325,325,38,38,0.13,-12,-12,625,625,50,12,12.13,0,625,12,12.13,0,118.42333333333333,13,12.87,0.99,93.42333333333333,25,25
1091,1.99,0.01,625,618.75,612.56,0.0,297.0,49.75,24.75,36.75,-0.25,24.75,12.75,0,300,25,37,0.25,25,13,0,0,12,-25,-24.75,-12,144,-13,-12.75,12,324.81333333333333,25,24.75,0.99,324.81333333333333,0,12
1092,1.01,0.99,625,6.25,0.06,6.25,6.25,25.25,25.25,25.25,-24.75,-24.75,-24.75,625,625,50,50,24.75,0,0,625,625,50,0,24.75,0,625,0,24.75,0,647.2113333333333,25,0.25,0.01,622.2113333333333,25,25
1093,1.99,0.01,169,167.31,165.64,0.0,321.75,25.87,12.87,37.87,-0.13,12.87,-12.13,0,325,13,38,0.13,13,-12,0,0,25,-13,-12.87,-25,625,12,12.13,25,93.29933333333334,13,12.87,0.99,93.29933333333334,0,25
1094,1.99,0.01,625,618.75,612.56,0.0,618.75,49.75,24.75,49.75,-0.25,24.75,-0.25,0,625,25,50,0.25,25,0,0,0,25,-25,-24.75,-25,625,0,0.25,25,328.0106666666667,25,24.75,0.99,328.0106666666667,0,25
1095,1.01,0.99,1,0.01,0.0,0.24,0.25,1.01,24.01,25.01,-0.99,-23.99,-24.99,24,25,25,26,0.99,-23,-24,576,600,49,23,23.99,-1,625,24,24.99,1,48.792,1,0.01,0.01,24.792,24,25
1096,1.99,0.01,4,3.96,3.92,0.0,0.0,3.98,1.98,1.98,-0.02,1.98,1.98,0,0,2,2,0.02,2,2,0,0,0,-2,-1.98,0,0,-2,-1.98,0,2.966666666666667,2,1.98,0.99,2.966666666666667,0,0
1097,1.99,0.01,1,0.99,0.98,0.0,0.0,1.99,0.99,0.99,-0.01,0.99,0.99,0,0,1,1,0.01,1,1,0,0,0,-1,-0.99,0,0,-1,-0.99,0,0.988,1,0.99,0.99,0.988,0,0
1098,1.01,0.99,169,1.69,0.02,0.0,0.0,13.13,0.13,0.13,-12.87,0.13,0.13,0,0,13,13,12.87,13,13,0,0,0,-13,-0.13,0,0,-13,-0.13,0,0.878,13,0.13,0.01,0.878,0,0
1099,1.99,0.01,1,0.99,0.98,0.0,24.75,1.99,0.99,25.99,-0.01,0.99,-24.01,0,25,1,26,0.01,1,-24,0,0,25,-1,-0.99,-25,625,24,24.01,25,1.176,1,0.99,0.99,1.176,0,25
1100,1.01,0.99,1,0.01,0.0,0.0,0.0,1.01,0.01,0.01,-0.99,0.01,0.01,0,0,1,1,0.99,1,1,0,0,0,-1,-0.01,0,0,-1,-0.01,0,0.008,1,0.01,0.01,0.008,0,0
1101,1.09,0.91,625,57.4,5.27,0.0,57.4,27.3,2.3,27.3,-22.7,2.3,-22.7,0,625,25,50,22.7,25,0,0,0,25,-25,-2.3,-25,625,0,22.7,25,597.2773333333333,25,2.3,0.09183458033420318,597.2773333333333,0,25
1102,1.99,0.01,1,0.99,0.98,0.0,0.0,1.99,0.99,0.99,-0.01,0.99,0.99,0,0,1,1,0.01,1,1,0,0,0,-1,-0.99,0,0,-1,-0.99,0,0.9906666666666667,1,0.99,0.99,0.9906666666666667,0,0
1103,1.99,0.01,625,618.75,612.56,0.0,0.0,49.75,24.75,24.75,-0.25,24.75,24.75,0,0,25,25,0.25,25,25,0,0,0,-25,-24.75,0,0,-25,-24.75,0,321.50733333333335,25,24.75,0.99,321.50733333333335,0,0
1104,1.99,0.01,1,0.99,0.98,24.75,24.75,1.99,25.99,25.99,-0.01,-24.01,-24.01,25,25,26,26,0.01,-24,-24,625,625,50,24,24.01,0,625,24,24.01,0,26.176,1,0.99,0.99,1.1759999999999984,25,25
1105,1.01,0.99,4,0.04,0.0,0.5,0.0,2.02,25.02,0.02,-1.98,-24.98,0.02,50,0,27,2,1.98,-23,2,625,0,25,23,24.98,25,0,-2,-0.02,-25,25.032666666666668,2,0.02,0.01,0.03266666666666751,25,0
1106,1.99,0.01,1,0.99,0.98,24.75,0.0,1.99,25.99,0.99,-0.01,-24.01,0.99,25,0,26,1,0.01,-24,1,625,0,25,24,24.01,25,0,-1,-0.99,-25,25.994666666666667,1,0.99,0.99,0.9946666666666673,25,0
1107,1.01,0.99,625,6.25,0.06,0.0,0.0,25.25,0.25,0.25,-24.75,0.25,0.25,0,0,25,25,24.75,25,25,0,0,0,-25,-0.25,0,0,-25,-0.25,0,3.138,25,0.25,0.01,3.138,0,0
1108,1.01,0.99,1,0.01,0.0,0.24,0.25,1.01,24.01,25.01,-0.99,-23.99,-24.99,24,25,25,26,0.99,-23,-24,576,600,49,23,23.99,-1,625,24,24.99,1,48.728,1,0.01,0.01,24.728,24,25
1109,1.99,0.01,4,3.96,3.92,0.0,0.0,3.98,1.98,1.98,-0.02,1.98,1.98,0,0,2,2,0.02,2,2,0,0,0,-2,-1.98,0,0,-2,-1.98,0,2.966,2,1.98,0.99,2.966,0,0
1110,1.83,0.17,625,517.5,428.49,517.5,248.4,45.7,45.7,32.7,-4.3,-4.3,8.7,625,300,50,37,4.3,0,13,625,300,37,0,4.3,13,144,-13,-8.7,-13,346.1206666666667,25,20.7,0.827999775353927,321.1206666666667,25,12
1111,1.99,0.01,625,618.75,612.56,0.0,618.75,49.75,24.75,49.75,-0.25,24.75,-0.25,0,625,25,50,0.25,25,0,0,0,25,-25,-24.75,-25,625,0,0.25,25,328.07533333333333,25,24.75,0.99,328.07533333333333,0,25
1112,1.99,0.01,1,0.99,0.98,0.0,0.0,1.99,0.99,0.99,-0.01,0.99,0.99,0,0,1,1,0.01,1,1,0,0,0,-1,-0.99,0,0,-1,-0.99,0,0.9846666666666667,1,0.99,0.99,0.9846666666666667,0,0
1113,1.01,0.99,625,6.25,0.06,0.0,0.0,25.25,0.25,0.25,-24.75,0.25,0.25,0,0,25,25,24.75,25,25,0,0,0,-25,-0.25,0,0,-25,-0.25,0,3.3893333333333335,25,0.25,0.01,3.3893333333333335,0,0
1114,1.99,0.01,625,618.75,612.56,0.0,321.75,49.75,24.75,37.75,-0.25,24.75,11.75,0,325,25,38,0.25,25,12,0,0,13,-25,-24.75,-13,169,-12,-11.75,13,325.0013333333333,25,24.75,0.99,325.0013333333333,0,13
1115,1.99,0.01,625,618.75,612.56,0.0,618.75,49.75,24.75,49.75,-0.25,24.75,-0.25,0,625,25,50,0.25,25,0,0,0,25,-25,-24.75,-25,625,0,0.25,25,327.888,25,24.75,0.99,327.888,0,25
1116,1.01,0.99,169,1.69,0.02,3.25,3.25,13.13,25.13,25.13,-12.87,-24.87,-24.87,325,325,38,38,12.87,-12,-12,625,625,50,12,24.87,0,625,12,24.87,0,348.01,13,0.13,0.01000000168537027,323.01,25,25
1117,1.99,0.01,625,618.75,612.56,618.75,321.75,49.75,49.75,37.75,-0.25,-0.25,11.75,625,325,50,38,0.25,0,12,625,325,38,0,0.25,12,169,-12,-11.75,-12,349.998,25,24.75,0.99,324.998,25,13
1118,1.99,0.01,169,167.31,165.64,0.0,321.75,25.87,12.87,37.87,-0.13,12.87,-12.13,0,325,13,38,0.13,13,-12,0,0,25,-13,-12.87,-25,625,12,12.13,25,93.40666666666667,13,12.87,0.99,93.40666666666667,0,25
1119,1.99,0.01,225,222.75,220.52,0.0,371.25,29.85,14.85,39.85,-0.15,14.85,-10.15,0,375,15,40,0.15,15,-10,0,0,25,-15,-14.85,-25,625,10,10.15,25,122.576,15,14.85,0.99,122.576,0,25
1120,1.99,0.01,1,0.99,0.98,0.0,0.99,1.99,0.99,1.99,-0.01,0.99,-0.01,0,1,1,2,0.01,1,0,0,0,1,-1,-0.99,-1,1,0,0.01,1,1.0,1,0.99,0.99,1.0,0,1
1121,1.99,0.01,625,618.75,612.56,618.75,0.0,49.75,49.75,24.75,-0.25,-0.25,24.75,625,0,50,25,0.25,0,25,625,0,25,0,0.25,25,0,-25,-24.75,-25,346.75733333333335,25,24.75,0.99,321.75733333333335,25,0
1122,1.99,0.01,1,0.99,0.98,0.0,0.0,1.99,0.99,0.99,-0.01,0.99,0.99,0,0,1,1,0.01,1,1,0,0,0,-1,-0.99,0,0,-1,-0.99,0,0.992,1,0.99,0.99,0.992,0,0
1123,1.99,0.01,625,618.75,612.56,0.0,0.0,49.75,24.75,24.75,-0.25,24.75,24.75,0,0,25,25,0.25,25,25,0,0,0,-25,-24.75,0,0,-25,-24.75,0,321.89866666666666,25,24.75,0.99,321.89866666666666,0,0
1124,1.01,0.99,1,0.01,0.0,0.0,0.25,1.01,0.01,25.01,-0.99,0.01,-24.99,0,25,1,26,0.99,1,-24,0,0,25,-1,-0.01,-25,625,24,24.99,25,24.744,1,0.01,0.01,24.744,0,25
1125,1.99,0.01,1,0.99,0.98,0.0,0.99,1.99,0.99,1.99,-0.01,0.99,-0.01,0,1,1,2,0.01,1,0,0,0,1,-1,-0.99,-1,1,0,0.01,1,1.0,1,0.99,0.99,1.0,0,1
1126,1.99,0.01,625,618.75,612.56,618.75,0.0,49.75,49.75,24.75,-0.25,-0.25,24.75,625,0,50,25,0.25,0,25,625,0,25,0,0.25,25,0,-25,-24.75,-25,347.122,25,24.75,0.99,322.122,25,0
1127,1.01,0.99,144,1.44,0.01,3.0,3.0,12.12,25.12,25.12,-11.88,-24.88,-24.88,300,300,37,37,11.88,-13,-13,625,625,50,13,24.88,0,625,13,24.88,0,322.718,12,0.12,0.01,297.718,25,25
1128,1.99,0.01,1,0.99,0.98,0.0,0.0,1.99,0.99,0.99,-0.01,0.99,0.99,0,0,1,1,0.01,1,1,0,0,0,-1,-0.99,0,0,-1,-0.99,0,0.9913333333333333,1,0.99,0.99,0.9913333333333333,0,0
1129,1.99,0.01,625,618.75,612.56,0.0,0.0,49.75,24.75,24.75,-0.25,24.75,24.75,0,0,25,25,0.25,25,25,0,0,0,-25,-24.75,0,0,-25,-24.75,0,321.768,25,24.75,0.99,321.768,0,0
1130,1.99,0.01,169,167.31,165.64,321.75,321.75,25.87,37.87,37.87,-0.13,-12.13,-12.13,325,325,38,38,0.13,-12,-12,625,625,50,12,12.13,0,625,12,12.13,0,118.42333333333333,13,12.87,0.99,93.42333333333333,25,25
1131,1.99,0.01,625,618.75,612.56,0.0,297.0,49.75,24.75,36.75,-0.25,24.75,12.75,0,300,25,37,0.25,25,13,0,0,12,-25,-24.75,-12,144,-13,-12.75,12,324.81333333333333,25,24.75,0.99,324.81333333333333,0,12
1132,1.01,0.99,625,6.25,0.06,6.25,6.25,25.25,25.25,25.25,-24.75,-24.75,-24.75,625,625,50,50,24.75,0,0,625,625,50,0,24.75,0,625,0,24.75,0,647.2113333333333,25,0.25,0.01,622.2113333333333,25,25
1133,1.99,0.01,169,167.31,165.64,0.0,321.75,25.87,12.87,37.87,-0.13,12.87,-12.13,0,325,13,38,0.13,13,-12,0,0,25,-13,-12.87,-25,625,12,12.13,25,93.29933333333334,13,12.87,0.99,93.29933333333334,0,25
1134,1.99,0.01,625,618.75,612.56,0.0,618.75,49.75,24.75,49.75,-0.25,24.75,-0.25,0,625,25,50,0.25,25,0,0,0,25,-25,-24.75,-25,625,0,0.25,25,328.0106666666667,25,24.75,0.99,328.0106666666667,0,25
1135,1.01,0.99,1,0.01,0.0,0.24,0.25,1.01,24.01,25.01,-0.99,-23.99,-24.99,24,25,25,26,0.99,-23,-24,576,600,49,23,23.99,-1,625,24,24.99,1,48.792,1,0.01,0.01,24.792,24,25
1136,1.99,0.01,4,3.96,3.92,0.0,0.0,3.98,1.98,1.98,-0.02,1.98,1.98,0,0,2,2,0.02,2,2,0,0,0,-2,-1.98,0,0,-2,-1.98,0,2.966666666666667,2,1.98,0.99,2.966666666666667,0,0
1137,1.99,0.01,1,0.99,0.98,0.0,0.0,1.99,0.99,0.99,-0.01,0.99,0.99,0,0,1,1,0.01,1,1,0,0,0,-1,-0.99,0,0,-1,-0.99,0,0.988,1,0.99,0.99,0.988,0,0
1138,1.01,0.99,169,1.69,0.02,0.0,0.0,13.13,0.13,0.13,-12.87,0.13,0.13,0,0,13,13,12.87,13,13,0,0,0,-13,-0.13,0,0,-13,-0.13,0,0.878,13,0.13,0.01,0.878,0,0
1139,1.99,0.01,1,0.99,0.98,0.0,24.75,1.99,0.99,25.99,-0.01,0.99,-24.01,0,25,1,26,0.01,1,-24,0,0,25,-1,-0.99,-25,625,24,24.01,25,1.176,1,0.99,0.99,1.176,0,25
1140,1.01,0.99,1,0.01,0.0,0.0,0.0,1.01,0.01,0.01,-0.99,0.01,0.01,0,0,1,1,0.99,1,1,0,0,0,-1,-0.01,0,0,-1,-0.01,0,0.008,1,0.01,0.01,0.008,0,0
1141,1.09,0.91,625,57.4,5.27,0.0,57.4,27.3,2.3,27.3,-22.7,2.3,-22.7,0,625,25,50,22.7,25,0,0,0,25,-25,-2.3,-25,625,0,22.7,25,597.2773333333333,25,2.3,0.09183458033420318,597.2773333333333,0,25
1142,1.99,0.01,1,0.99,0.98,0.0,0.0,1.99,0.99,0.99,-0.01,0.99,0.99,0,0,1,1,0.01,1,1,0,0,0,-1,-0.99,0,0,-1,-0.99,0,0.9906666666666667,1,0.99,0.99,0.9906666666666667,0,0
1143,1.99,0.01,625,618.75,612.56,0.0,0.0,49.75,24.75,24.75,-0.25,24.75,24.75,0,0,25,25,0.25,25,25,0,0,0,-25,-24.75,0,0,-25,-24.75,0,321.50733333333335,25,24.75,0.99,321.50733333333335,0,0
1144,1.99,0.01,1,0.99,0.98,24.75,24.75,1.99,25.99,25.99,-0.01,-24.01,-24.01,25,25,26,26,0.01,-24,-24,625,625,50,24,24.01,0,625,24,24.01,0,26.176,1,0.99,0.99,1.1759999999999984,25,25
1145,1.01,0.99,4,0.04,0.0,0.5,0.0,2.02,25.02,0.02,-1.98,-24.98,0.02,50,0,27,2,1.98,-23,2,625,0,25,23,24.98,25,0,-2,-0.02,-25,25.032666666666668,2,0.02,0.01,0.03266666666666751,25,0
1146,1.99,0.01,1,0.99,0.98,24.75,0.0,1.99,25.99,0.99,-0.01,-24.01,0.99,25,0,26,1,0.01,-24,1,625,0,25,24,24.01,25,0,-1,-0.99,-25,25.994666666666667,1,0.99,0.99,0.9946666666666673,25,0
1147,1.01,0.99,625,6.25,0.06,0.0,0.0,25.25,0.25,0.25,-24.75,0.25,0.25,0,0,25,25,24.75,25,25,0,0,0,-25,-0.25,0,0,-25,-0.25,0,3.138,25,0.25,0.01,3.138,0,0
1148,1.01,0.99,1,0.01,0.0,0.24,0.25,1.01,24.01,25.01,-0.99,-23.99,-24.99,24,25,25,26,0.99,-23,-24,576,600,49,23,23.99,-1,625,24,24.99,1,48.728,1,0.01,0.01,24.728,24,25
1149,1.99,0.01,4,3.96,3.92,0.0,0.0,3.98,1.98,1.98,-0.02,1.98,1.98,0,0,2,2,0.02,2,2,0,0,0,-2,-1.98,0,0,-2,-1.98,0,2.966,2,1.98,0.99,2.966,0,0
1150,1.83,0.17,625,517.5,428.49,517.5,248.4,45.7,45.7,32.7,-4.3,-4.3,8.7,625,300,50,37,4.3,0,13,625,300,37,0,4.3,13,144,-13,-8.7,-13,346.1206666666667,25,20.7,0.827999775353927,321.1206666666667,25,12
1151,1.99,0.01,625,618.75,612.56,0.0,618.75,49.75,24.75,49.75,-0.25,24.75,-0.25,0,625,25,50,0.25,25,0,0,0,25,-25,-24.75,-25,625,0,0.25,25,328.07533333333333,25,24.75,0.99,328.07533333333333,0,25
1152,1.99,0.01,1,0.99,0.98,0.0,0.0,1.99,0.99,0.99,-0.01,0.99,0.99,0,0,1,1,0.01,1,1,0,0,0,-1,-0.99,0,0,-1,-0.99,0,0.9846666666666667,1,0.99,0.99,0.9846666666666667,0,0
1153,1.01,0.99,625,6.25,0.06,0.0,0.0,25.25,0.25,0.25,-24.75,0.25,0.25,0,0,25,25,24.75,25,25,0,0,0,-25,-0.25,0,0,-25,-0.25,0,3.3893333333333335,25,0.25,0.01,3.3893333333333335,0,0
1154,1.99,0.01,625,618.75,612.56,0.0,321.75,49.75,24.75,37.75,-0.25,24.75,11.75,0,325,25,38,0.25,25,12,0,0,13,-25,-24.75,-13,169,-12,-11.75,13,325.0013333333333,25,24.75,0.99,325.0013333333333,0,13
1155,1.99,0.01,625,618.75,612.56,0.0,618.75,49.75,24.75,49.75,-0.25,24.75,-0.25,0,625,25,50,0.25,25,0,0,0,25,-25,-24.75,-25,625,0,0.25,25,327.888,25,24.75,0.99,327.888,0,25
1156,1.01,0.99,169,1.69,0.02,3.25,3.25,13.13,25.13,25.13,-12.87,-24.87,-24.87,325,325,38,38,12.87,-12,-12,625,625,50,12,24.87,0,625,12,24.87,0,348.01,13,0.13,0.01000000168537027,323.01,25,25
1157,1.99,0.01,625,618.75,612.56,618.75,321.75,49.75,49.75,37.75,-0.25,-0.25,11.75,625,325,50,38,0.25,0,12,625,325,38,0,0.25,12,169,-12,-11.75,-12,349.998,25,24.75,0.99,324.998,25,13
1158,1.99,0.01,169,167.31,165.64,0.0,321.75,25.87,12.87,37.87,-0.13,12.87,-12.13,0,325,13,38,0.13,13,-12,0,0,25,-13,-12.87,-25,625,12,12.13,25,93.40666666666667,13,12.87,0.99,93.40666666666667,0,25
1159,1.99,0.01,225,222.75,220.52,0.0,371.25,29.85,14.85,39.85,-0.15,14.85,-10.15,0,375,15,40,0.15,15,-10,0,0,25,-15,-14.85,-25,625,10,10.15,25,122.576,15,14.85,0.99,122.576,0,25
1160,1.99,0.01,1,0.99,0.98,0.0,0.99,1.99,0.99,1.99,-0.01,0.99,-0.01,0,1,1,2,0.01,1,0,0,0,1,-1,-0.99,-1,1,0,0.01,1,1.0,1,0.99,0.99,1.0,0,1
1161,1.99,0.01,625,618.75,612.56,618.75,0.0,49.75,49.75,24.75,-0.25,-0.25,24.75,625,0,50,25,0.25,0,25,625,0,25,0,0.25,25,0,-25,-24.75,-25,346.75733333333335,25,24.75,0.99,321.75733333333335,25,0
1162,1.99,0.01,1,0.99,0.98,0.0,0.0,1.99,0.99,0.99,-0.01,0.99,0.99,0,0,1,1,0.01,1,1,0,0,0,-1,-0.99,0,0,-1,-0.99,0,0.992,1,0.99,0.99,0.992,0,0
1163,1.99,0.01,625,618.75,612.56,0.0,0.0,49.75,24.75,24.75,-0.25,24.75,24.75,0,0,25,25,0.25,25,25,0,0,0,-25,-24.75,0,0,-25,-24.75,0,321.89866666666666,25,24.75,0.99,321.89866666666666,0,0
1164,1.01,0.99,1,0.01,0.0,0.0,0.25,1.01,0.01,25.01,-0.99,0.01,-24.99,0,25,1,26,0.99,1,-24,0,0,25,-1,-0.01,-25,625,24,24.99,25,24.744,1,0.01,0.01,24.744,0,25
1165,1.99,0.01,1,0.99,0.98,0.0,0.99,1.99,0.99,1.99,-0.01,0.99,-0.01,0,1,1,2,0.01,1,0,0,0,1,-1,-0.99,-1,1,0,0.01,1,1.0,1,0.99,0.99,1.0,0,1
1166,1.99,0.01,625,618.75,612.56,618.75,0.0,49.75,49.75,24.75,-0.25,-0.25,24.75,625,0,50,25,0.25,0,25,625,0,25,0,0.25,25,0,-25,-24.75,-25,347.122,25,24.75,0.99,322.122,25,0
1167,1.01,0.99,144,1.44,0.01,3.0,3.0,12.12,25.12,25.12,-11.88,-24.88,-24.88,300,300,37,37,11.88,-13,-13,625,625,50,13,24.88,0,625,13,24.88,0,322.718,12,0.12,0.01,297.718,25,25
1168,1.99,0.01,1,0.99,0.98,0.0,0.0,1.99,0.99,0.99,-0.01,0.99,0.99,0,0,1,1,0.01,1,1,0,0,0,-1,-0.99,0,0,-1,-0.99,0,0.9913333333333333,1,0.99,0.99,0.9913333333333333,0,0
1169,1.99,0.01,625,618.75,612.56,0.0,0.0,49.75,24.75,24.75,-0.25,24.75,24.75,0,0,25,25,0.25,25,25,0,0,0,-25,-24.75,0,0,-25,-24.75,0,321.768,25,24.75,0.99,321.768,0,0
1170,1.99,0.01,169,167.31,165.64,321.75,321.75,25.87,37.87,37.87,-0.13,-12.13,-12.13,325,325,38,38,0.13,-12,-12,625,625,50,12,12.13,0,625,12,12.13,0,118.42333333333333,13,12.87,0.99,93.42333333333333,25,25
1171,1.99,0.01,625,618.75,612.56,0.0,297.0,49.75,24.75,36.75,-0.25,24.75,12.75,0,300,25,37,0.25,25,13,0,0,12,-25,-24.75,-12,144,-13,-12.75,12,324.81333333333333,25,24.75,0.99,324.81333333333333,0,12
1172,1.01,0.99,625,6.25,0.06,6.25,6.25,25.25,25.25,25.25,-24.75,-24.75,-24.75,625,625,50,50,24.75,0,0,625,625,50,0,24.75,0,625,0,24.75,0,647.2113333333333,25,0.25,0.01,622.2113333333333,25,25
1173,1.99,0.01,169,167.31,165.64,0.0,321.75,25.87,12.87,37.87,-0.13,12.87,-12.13,0,325,13,38,0.13,13,-12,0,0,25,-13,-12.87,-25,625,12,12.13,25,93.29933333333334,13,12.87,0.99,93.29933333333334,0,25
1174,1.99,0.01,625,618.75,612.56,0.0,618.75,49.75,24.75,49.75,-0.25,24.75,-0.25,0,625,25,50,0.25,25,0,0,0,25,-25,-24.75,-25,625,0,0.25,25,328.0106666666667,25,24.75,0.99,328.0106666666667,0,25
1175,1.01,0.99,1,0.01,0.0,0.24,0.25,1.01,24.01,25.01,-0.99,-23.99,-24.99,24,25,25,26,0.99,-23,-24,576,600,49,23,23.99,-1,625,24,24.99,1,48.792,1,0.01,0.01,24.792,24,25
1176,1.99,0.01,4,3.96,3.92,0.0,0.0,3.98,1.98,1.98,-0.02,1.98,1.98,0,0,2,2,0.02,2,2,0,0,0,-2,-1.98,0,0,-2,-1.98,0,2.966666666666667,2,1.98,0.99,2.966666666666667,0,0
1177,1.99,0.01,1,0.99,0.98,0.0,0.0,1.99,0.99,0.99,-0.01,0.99,0.99,0,0,1,1,0.01,1,1,0,0,0,-1,-0.99,0,0,-1,-0.99,0,0.988,1,0.99,0.99,0.988,0,0
1178,1.01,0.99,169,1.69,0.02,0.0,0.0,13.13,0.13,0.13,-12.87,0.13,0.13,0,0,13,13,12.87,13,13,0,0,0,-13,-0.13,0,0,-13,-0.13,0,0.878,13,0.13,0.01,0.878,0,0
1179,1.99,0.01,1,0.99,0.98,0.0,24.75,1.99,0.99,25.99,-0.01,0.99,-24.01,0,25,1,26,0.01,1,-24,0,0,25,-1,-0.99,-25,625,24,24.01,25,1.176,1,0.99,0.99,1.176,0,25
1180,1.01,0.99,1,0.01,0.0,0.0,0.0,1.01,0.01,0.01,-0.99,0.01,0.01,0,0,1,1,0.99,1,1,0,0,0,-1,-0.01,0,0,-1,-0.01,0,0.008,1,0.01,0.01,0.008,0,0
1181,1.09,0.91,625,57.4,5.27,0.0,57.4,27.3,2.3,27.3,-22.7,2.3,-22.7,0,625,25,50,22.7,25,0,0,0,25,-25,-2.3,-25,625,0,22.7,25,597.2773333333333,25,2.3,0.09183458033420318,597.2773333333333,0,25
1182,1.99,0.01,1,0.99,0.98,0.0,0.0,1.99,0.99,0.99,-0.01,0.99,0.99,0,0,1,1,0.01,1,1,0,0,0,-1,-0.99,0,0,-1,-0.99,0,0.9906666666666667,1,0.99,0.99,0.9906666666666667,0,0
1183,1.99,0.01,625,618.75,612.56,0.0,0.0,49.75,24.75,24.75,-0.25,24.75,24.75,0,0,25,25,0.25,25,25,0,0,0,-25,-24.75,0,0,-25,-24.75,0,321.50733333333335,25,24.75,0.99,321.50733333333335,0,0
1184,1.99,0.01,1,0.99,0.98,24.75,24.75,1.99,25.99,25.99,-0.01,-24.01,-24.01,25,25,26,26,0.01,-24,-24,625,625,50,24,24.01,0,625,24,24.01,0,26.176,1,0.99,0.99,1.1759999999999984,25,25
1185,1.01,0.99,4,0.04,0.0,0.5,0.0,2.02,25.02,0.02,-1.98,-24.98,0.02,50,0,27,2,1.98,-23,2,625,0,25,23,24.98,25,0,-2,-0.02,-25,25.032666666666668,2,0.02,0.01,0.03266666666666751,25,0
1186,1.99,0.01,1,0.99,0.98,24.75,0.0,1.99,25.99,0.99,-0.01,-24.01,0.99,25,0,26,1,0.01,-24,1,625,0,25,24,24.01,25,0,-1,-0.99,-25,25.994666666666667,1,0.99,0.99,0.9946666666666673,25,0
1187,1.01,0.99,625,6.25,0.06,0.0,0.0,25.25,0.25,0.25,-24.75,0.25,0.25,0,0,25,25,24.75,25,25,0,0,0,-25,-0.25,0,0,-25,-0.25,0,3.138,25,0.25,0.01,3.138,0,0
1188,1.01,0.99,1,0.01,0.0,0.24,0.25,1.01,24.01,25.01,-0.99,-23.99,-24.99,24,25,25,26,0.99,-23,-24,576,600,49,23,23.99,-1,625,24,24.99,1,48.728,1,0.01,0.01,24.728,24,25
1189,1.99,0.01,4,3.96,3.92,0.0,0.0,3.98,1.98,1.98,-0.02,1.98,1.98,0,0,2,2,0.02,2,2,0,0,0,-2,-1.98,0,0,-2,-1.98,0,2.966,2,1.98,0.99,2.966,0,0
1190,1.83,0.17,625,517.5,428.49,517.5,248.4,45.7,45.7,32.7,-4.3,-4.3,8.7,625,300,50,37,4.3,0,13,625,300,37,0,4.3,13,144,-13,-8.7,-13,346.1206666666667,25,20.7,0.827999775353927,321.1206666666667,25,12
1191,1.99,0.01,625,618.75,612.56,0.0,618.75,49.75,24.75,49.75,-0.25,24.75,-0.25,0,625,25,50,0.25,25,0,0,0,25,-25,-24.75,-25,625,0,0.25,25,328.07533333333333,25,24.75,0.99,328.07533333333333,0,25
1192,1.99,0.01,1,0.99,0.98,0.0,0.0,1.99,0.99,0.99,-0.01,0.99,0.99,0,0,1,1,0.01,1,1,0,0,0,-1,-0.99,0,0,-1,-0.99,0,0.9846666666666667,1,0.99,0.99,0.9846666666666667,0,0
1193,1.01,0.99,625,6.25,0.06,0.0,0.0,25.25,0.25,0.25,-24.75,0.25,0.25,0,0,25,25,24.75,25,25,0,0,0,-25,-0.25,0,0,-25,-0.25,0,3.3893333333333335,25,0.25,0.01,3.3893333333333335,0,0
1194,1.99,0.01,625,618.75,612.56,0.0,321.75,49.75,24.75,37.75,-0.25,24.75,11.75,0,325,25,38,0.25,25,12,0,0,13,-25,-24.75,-13,169,-12,-11.75,13,325.0013333333333,25,24.75,0.99,325.0013333333333,0,13
1195,1.99,0.01,625,618.75,612.56,0.0,618.75,49.75,24.75,49.75,-0.25,24.75,-0.25,0,625,25,50,0.25,25,0,0,0,25,-25,-24.75,-25,625,0,0.25,25,327.888,25,24.75,0.99,327.888,0,25
1196,1.01,0.99,169,1.69,0.02,3.25,3.25,13.13,25.13,25.13,-12.87,-24.87,-24.87,325,325,38,38,12.87,-12,-12,625,625,50,12,24.87,0,625,12,24.87,0,348.01,13,0.13,0.01000000168537027,323.01,25,25
1197,1.99,0.01,625,618.75,612.56,618.75,321.75,49.75,49.75,37.75,-0.25,-0.25,11.75,625,325,50,38,0.25,0,12,625,325,38,0,0.25,12,169,-12,-11.75,-12,349.998,25,24.75,0.99,324.998,25,13
1198,1.99,0.01,169,167.31,165.64,0.0,321.75,25.87,12.87,37.87,-0.13,12.87,-12.13,0,325,13,38,0.13,13,-12,0,0,25,-13,-12.87,-25,625,12,12.13,25,93.40666666666667,13,12.87,0.99,93.40666666666667,0,25
1199,1.99,0.01,225,222.75,220.52,0.0,371.25,29.85,14.85,39.85,-0.15,14.85,-10.15,0,375,15,40,0.15,15,-10,0,0,25,-15,-14.85,-25,625,10,10.15,25,122.576,15,14.85,0.99,122.576,0,25
0,1.77,0.23,169,130.13,100.2,90.09,30.03,23.01,19.01,13.01,-2.99,1.01,7.01,117,39,22,16,2.99,4,10,81,27,12,-4,-1.01,6,9,-10,-7.01,-6,87.83,13,10.01,0.77,78.83,9,3
1,1.2,0.8,49,9.8,1.96,25.2,19.6,8.4,19.4,15.4,-5.6,-16.6,-12.6,126,98,25,21,5.6,-11,-7,324,252,32,11,16.6,4,196,7,12.6,-4,101.532,7,1.4,0.2,83.532,18,14
2,1.93,0.07,1,0.93,0.86,9.3,15.81,1.93,10.93,17.93,-0.07,-9.07,-16.07,10,17,11,18,0.07,-9,-16,100,170,27,9,9.07,-7,289,16,16.07,7,11.992,1,0.93,0.93,1.9920000000000009,10,17
3,1.54,0.46,1,0.54,0.29,7.56,4.86,1.54,14.54,9.54,-0.46,-13.46,-8.46,14,9,15,10,0.46,-13,-8,196,126,23,13,13.46,5,81,8,8.46,-5,18.888,1,0.54,0.54,4.888000000000002,14,9
4,1.35,0.65,81,28.35,9.92,44.1,28.35,12.15,17.15,12.15,-5.85,-10.85,-5.85,126,81,23,18,5.85,-5,0,196,126,23,5,10.85,5,81,0,5.85,-5,82.638,9,3.15,0.35,68.638,14,9
5,1.54,0.46,1,0.54,0.29,9.18,1.62,1.54,17.54,3.54,-0.46,-16.46,-2.46,17,3,18,4,0.46,-16,-2,289,51,20,16,16.46,14,9,2,2.46,-14,18.9,1,0.54,0.54,1.8999999999999986,17,3
6,1.57,0.43,225,128.25,73.1,17.1,94.05,23.55,10.55,19.55,-6.45,6.55,-2.45,30,165,17,26,6.45,13,4,4,22,13,-13,-6.55,-9,121,-4,2.45,9,140.5,15,8.55,0.57,138.5,2,11
7,1.51,0.49,49,24.99,12.74,53.55,17.85,10.57,18.57,8.57,-3.43,-11.43,-1.43,105,35,22,12,3.43,-8,2,225,75,20,8,11.43,10,25,-2,1.43,-10,46.648,7,3.57,0.51,31.648000000000003,15,5
8,1.2,0.8,16,3.2,0.64,7.2,2.4,4.8,9.8,3.8,-3.2,-8.2,-2.2,36,12,13,7,3.2,-5,1,81,27,12,5,8.2,6,9,-1,2.2,-6,20.626,4,0.8,0.2,11.626000000000001,9,3
9,1.32,0.68,81,25.92,8.29,11.52,43.2,11.88,6.88,17.88,-6.12,-1.12,-12.12,36,135,13,24,6.12,5,-6,16,60,19,-5,1.12,-11,225,6,12.12,11,110.516,9,2.88,0.32,106.516,4,15
10,1.76,0.24,289,219.64,166.93,206.72,232.56,29.92,28.92,30.92,-4.08,-3.08,-5.08,272,306,33,35,4.08,1,-1,256,288,34,-1,3.08,-2,324,1,5.08,2,205.206,17,12.92,0.76,189.206,16,18
11,1.4,0.6,25,10.0,4.0,2.0,40.0,7.0,3.0,22.0,-3.0,1.0,-18.0,5,100,6,25,3.0,4,-15,1,20,21,-4,-1.0,-19,400,15,18.0,19,66.134,5,2.0,0.4,65.134,1,20
12,1.83,0.17,400,332.0,275.56,0.0,249.0,36.6,16.6,31.6,-3.4,16.6,1.6,0,300,20,35,3.4,20,5,0,0,15,-20,-16.6,-15,225,-5,-1.6,15,225.748,20,16.6,0.83,225.748,0,15
13,1.81,0.19,225,182.25,147.62,72.9,121.5,27.15,18.15,22.15,-2.85,6.15,2.15,90,150,21,25,2.85,9,5,36,60,16,-9,-6.15,-4,100,-5,-2.15,4,131.582,15,12.15,0.81,125.582,6,10
14,1.26,0.74,256,66.56,17.31,70.72,62.4,20.16,21.16,19.16,-11.84,-12.84,-10.84,272,240,33,31,11.84,-1,1,289,255,32,1,12.84,2,225,-1,10.84,-2,230.194,16,4.16,0.26,213.194,17,15
15,1.15,0.85,1,0.15,0.02,1.2,2.4,1.15,8.15,16.15,-0.85,-7.85,-15.85,8,16,9,17,0.85,-7,-15,64,128,24,7,7.85,-8,256,15,15.85,8,21.9,1,0.15,0.15,13.899999999999999,8,16
16,1.44,0.56,121,53.24,23.43,29.04,19.36,15.84,10.84,8.84,-6.16,-1.16,0.84,66,44,17,15,6.16,5,7,36,24,10,-5,1.16,2,16,-7,-0.84,-2,59.188,11,4.84,0.44,53.188,6,4
17,1.46,0.54,144,66.24,30.47,88.32,16.56,17.52,21.52,8.52,-6.48,-10.48,2.52,192,36,28,15,6.48,-4,9,256,48,19,4,10.48,13,9,-9,-2.52,-13,71.852,12,5.52,0.46,55.852000000000004,16,3
18,1.58,0.42,289,167.62,97.22,187.34,128.18,26.86,28.86,22.86,-7.14,-9.14,-3.14,323,221,36,30,7.14,-2,4,361,247,32,2,9.14,6,169,-4,3.14,-6,200.494,17,9.86,0.58,181.494,19,13
19,1.7,0.3,16,11.2,7.84,56.0,22.4,6.8,22.8,10.8,-1.2,-17.2,-5.2,80,32,24,12,1.2,-16,-4,400,160,28,16,17.2,12,64,4,5.2,-12,36.206,4,2.8,0.7,16.206000000000003,20,8
20,1.83,0.17,144,119.52,99.2,19.92,79.68,21.96,11.96,17.96,-2.04,7.96,1.96,24,96,14,20,2.04,10,4,4,16,10,-10,-7.96,-6,64,-4,-1.96,6,83.288,12,9.96,0.83,81.288,2,8
21,1.05,0.95,4,0.2,0.01,0.2,1.6,2.1,2.1,16.1,-1.9,-1.9,-15.9,4,32,4,18,1.9,0,-14,4,32,18,0,1.9,-14,256,14,15.9,14,32.928,2,0.1,0.05,30.927999999999997,2,16
22,1.51,0.49,256,130.56,66.59,40.8,114.24,24.16,13.16,22.16,-7.84,3.16,-5.84,80,224,21,30,7.84,11,2,25,70,19,-11,-3.16,-9,196,-2,5.84,9,184.178,16,8.16,0.51,179.178,5,14
23,1.78,0.22,16,12.48,9.73,53.04,56.16,7.12,20.12,21.12,-0.88,-13.88,-14.88,68,72,21,22,0.88,-13,-14,289,306,35,13,13.88,-1,324,14,14.88,1,40.508,4,3.12,0.78,23.508000000000003,17,18
24,1.64,0.36,400,256.0,163.84,217.6,76.8,32.8,29.8,18.8,-7.2,-4.2,6.8,340,120,37,26,7.2,3,14,289,102,23,-3,4.2,11,36,-14,-6.8,-11,194.624,20,12.8,0.64,177.624,17,6
25,1.59,0.41,36,21.24,12.53,46.02,46.02,9.54,16.54,16.54,-2.46,-9.46,-9.46,78,78,19,19,2.46,-7,-7,169,169,26,7,9.46,0,169,7,9.46,0,57.234,6,3.54,0.59,44.234,13,13
26,1.2,0.8,225,45.0,9.0,3.0,24.0,18.0,4.0,11.0,-12.0,2.0,-5.0,15,120,16,23,12.0,14,7,1,8,9,-14,-2.0,-7,64,-7,5.0,7,121.332,15,3.0,0.2,120.332,1,8
27,1.21,0.79,361,75.81,15.92,75.81,3.99,22.99,22.99,4.99,-15.01,-15.01,2.99,361,19,38,20,15.01,0,18,361,19,20,0,15.01,18,1,-18,-2.99,-18,74.08,19,3.99,0.21,55.08,19,1
28,1.19,0.81,16,3.04,0.58,14.44,5.32,4.76,19.76,7.76,-3.24,-18.24,-6.24,76,28,23,11,3.24,-15,-3,361,133,26,15,18.24,12,49,3,6.24,-12,43.216,4,0.76,0.19,24.216,19,7
29,1.43,0.57,196,84.28,36.24,42.14,66.22,20.02,13.02,17.02,-7.98,-0.98,-4.98,98,154,21,25,7.98,7,3,49,77,18,-7,0.98,-4,121,-3,4.98,4,139.564,14,6.02,0.43,132.564,7,11
30,1.25,0.75,49,12.25,3.06,22.75,26.25,8.75,14.75,16.75,-5.25,-11.25,-13.25,91,105,20,22,5.25,-6,-8,169,195,28,6,11.25,-2,225,8,13.25,2,99.096,7,1.75,0.25,86.096,13,15
31,1.89,0.11,289,257.21,228.92,15.13,45.39,32.13,16.13,18.13,-1.87,14.13,12.13,17,51,18,20,1.87,16,14,1,3,4,-16,-14.13,-2,9,-14,-12.13,2,142.94,17,15.13,0.89,141.94,1,3
32,1.62,0.38,361,223.82,138.77,200.26,106.02,30.78,28.78,20.78,-7.22,-5.22,2.78,323,171,36,28,7.22,2,10,289,153,26,-2,5.22,8,81,-10,-2.78,-8,198.798,19,11.78,0.62,181.798,17,9
33,1.07,0.93,25,1.75,0.12,0.35,2.8,5.35,1.35,8.35,-4.65,-0.65,-7.65,5,40,6,13,4.65,4,-3,1,8,9,-4,0.65,-7,64,3,7.65,7,39.084,5,0.35,0.07,38.084,1,8
34,1.31,0.69,169,52.39,16.24,4.03,40.3,17.03,5.03,14.03,-8.97,3.03,-5.97,13,130,14,23,8.97,12,3,1,10,11,-12,-3.03,-9,100,-3,5.97,9,118.85,13,4.03,0.31,117.85,1,10
35,1.81,0.19,1,0.81,0.66,16.2,1.62,1.81,20.81,2.81,-0.19,-19.19,-1.19,20,2,21,3,0.19,-19,-1,400,40,22,19,19.19,18,4,1,1.19,-18,21.196,1,0.81,0.81,1.1960000000000015,20,2
36,1.46,0.54,16,7.36,3.39,25.76,29.44,5.84,15.84,17.84,-2.16,-12.16,-14.16,56,64,18,20,2.16,-10,-12,196,224,30,10,12.16,-2,256,12,14.16,2,53.802,4,1.84,0.46,39.802,14,16
37,1.7,0.3,81,56.7,39.69,75.6,0.0,15.3,18.3,6.3,-2.7,-5.7,6.3,108,0,21,9,2.7,-3,9,144,0,12,3,5.7,12,0,-9,-6.3,-12,43.114,9,6.3,0.7,31.113999999999997,12,0
38,1.89,0.11,36,32.04,28.52,101.46,32.04,11.34,24.34,11.34,-0.66,-13.66,-0.66,114,36,25,12,0.66,-13,0,361,114,25,13,13.66,13,36,0,0.66,-13,41.736,6,5.34,0.89,22.735999999999997,19,6
39,1.4,0.6,36,14.4,5.76,4.8,2.4,8.4,4.4,3.4,-3.6,0.4,1.4,12,6,8,7,3.6,4,5,4,2,3,-4,-0.4,1,1,-5,-1.4,-1,13.962,6,2.4,0.4,11.962,2,1
40,1.84,0.16,1,0.84,0.71,16.8,5.88,1.84,20.84,7.84,-0.16,-19.16,-6.16,20,7,21,8,0.16,-19,-6,400,140,27,19,19.16,13,49,6,6.16,-13,22.008,1,0.84,0.84,2.007999999999999,20,7
41,1.52,0.48,225,117.0,60.84,124.8,23.4,22.8,23.8,10.8,-7.2,-8.2,4.8,240,45,31,18,7.2,-1,12,256,48,19,1,8.2,13,9,-12,-4.8,-13,100.562,15,7.8,0.52,84.562,16,3
42,1.9,0.1,225,202.5,182.25,40.5,108.0,28.5,16.5,21.5,-1.5,10.5,5.5,45,120,18,23,1.5,12,7,9,24,11,-12,-10.5,-5,64,-7,-5.5,5,122.834,15,13.5,0.9,119.834,3,8
43,1.6,0.4,4,2.4,1.44,9.6,15.6,3.2,9.2,14.2,-0.8,-6.8,-11.8,16,26,10,15,0.8,-6,-11,64,104,21,6,6.8,-5,169,11,11.8,5,20.654,2,1.2,0.6,12.654,8,13
44,1.09,0.91,169,15.21,1.37,10.53,7.02,14.17,10.17,7.17,-11.83,-7.83,-4.83,117,78,22,19,11.83,4,7,81,54,15,-4,7.83,3,36,-7,4.83,-3,88.468,13,1.17,0.09,79.468,9,6
